Account,Date,Transaction type,Num,Name,Description,Full name,Account,Amount,Balance
CHASE ENDING IN 5315,12/13/23,Expense,--,QuickBooks Payments,ORIG CO NAME:INTUIT * ORIG ID:XXXXXX6346 DESC DATE:231213 CO ENTRY DESCR:QBooks OnlSEC:CCD TRACE#:XXXXXXXX6535988 EED:231213 IND ID:0519196 IND NAME:DIGNITAS UK RAINE INC XXX-XXX-8848 TRN: XXXXXX5988 TC,CHASE ENDING IN 5315,Software & apps,($85.00),($85.00)
Software & apps,12/13/23,Expense,--,QuickBooks Payments,ORIG CO NAME:INTUIT * ORIG ID:XXXXXX6346 DESC DATE:231213 CO ENTRY DESCR:QBooks OnlSEC:CCD TRACE#:XXXXXXXX6535988 EED:231213 IND ID:0519196 IND NAME:DIGNITAS UK RAINE INC XXX-XXX-8848 TRN: XXXXXX5988 TC,OFFICE/GENERAL ADMINISTRATIVE EXPENSES:Software & apps,CHASE ENDING IN 5315,$85.00 ,$0.00 
PayPal Bank 3,12/9/23,Deposit,1MK83563SC1649405,09 MSU RESTR,Subject: New 10 UnitsTransaction ID: 1MK83563SC1649405https://www.paypal.com/activity/payment/1MK83563SC1649405,PayPal Bank 3,--,$489.56 ,$489.56 
Donations directed by individuals,12/9/23,Deposit,1MK83563SC1649405,09 MSU RESTR,donation-form,Contributed income:Donations directed by individuals,PayPal Bank 3,$500.00 ,$989.56 
PayPal Fees,12/9/23,Deposit,1MK83563SC1649405,09 MSU RESTR,PayPal fees,OFFICE/GENERAL ADMINISTRATIVE EXPENSES:PayPal Fees,PayPal Bank 3,$10.44 ,"$1,000.00 "
PayPal Bank 3,12/9/23,Deposit,71G45329W57267338,08 VICTORY DRONES RESTR,Subject: VictoryDronesTransaction ID: 71G45329W57267338https://www.paypal.com/activity/payment/71G45329W57267338,PayPal Bank 3,--,$73.84 ,"$1,073.84 "
Donations directed by individuals,12/9/23,Deposit,71G45329W57267338,08 VICTORY DRONES RESTR,VICTORY DRONES - VICTORY DRONES,Contributed income:Donations directed by individuals,PayPal Bank 3,$77.02 ,"$1,150.86 "
PayPal Fees,12/9/23,Deposit,71G45329W57267338,08 VICTORY DRONES RESTR,PayPal fees,OFFICE/GENERAL ADMINISTRATIVE EXPENSES:PayPal Fees,PayPal Bank 3,$3.18 ,"$1,154.04 "
PayPal Bank 3,12/9/23,Deposit,81S18896FU3091537,04 PAYPAL GENERAL UNRESTR,Subject: GeneralPageNote: Donation from OWL SolutionsTransaction ID: 81S18896FU3091537https://www.paypal.com/activity/payment/81S18896FU3091537,PayPal Bank 3,--,$979.61 ,"$2,133.65 "
Donations directed by individuals,12/9/23,Deposit,81S18896FU3091537,04 PAYPAL GENERAL UNRESTR,Support Ukraine - Support Ukraine,Contributed income:Donations directed by individuals,PayPal Bank 3,"$1,000.00 ","$3,133.65 "
PayPal Fees,12/9/23,Deposit,81S18896FU3091537,04 PAYPAL GENERAL UNRESTR,PayPal fees,OFFICE/GENERAL ADMINISTRATIVE EXPENSES:PayPal Fees,PayPal Bank 3,$20.39 ,"$3,154.04 "
PayPal Bank 3,12/9/23,Deposit,7NF817729M795152D,04 PAYPAL GENERAL UNRESTR,Subject: GeneralPageTransaction ID: 7NF817729M795152Dhttps://www.paypal.com/activity/payment/7NF817729M795152D,PayPal Bank 3,--,$200.00 ,"$3,354.04 "
Donations directed by individuals,12/9/23,Deposit,7NF817729M795152D,04 PAYPAL GENERAL UNRESTR,Support Ukraine - Support Ukraine,Contributed income:Donations directed by individuals,PayPal Bank 3,$204.56 ,"$3,558.60 "
PayPal Fees,12/9/23,Deposit,7NF817729M795152D,04 PAYPAL GENERAL UNRESTR,PayPal fees,OFFICE/GENERAL ADMINISTRATIVE EXPENSES:PayPal Fees,PayPal Bank 3,$4.56 ,"$3,563.16 "
PayPal Bank 3,12/9/23,Deposit,1BF94096VA356302S,09 MSU RESTR,Subject: New 10 UnitsTransaction ID: 1BF94096VA356302Shttps://www.paypal.com/activity/payment/1BF94096VA356302S,PayPal Bank 3,--,$9.16 ,"$3,572.32 "
Donations directed by individuals,12/9/23,Deposit,1BF94096VA356302S,09 MSU RESTR,donation-form,Contributed income:Donations directed by individuals,PayPal Bank 3,$10.00 ,"$3,582.32 "
PayPal Fees,12/9/23,Deposit,1BF94096VA356302S,09 MSU RESTR,PayPal fees,OFFICE/GENERAL ADMINISTRATIVE EXPENSES:PayPal Fees,PayPal Bank 3,$0.84 ,"$3,583.16 "
PayPal Bank 3,12/9/23,Deposit,0EA400795T141684G,07 1000 DRONES RESTR,Subject: 1000DRONESNote: Note: Directional IR laser communication with drones would be highly resistant to Russian jamming.   Ken@3cat.   usTransaction ID: 0EA400795T141684Ghttps://www.paypal.com/activity/payment/0EA400795T141684G,PayPal Bank 3,--,$50.00 ,"$3,633.16 "
Donations directed by individuals,12/9/23,Deposit,0EA400795T141684G,07 1000 DRONES RESTR,1000 DRONES FOR UKRAINE - 1000 DRONES FOR UKRAINE,Contributed income:Donations directed by individuals,PayPal Bank 3,$51.52 ,"$3,684.68 "
PayPal Fees,12/9/23,Deposit,0EA400795T141684G,07 1000 DRONES RESTR,PayPal fees,OFFICE/GENERAL ADMINISTRATIVE EXPENSES:PayPal Fees,PayPal Bank 3,$1.52 ,"$3,686.20 "
PayPal Bank 3,12/8/23,Deposit,6G10057959345840P,08 VICTORY DRONES RESTR,Subject: VictoryDronesTransaction ID: 6G10057959345840Phttps://www.paypal.com/activity/payment/6G10057959345840P,PayPal Bank 3,--,$100.00 ,"$3,786.20 "
Donations directed by individuals,12/8/23,Deposit,6G10057959345840P,08 VICTORY DRONES RESTR,VICTORY DRONES - VICTORY DRONES,Contributed income:Donations directed by individuals,PayPal Bank 3,$102.53 ,"$3,888.73 "
PayPal Fees,12/8/23,Deposit,6G10057959345840P,08 VICTORY DRONES RESTR,PayPal fees,OFFICE/GENERAL ADMINISTRATIVE EXPENSES:PayPal Fees,PayPal Bank 3,$2.53 ,"$3,891.26 "
PayPal Bank 3,12/8/23,Deposit,25H34426BN748013R,08 VICTORY DRONES RESTR,Subject: VictoryDronesNote: Thank you for your courage !Transaction ID: 25H34426BN748013Rhttps://www.paypal.com/activity/payment/25H34426BN748013R,PayPal Bank 3,--,$200.00 ,"$4,091.26 "
Donations directed by individuals,12/8/23,Deposit,25H34426BN748013R,08 VICTORY DRONES RESTR,VICTORY DRONES - VICTORY DRONES,Contributed income:Donations directed by individuals,PayPal Bank 3,$204.56 ,"$4,295.82 "
PayPal Fees,12/8/23,Deposit,25H34426BN748013R,08 VICTORY DRONES RESTR,PayPal fees,OFFICE/GENERAL ADMINISTRATIVE EXPENSES:PayPal Fees,PayPal Bank 3,$4.56 ,"$4,300.38 "
PayPal Bank 3,12/8/23,Deposit,4DK88987LY323880E,07 1000 DRONES RESTR,Subject: 1000DRONESTransaction ID: 4DK88987LY323880Ehttps://www.paypal.com/activity/payment/4DK88987LY323880E,PayPal Bank 3,--,$289.04 ,"$4,589.42 "
Donations directed by individuals,12/8/23,Deposit,4DK88987LY323880E,07 1000 DRONES RESTR,1000 DRONES FOR UKRAINE - 1000 DRONES FOR UKRAINE,Contributed income:Donations directed by individuals,PayPal Bank 3,$300.00 ,"$4,889.42 "
PayPal Fees,12/8/23,Deposit,4DK88987LY323880E,07 1000 DRONES RESTR,PayPal fees,OFFICE/GENERAL ADMINISTRATIVE EXPENSES:PayPal Fees,PayPal Bank 3,$10.96 ,"$4,900.38 "
PayPal Bank 3,12/8/23,Deposit,4MG76353H5466671X,04 PAYPAL GENERAL UNRESTR,Subject: GeneralPageTransaction ID: 4MG76353H5466671Xhttps://www.paypal.com/activity/payment/4MG76353H5466671X,PayPal Bank 3,--,$50.00 ,"$4,950.38 "
Donations directed by individuals,12/8/23,Deposit,4MG76353H5466671X,04 PAYPAL GENERAL UNRESTR,Support Ukraine - Support Ukraine,Contributed income:Donations directed by individuals,PayPal Bank 3,$51.52 ,"$5,001.90 "
PayPal Fees,12/8/23,Deposit,4MG76353H5466671X,04 PAYPAL GENERAL UNRESTR,PayPal fees,OFFICE/GENERAL ADMINISTRATIVE EXPENSES:PayPal Fees,PayPal Bank 3,$1.52 ,"$5,003.42 "
PayPal Bank 3,12/8/23,Deposit,6CM76732T2981341B,04 PAYPAL GENERAL UNRESTR,Transaction ID: 6CM76732T2981341Bhttps://www.paypal.com/activity/payment/6CM76732T2981341B,PayPal Bank 3,--,$18.81 ,"$5,022.23 "
Donations directed by individuals,12/8/23,Deposit,6CM76732T2981341B,04 PAYPAL GENERAL UNRESTR,Money in to PayPal,Contributed income:Donations directed by individuals,PayPal Bank 3,$20.00 ,"$5,042.23 "
PayPal Fees,12/8/23,Deposit,6CM76732T2981341B,04 PAYPAL GENERAL UNRESTR,PayPal fees,OFFICE/GENERAL ADMINISTRATIVE EXPENSES:PayPal Fees,PayPal Bank 3,$1.19 ,"$5,043.42 "
CHASE ENDING IN 5315,12/7/23,Deposit,--,05 VENMO UNRESTR,ORIG CO NAME:VENMO ORIG ID:XXXXXX1992 DESC DATE:231206 CO ENTRY DESCR:CASHOUT SEC:PPD TRACE#:XXXXXXXX8378575 EED:231207 IND ID: IND NAME:OKSANA PATRINA TRN: 341 XXX8575TC,CHASE ENDING IN 5315,Donations directed by individuals,$307.55 ,"$5,350.97 "
Donations directed by individuals,12/7/23,Deposit,--,05 VENMO UNRESTR,ORIG CO NAME:VENMO ORIG ID:XXXXXX1992 DESC DATE:231206 CO ENTRY DESCR:CASHOUT SEC:PPD TRACE#:XXXXXXXX8378575 EED:231207 IND ID: IND NAME:OKSANA PATRINA TRN: 341 XXX8575TC,Contributed income:Donations directed by individuals,CHASE ENDING IN 5315,$307.55 ,"$5,658.52 "
PayPal Bank 3,12/7/23,Deposit,6VJ30432WA6949726,07 1000 DRONES RESTR,Subject: 1000DRONESTransaction ID: 6VJ30432WA6949726https://www.paypal.com/activity/payment/6VJ30432WA6949726,PayPal Bank 3,--,$23.64 ,"$5,682.16 "
Donations directed by individuals,12/7/23,Deposit,6VJ30432WA6949726,07 1000 DRONES RESTR,1000 DRONES FOR UKRAINE - 1000 DRONES FOR UKRAINE,Contributed income:Donations directed by individuals,PayPal Bank 3,$25.00 ,"$5,707.16 "
PayPal Fees,12/7/23,Deposit,6VJ30432WA6949726,07 1000 DRONES RESTR,PayPal fees,OFFICE/GENERAL ADMINISTRATIVE EXPENSES:PayPal Fees,PayPal Bank 3,$1.36 ,"$5,708.52 "
PayPal Bank 3,12/7/23,Deposit,3A92242178001841H,04 PAYPAL GENERAL UNRESTR,Subject: Support UkraineTransaction ID: 3A92242178001841Hhttps://www.paypal.com/activity/payment/3A92242178001841H,PayPal Bank 3,--,$19.69 ,"$5,728.21 "
Donations directed by individuals,12/7/23,Deposit,3A92242178001841H,04 PAYPAL GENERAL UNRESTR,Money in to PayPal,Contributed income:Donations directed by individuals,PayPal Bank 3,$20.91 ,"$5,749.12 "
PayPal Fees,12/7/23,Deposit,3A92242178001841H,04 PAYPAL GENERAL UNRESTR,PayPal fees,OFFICE/GENERAL ADMINISTRATIVE EXPENSES:PayPal Fees,PayPal Bank 3,$1.22 ,"$5,750.34 "
PayPal Bank 3,12/7/23,Deposit,16G39957TH4660849,04 PAYPAL GENERAL UNRESTR,Subject: GeneralPageTransaction ID: 16G39957TH4660849https://www.paypal.com/activity/payment/16G39957TH4660849,PayPal Bank 3,--,$100.00 ,"$5,850.34 "
Donations directed by individuals,12/7/23,Deposit,16G39957TH4660849,04 PAYPAL GENERAL UNRESTR,Support Ukraine - Support Ukraine,Contributed income:Donations directed by individuals,PayPal Bank 3,$102.53 ,"$5,952.87 "
PayPal Fees,12/7/23,Deposit,16G39957TH4660849,04 PAYPAL GENERAL UNRESTR,PayPal fees,OFFICE/GENERAL ADMINISTRATIVE EXPENSES:PayPal Fees,PayPal Bank 3,$2.53 ,"$5,955.40 "
PayPal Bank 3,12/7/23,Deposit,5T050799TE273571B,08 VICTORY DRONES RESTR,Subject: VictoryDronesTransaction ID: 5T050799TE273571Bhttps://www.paypal.com/activity/payment/5T050799TE273571B,PayPal Bank 3,--,$98.46 ,"$6,053.86 "
Donations directed by individuals,12/7/23,Deposit,5T050799TE273571B,08 VICTORY DRONES RESTR,VICTORY DRONES - VICTORY DRONES,Contributed income:Donations directed by individuals,PayPal Bank 3,$102.53 ,"$6,156.39 "
PayPal Fees,12/7/23,Deposit,5T050799TE273571B,08 VICTORY DRONES RESTR,PayPal fees,OFFICE/GENERAL ADMINISTRATIVE EXPENSES:PayPal Fees,PayPal Bank 3,$4.07 ,"$6,160.46 "
PayPal Bank 3,12/7/23,Deposit,9DN51271Y32497935,04 PAYPAL GENERAL UNRESTR,Subject: Support UkraineTransaction ID: 9DN51271Y32497935https://www.paypal.com/activity/payment/9DN51271Y32497935,PayPal Bank 3,--,$69.00 ,"$6,229.46 "
Donations directed by individuals,12/7/23,Deposit,9DN51271Y32497935,04 PAYPAL GENERAL UNRESTR,Money in to PayPal,Contributed income:Donations directed by individuals,PayPal Bank 3,$72.00 ,"$6,301.46 "
PayPal Fees,12/7/23,Deposit,9DN51271Y32497935,04 PAYPAL GENERAL UNRESTR,PayPal fees,OFFICE/GENERAL ADMINISTRATIVE EXPENSES:PayPal Fees,PayPal Bank 3,$3.00 ,"$6,304.46 "
PayPal Bank 3,12/7/23,Deposit,5MN74687FS529904N,04 PAYPAL GENERAL UNRESTR,Subject: Support UkraineTransaction ID: 5MN74687FS529904Nhttps://www.paypal.com/activity/payment/5MN74687FS529904N,PayPal Bank 3,--,$25.24 ,"$6,329.70 "
Donations directed by individuals,12/7/23,Deposit,5MN74687FS529904N,04 PAYPAL GENERAL UNRESTR,Money in to PayPal,Contributed income:Donations directed by individuals,PayPal Bank 3,$26.25 ,"$6,355.95 "
PayPal Fees,12/7/23,Deposit,5MN74687FS529904N,04 PAYPAL GENERAL UNRESTR,PayPal fees,OFFICE/GENERAL ADMINISTRATIVE EXPENSES:PayPal Fees,PayPal Bank 3,$1.01 ,"$6,356.96 "
PayPal Bank 3,12/7/23,Deposit,2W854315L3416012M,04 PAYPAL GENERAL UNRESTR,Subject: Support UkraineTransaction ID: 2W854315L3416012Mhttps://www.paypal.com/activity/payment/2W854315L3416012M,PayPal Bank 3,--,$50.00 ,"$6,406.96 "
Donations directed by individuals,12/7/23,Deposit,2W854315L3416012M,04 PAYPAL GENERAL UNRESTR,Money in to PayPal,Contributed income:Donations directed by individuals,PayPal Bank 3,$51.52 ,"$6,458.48 "
PayPal Fees,12/7/23,Deposit,2W854315L3416012M,04 PAYPAL GENERAL UNRESTR,PayPal fees,OFFICE/GENERAL ADMINISTRATIVE EXPENSES:PayPal Fees,PayPal Bank 3,$1.52 ,"$6,460.00 "
PayPal Bank 3,12/7/23,Deposit,46527982XF8997645,08 VICTORY DRONES RESTR,Subject: VictoryDronesTransaction ID: 46527982XF8997645https://www.paypal.com/activity/payment/46527982XF8997645,PayPal Bank 3,--,$9.84 ,"$6,469.84 "
Donations directed by individuals,12/7/23,Deposit,46527982XF8997645,08 VICTORY DRONES RESTR,VICTORY DRONES - VICTORY DRONES,Contributed income:Donations directed by individuals,PayPal Bank 3,$10.70 ,"$6,480.54 "
PayPal Fees,12/7/23,Deposit,46527982XF8997645,08 VICTORY DRONES RESTR,PayPal fees,OFFICE/GENERAL ADMINISTRATIVE EXPENSES:PayPal Fees,PayPal Bank 3,$0.86 ,"$6,481.40 "
PayPal Bank 3,12/7/23,Deposit,7VT209923Y3994633,04 PAYPAL GENERAL UNRESTR,Subject: GeneralPageTransaction ID: 7VT209923Y3994633https://www.paypal.com/activity/payment/7VT209923Y3994633,PayPal Bank 3,--,$47.76 ,"$6,529.16 "
Donations directed by individuals,12/7/23,Deposit,7VT209923Y3994633,04 PAYPAL GENERAL UNRESTR,Support Ukraine - Support Ukraine,Contributed income:Donations directed by individuals,PayPal Bank 3,$50.00 ,"$6,579.16 "
PayPal Fees,12/7/23,Deposit,7VT209923Y3994633,04 PAYPAL GENERAL UNRESTR,PayPal fees,OFFICE/GENERAL ADMINISTRATIVE EXPENSES:PayPal Fees,PayPal Bank 3,$2.24 ,"$6,581.40 "
PayPal Bank 3,12/7/23,Deposit,0XC328831F4214212,07 1000 DRONES RESTR,Subject: 1000DRONESTransaction ID: 0XC328831F4214212https://www.paypal.com/activity/payment/0XC328831F4214212,PayPal Bank 3,--,$9.16 ,"$6,590.56 "
Donations directed by individuals,12/7/23,Deposit,0XC328831F4214212,07 1000 DRONES RESTR,1000 DRONES FOR UKRAINE - 1000 DRONES FOR UKRAINE,Contributed income:Donations directed by individuals,PayPal Bank 3,$10.00 ,"$6,600.56 "
PayPal Fees,12/7/23,Deposit,0XC328831F4214212,07 1000 DRONES RESTR,PayPal fees,OFFICE/GENERAL ADMINISTRATIVE EXPENSES:PayPal Fees,PayPal Bank 3,$0.84 ,"$6,601.40 "
PayPal Bank 3,12/6/23,Deposit,2V7375441P885850N,04 PAYPAL GENERAL UNRESTR,Subject: Support UkraineTransaction ID: 2V7375441P885850Nhttps://www.paypal.com/activity/payment/2V7375441P885850N,PayPal Bank 3,--,$4.34 ,"$6,605.74 "
Donations directed by individuals,12/6/23,Deposit,2V7375441P885850N,04 PAYPAL GENERAL UNRESTR,Money in to PayPal,Contributed income:Donations directed by individuals,PayPal Bank 3,$5.00 ,"$6,610.74 "
PayPal Fees,12/6/23,Deposit,2V7375441P885850N,04 PAYPAL GENERAL UNRESTR,PayPal fees,OFFICE/GENERAL ADMINISTRATIVE EXPENSES:PayPal Fees,PayPal Bank 3,$0.66 ,"$6,611.40 "
PayPal Bank 3,12/6/23,Deposit,1WU040811L2653253,07 1000 DRONES RESTR,Subject: GeneralPageNote: На бомби з дронами для руссні.Transaction ID: 1WU040811L2653253https://www.paypal.com/activity/payment/1WU040811L2653253,PayPal Bank 3,--,$195.53 ,"$6,806.93 "
Donations directed by individuals,12/6/23,Deposit,1WU040811L2653253,07 1000 DRONES RESTR,Support Ukraine - Support Ukraine,Contributed income:Donations directed by individuals,PayPal Bank 3,$200.00 ,"$7,006.93 "
PayPal Fees,12/6/23,Deposit,1WU040811L2653253,07 1000 DRONES RESTR,PayPal fees,OFFICE/GENERAL ADMINISTRATIVE EXPENSES:PayPal Fees,PayPal Bank 3,$4.47 ,"$7,011.40 "
PayPal Bank 3,12/6/23,Deposit,57B50672WC7477227,04 PAYPAL GENERAL UNRESTR,Subject: GeneralPageTransaction ID: 57B50672WC7477227https://www.paypal.com/activity/payment/57B50672WC7477227,PayPal Bank 3,--,$49.23 ,"$7,060.63 "
Donations directed by individuals,12/6/23,Deposit,57B50672WC7477227,04 PAYPAL GENERAL UNRESTR,Support Ukraine - Support Ukraine,Contributed income:Donations directed by individuals,PayPal Bank 3,$51.52 ,"$7,112.15 "
PayPal Fees,12/6/23,Deposit,57B50672WC7477227,04 PAYPAL GENERAL UNRESTR,PayPal fees,OFFICE/GENERAL ADMINISTRATIVE EXPENSES:PayPal Fees,PayPal Bank 3,$2.29 ,"$7,114.44 "
PayPal Bank 3,12/6/23,Deposit,80P112087R235541B,04 PAYPAL GENERAL UNRESTR,Subject: GeneralPageTransaction ID: 80P112087R235541Bhttps://www.paypal.com/activity/payment/80P112087R235541B,PayPal Bank 3,--,$18.81 ,"$7,133.25 "
Donations directed by individuals,12/6/23,Deposit,80P112087R235541B,04 PAYPAL GENERAL UNRESTR,Support Ukraine - Support Ukraine,Contributed income:Donations directed by individuals,PayPal Bank 3,$20.00 ,"$7,153.25 "
PayPal Fees,12/6/23,Deposit,80P112087R235541B,04 PAYPAL GENERAL UNRESTR,PayPal fees,OFFICE/GENERAL ADMINISTRATIVE EXPENSES:PayPal Fees,PayPal Bank 3,$1.19 ,"$7,154.44 "
PayPal Bank 3,12/6/23,Deposit,82231026U3776434M,07 1000 DRONES RESTR,Subject: 1000DRONESTransaction ID: 82231026U3776434Mhttps://www.paypal.com/activity/payment/82231026U3776434M,PayPal Bank 3,--,$196.93 ,"$7,351.37 "
Donations directed by individuals,12/6/23,Deposit,82231026U3776434M,07 1000 DRONES RESTR,1000 DRONES FOR UKRAINE - 1000 DRONES FOR UKRAINE,Contributed income:Donations directed by individuals,PayPal Bank 3,$204.56 ,"$7,555.93 "
PayPal Fees,12/6/23,Deposit,82231026U3776434M,07 1000 DRONES RESTR,PayPal fees,OFFICE/GENERAL ADMINISTRATIVE EXPENSES:PayPal Fees,PayPal Bank 3,$7.63 ,"$7,563.56 "
PayPal Bank 3,12/5/23,Deposit,4ET309440E809614N,09 MSU RESTR,Subject: New 10 UnitsTransaction ID: 4ET309440E809614Nhttps://www.paypal.com/activity/payment/4ET309440E809614N,PayPal Bank 3,--,$19.11 ,"$7,582.67 "
Donations directed by individuals,12/5/23,Deposit,4ET309440E809614N,09 MSU RESTR,donation-form,Contributed income:Donations directed by individuals,PayPal Bank 3,$20.00 ,"$7,602.67 "
PayPal Fees,12/5/23,Deposit,4ET309440E809614N,09 MSU RESTR,PayPal fees,OFFICE/GENERAL ADMINISTRATIVE EXPENSES:PayPal Fees,PayPal Bank 3,$0.89 ,"$7,603.56 "
PayPal Bank 3,12/5/23,Deposit,395525075J380770A,09 MSU RESTR,Subject: New 10 UnitsTransaction ID: 395525075J380770Ahttps://www.paypal.com/activity/payment/395525075J380770A,PayPal Bank 3,--,$97.52 ,"$7,701.08 "
Donations directed by individuals,12/5/23,Deposit,395525075J380770A,09 MSU RESTR,donation-form,Contributed income:Donations directed by individuals,PayPal Bank 3,$100.00 ,"$7,801.08 "
PayPal Fees,12/5/23,Deposit,395525075J380770A,09 MSU RESTR,PayPal fees,OFFICE/GENERAL ADMINISTRATIVE EXPENSES:PayPal Fees,PayPal Bank 3,$2.48 ,"$7,803.56 "
PayPal Bank 3,12/5/23,Deposit,63U11072J2277854W,09 MSU RESTR,Subject: MobileShowersTransaction ID: 63U11072J2277854Whttps://www.paypal.com/activity/payment/63U11072J2277854W,PayPal Bank 3,--,$20.09 ,"$7,823.65 "
Donations directed by individuals,12/5/23,Deposit,63U11072J2277854W,09 MSU RESTR,Mobile Shower/Laundry Units - Mobile Shower/Laundry Units,Contributed income:Donations directed by individuals,PayPal Bank 3,$21.00 ,"$7,844.65 "
PayPal Fees,12/5/23,Deposit,63U11072J2277854W,09 MSU RESTR,PayPal fees,OFFICE/GENERAL ADMINISTRATIVE EXPENSES:PayPal Fees,PayPal Bank 3,$0.91 ,"$7,845.56 "
PayPal Bank 3,12/5/23,Deposit,6M451930WK7810409,04 PAYPAL GENERAL UNRESTR,Subject: GeneralPageTransaction ID: 6M451930WK7810409https://www.paypal.com/activity/payment/6M451930WK7810409,PayPal Bank 3,--,$19.11 ,"$7,864.67 "
Donations directed by individuals,12/5/23,Deposit,6M451930WK7810409,04 PAYPAL GENERAL UNRESTR,Support Ukraine - Support Ukraine,Contributed income:Donations directed by individuals,PayPal Bank 3,$20.00 ,"$7,884.67 "
PayPal Fees,12/5/23,Deposit,6M451930WK7810409,04 PAYPAL GENERAL UNRESTR,PayPal fees,OFFICE/GENERAL ADMINISTRATIVE EXPENSES:PayPal Fees,PayPal Bank 3,$0.89 ,"$7,885.56 "
PayPal Bank 3,12/5/23,Deposit,0PC52598C03226436,04 PAYPAL GENERAL UNRESTR,Subject: GeneralPageTransaction ID: 0PC52598C03226436https://www.paypal.com/activity/payment/0PC52598C03226436,PayPal Bank 3,--,$100.00 ,"$7,985.56 "
Donations directed by individuals,12/5/23,Deposit,0PC52598C03226436,04 PAYPAL GENERAL UNRESTR,Support Ukraine - Support Ukraine,Contributed income:Donations directed by individuals,PayPal Bank 3,$102.53 ,"$8,088.09 "
PayPal Fees,12/5/23,Deposit,0PC52598C03226436,04 PAYPAL GENERAL UNRESTR,PayPal fees,OFFICE/GENERAL ADMINISTRATIVE EXPENSES:PayPal Fees,PayPal Bank 3,$2.53 ,"$8,090.62 "
PayPal Bank 3,12/5/23,Deposit,81W79463SA578253D,07 1000 DRONES RESTR,Subject: 1000DRONESTransaction ID: 81W79463SA578253Dhttps://www.paypal.com/activity/payment/81W79463SA578253D,PayPal Bank 3,--,$48.51 ,"$8,139.13 "
Donations directed by individuals,12/5/23,Deposit,81W79463SA578253D,07 1000 DRONES RESTR,1000 DRONES FOR UKRAINE - 1000 DRONES FOR UKRAINE,Contributed income:Donations directed by individuals,PayPal Bank 3,$50.00 ,"$8,189.13 "
PayPal Fees,12/5/23,Deposit,81W79463SA578253D,07 1000 DRONES RESTR,PayPal fees,OFFICE/GENERAL ADMINISTRATIVE EXPENSES:PayPal Fees,PayPal Bank 3,$1.49 ,"$8,190.62 "
PayPal Bank 3,12/4/23,Deposit,6J9276499Y7210818,04 PAYPAL GENERAL UNRESTR,Subject: Dignitas Ukraine Flight to RecoveryTransaction ID: 6J9276499Y7210818https://www.paypal.com/activity/payment/6J9276499Y7210818,PayPal Bank 3,--,$50.47 ,"$8,241.09 "
Donations directed by individuals,12/4/23,Deposit,6J9276499Y7210818,04 PAYPAL GENERAL UNRESTR,Money in to PayPal,Contributed income:Donations directed by individuals,PayPal Bank 3,$51.99 ,"$8,293.08 "
PayPal Fees,12/4/23,Deposit,6J9276499Y7210818,04 PAYPAL GENERAL UNRESTR,PayPal fees,OFFICE/GENERAL ADMINISTRATIVE EXPENSES:PayPal Fees,PayPal Bank 3,$1.52 ,"$8,294.60 "
PayPal Bank 3,12/4/23,Deposit,1RY70948J9941484V,04 PAYPAL GENERAL UNRESTR,Subject: Support UkraineTransaction ID: 1RY70948J9941484Vhttps://www.paypal.com/activity/payment/1RY70948J9941484V,PayPal Bank 3,--,$19.69 ,"$8,314.29 "
Donations directed by individuals,12/4/23,Deposit,1RY70948J9941484V,04 PAYPAL GENERAL UNRESTR,Money in to PayPal,Contributed income:Donations directed by individuals,PayPal Bank 3,$20.91 ,"$8,335.20 "
PayPal Fees,12/4/23,Deposit,1RY70948J9941484V,04 PAYPAL GENERAL UNRESTR,PayPal fees,OFFICE/GENERAL ADMINISTRATIVE EXPENSES:PayPal Fees,PayPal Bank 3,$1.22 ,"$8,336.42 "
PayPal Bank 3,12/4/23,Deposit,3DW81397XU731551K,08 VICTORY DRONES RESTR,Subject: VICTORY DRONESTransaction ID: 3DW81397XU731551Khttps://www.paypal.com/activity/payment/3DW81397XU731551K,PayPal Bank 3,--,$99.38 ,"$8,435.80 "
Donations directed by individuals,12/4/23,Deposit,3DW81397XU731551K,08 VICTORY DRONES RESTR,Money in to PayPal,Contributed income:Donations directed by individuals,PayPal Bank 3,$103.48 ,"$8,539.28 "
PayPal Fees,12/4/23,Deposit,3DW81397XU731551K,08 VICTORY DRONES RESTR,PayPal fees,OFFICE/GENERAL ADMINISTRATIVE EXPENSES:PayPal Fees,PayPal Bank 3,$4.10 ,"$8,543.38 "
PayPal Bank 3,12/4/23,Deposit,94F331271T258332B,07 1000 DRONES RESTR,Subject: 1000DRONESTransaction ID: 94F331271T258332Bhttps://www.paypal.com/activity/payment/94F331271T258332B,PayPal Bank 3,--,$192.53 ,"$8,735.91 "
Donations directed by individuals,12/4/23,Deposit,94F331271T258332B,07 1000 DRONES RESTR,1000 DRONES FOR UKRAINE - 1000 DRONES FOR UKRAINE,Contributed income:Donations directed by individuals,PayPal Bank 3,$200.00 ,"$8,935.91 "
PayPal Fees,12/4/23,Deposit,94F331271T258332B,07 1000 DRONES RESTR,PayPal fees,OFFICE/GENERAL ADMINISTRATIVE EXPENSES:PayPal Fees,PayPal Bank 3,$7.47 ,"$8,943.38 "
PayPal Bank 3,12/4/23,Deposit,0VE26047A79584033,10 Flight to Recovery RESTR,Subject: Dignitas Ukraine Flight to RecoveryTransaction ID: 0VE26047A79584033https://www.paypal.com/activity/payment/0VE26047A79584033,PayPal Bank 3,--,$99.38 ,"$9,042.76 "
Donations directed by individuals,12/4/23,Deposit,0VE26047A79584033,10 Flight to Recovery RESTR,Money in to PayPal,Contributed income:Donations directed by individuals,PayPal Bank 3,$103.48 ,"$9,146.24 "
PayPal Fees,12/4/23,Deposit,0VE26047A79584033,10 Flight to Recovery RESTR,PayPal fees,OFFICE/GENERAL ADMINISTRATIVE EXPENSES:PayPal Fees,PayPal Bank 3,$4.10 ,"$9,150.34 "
PayPal Bank 3,12/4/23,Deposit,2HH873252N058764R,04 PAYPAL GENERAL UNRESTR,Subject: Support UkraineTransaction ID: 2HH873252N058764Rhttps://www.paypal.com/activity/payment/2HH873252N058764R,PayPal Bank 3,--,$0.49 ,"$9,150.83 "
Donations directed by individuals,12/4/23,Deposit,2HH873252N058764R,04 PAYPAL GENERAL UNRESTR,Money in to PayPal,Contributed income:Donations directed by individuals,PayPal Bank 3,$1.00 ,"$9,151.83 "
PayPal Fees,12/4/23,Deposit,2HH873252N058764R,04 PAYPAL GENERAL UNRESTR,PayPal fees,OFFICE/GENERAL ADMINISTRATIVE EXPENSES:PayPal Fees,PayPal Bank 3,$0.51 ,"$9,152.34 "
PayPal Bank 3,12/3/23,Deposit,46187207TX1855409,04 PAYPAL GENERAL UNRESTR,Subject: Support UkraineTransaction ID: 46187207TX1855409https://www.paypal.com/activity/payment/46187207TX1855409,PayPal Bank 3,--,$29.81 ,"$9,182.15 "
Donations directed by individuals,12/3/23,Deposit,46187207TX1855409,04 PAYPAL GENERAL UNRESTR,Money in to PayPal,Contributed income:Donations directed by individuals,PayPal Bank 3,$31.40 ,"$9,213.55 "
PayPal Fees,12/3/23,Deposit,46187207TX1855409,04 PAYPAL GENERAL UNRESTR,PayPal fees,OFFICE/GENERAL ADMINISTRATIVE EXPENSES:PayPal Fees,PayPal Bank 3,$1.59 ,"$9,215.14 "
PayPal Bank 3,12/3/23,Deposit,9NR234689J3545531,07 1000 DRONES RESTR,Subject: 1000DRONESTransaction ID: 9NR234689J3545531https://www.paypal.com/activity/payment/9NR234689J3545531,PayPal Bank 3,--,$39.38 ,"$9,254.52 "
Donations directed by individuals,12/3/23,Deposit,9NR234689J3545531,07 1000 DRONES RESTR,1000 DRONES FOR UKRAINE - 1000 DRONES FOR UKRAINE,Contributed income:Donations directed by individuals,PayPal Bank 3,$41.31 ,"$9,295.83 "
PayPal Fees,12/3/23,Deposit,9NR234689J3545531,07 1000 DRONES RESTR,PayPal fees,OFFICE/GENERAL ADMINISTRATIVE EXPENSES:PayPal Fees,PayPal Bank 3,$1.93 ,"$9,297.76 "
PayPal Bank 3,12/2/23,Deposit,11073696XU7425226,04 PAYPAL GENERAL UNRESTR,Subject: Support UkraineTransaction ID: 11073696XU7425226https://www.paypal.com/activity/payment/11073696XU7425226,PayPal Bank 3,--,$98.46 ,"$9,396.22 "
Donations directed by individuals,12/2/23,Deposit,11073696XU7425226,04 PAYPAL GENERAL UNRESTR,Money in to PayPal,Contributed income:Donations directed by individuals,PayPal Bank 3,$102.53 ,"$9,498.75 "
PayPal Fees,12/2/23,Deposit,11073696XU7425226,04 PAYPAL GENERAL UNRESTR,PayPal fees,OFFICE/GENERAL ADMINISTRATIVE EXPENSES:PayPal Fees,PayPal Bank 3,$4.07 ,"$9,502.82 "
PayPal Bank 3,12/2/23,Deposit,0CP924885F354503J,04 PAYPAL GENERAL UNRESTR,Subject: Support UkraineTransaction ID: 0CP924885F354503Jhttps://www.paypal.com/activity/payment/0CP924885F354503J,PayPal Bank 3,--,$11.92 ,"$9,514.74 "
Donations directed by individuals,12/2/23,Deposit,0CP924885F354503J,04 PAYPAL GENERAL UNRESTR,Money in to PayPal,Contributed income:Donations directed by individuals,PayPal Bank 3,$12.86 ,"$9,527.60 "
PayPal Fees,12/2/23,Deposit,0CP924885F354503J,04 PAYPAL GENERAL UNRESTR,PayPal fees,OFFICE/GENERAL ADMINISTRATIVE EXPENSES:PayPal Fees,PayPal Bank 3,$0.94 ,"$9,528.54 "
PayPal Bank 3,12/2/23,Deposit,02N4600043226100L,04 PAYPAL GENERAL UNRESTR,Subject: Support UkraineTransaction ID: 02N4600043226100Lhttps://www.paypal.com/activity/payment/02N4600043226100L,PayPal Bank 3,--,$50.00 ,"$9,578.54 "
Donations directed by individuals,12/2/23,Deposit,02N4600043226100L,04 PAYPAL GENERAL UNRESTR,Money in to PayPal,Contributed income:Donations directed by individuals,PayPal Bank 3,$51.52 ,"$9,630.06 "
PayPal Fees,12/2/23,Deposit,02N4600043226100L,04 PAYPAL GENERAL UNRESTR,PayPal fees,OFFICE/GENERAL ADMINISTRATIVE EXPENSES:PayPal Fees,PayPal Bank 3,$1.52 ,"$9,631.58 "
PayPal Bank 3,12/2/23,Deposit,6K608748WN374724M,04 PAYPAL GENERAL UNRESTR,Subject: Support UkraineTransaction ID: 6K608748WN374724Mhttps://www.paypal.com/activity/payment/6K608748WN374724M,PayPal Bank 3,--,$9.84 ,"$9,641.42 "
Donations directed by individuals,12/2/23,Deposit,6K608748WN374724M,04 PAYPAL GENERAL UNRESTR,Money in to PayPal,Contributed income:Donations directed by individuals,PayPal Bank 3,$10.70 ,"$9,652.12 "
PayPal Fees,12/2/23,Deposit,6K608748WN374724M,04 PAYPAL GENERAL UNRESTR,PayPal fees,OFFICE/GENERAL ADMINISTRATIVE EXPENSES:PayPal Fees,PayPal Bank 3,$0.86 ,"$9,652.98 "
PayPal Bank 3,12/2/23,Deposit,7XN56402RU782734M,07 1000 DRONES RESTR,Subject: 1000 DRONES FOR UKRAINETransaction ID: 7XN56402RU782734Mhttps://www.paypal.com/activity/payment/7XN56402RU782734M,PayPal Bank 3,--,$10.93 ,"$9,663.91 "
Donations directed by individuals,12/2/23,Deposit,7XN56402RU782734M,07 1000 DRONES RESTR,Money in to PayPal,Contributed income:Donations directed by individuals,PayPal Bank 3,$11.83 ,"$9,675.74 "
PayPal Fees,12/2/23,Deposit,7XN56402RU782734M,07 1000 DRONES RESTR,PayPal fees,OFFICE/GENERAL ADMINISTRATIVE EXPENSES:PayPal Fees,PayPal Bank 3,$0.90 ,"$9,676.64 "
PayPal Bank 3,12/2/23,Deposit,5BY80095R6474682F,04 PAYPAL GENERAL UNRESTR,Subject: GeneralPageTransaction ID: 5BY80095R6474682Fhttps://www.paypal.com/activity/payment/5BY80095R6474682F,PayPal Bank 3,--,$20.00 ,"$9,696.64 "
Donations directed by individuals,12/2/23,Deposit,5BY80095R6474682F,04 PAYPAL GENERAL UNRESTR,Support Ukraine - Support Ukraine,Contributed income:Donations directed by individuals,PayPal Bank 3,$20.91 ,"$9,717.55 "
PayPal Fees,12/2/23,Deposit,5BY80095R6474682F,04 PAYPAL GENERAL UNRESTR,PayPal fees,OFFICE/GENERAL ADMINISTRATIVE EXPENSES:PayPal Fees,PayPal Bank 3,$0.91 ,"$9,718.46 "
PayPal Bank 3,12/2/23,Deposit,3AS38946658066733,04 PAYPAL GENERAL UNRESTR,Subject: GeneralPageTransaction ID: 3AS38946658066733https://www.paypal.com/activity/payment/3AS38946658066733,PayPal Bank 3,--,$45.00 ,"$9,763.46 "
Donations directed by individuals,12/2/23,Deposit,3AS38946658066733,04 PAYPAL GENERAL UNRESTR,Support Ukraine - Support Ukraine,Contributed income:Donations directed by individuals,PayPal Bank 3,$46.41 ,"$9,809.87 "
PayPal Fees,12/2/23,Deposit,3AS38946658066733,04 PAYPAL GENERAL UNRESTR,PayPal fees,OFFICE/GENERAL ADMINISTRATIVE EXPENSES:PayPal Fees,PayPal Bank 3,$1.41 ,"$9,811.28 "
PayPal Bank 3,12/2/23,Deposit,3GM43201MR696333F,04 PAYPAL GENERAL UNRESTR,Subject: GeneralPageTransaction ID: 3GM43201MR696333Fhttps://www.paypal.com/activity/payment/3GM43201MR696333F,PayPal Bank 3,--,$9.31 ,"$9,820.59 "
Donations directed by individuals,12/2/23,Deposit,3GM43201MR696333F,04 PAYPAL GENERAL UNRESTR,Support Ukraine - Support Ukraine,Contributed income:Donations directed by individuals,PayPal Bank 3,$10.00 ,"$9,830.59 "
PayPal Fees,12/2/23,Deposit,3GM43201MR696333F,04 PAYPAL GENERAL UNRESTR,PayPal fees,OFFICE/GENERAL ADMINISTRATIVE EXPENSES:PayPal Fees,PayPal Bank 3,$0.69 ,"$9,831.28 "
PayPal Bank 3,12/2/23,Deposit,02D87778EF7692116,07 1000 DRONES RESTR,Subject: 1000DRONESTransaction ID: 02D87778EF7692116https://www.paypal.com/activity/payment/02D87778EF7692116,PayPal Bank 3,--,$33.81 ,"$9,865.09 "
Donations directed by individuals,12/2/23,Deposit,02D87778EF7692116,07 1000 DRONES RESTR,1000 DRONES FOR UKRAINE - 1000 DRONES FOR UKRAINE,Contributed income:Donations directed by individuals,PayPal Bank 3,$35.00 ,"$9,900.09 "
PayPal Fees,12/2/23,Deposit,02D87778EF7692116,07 1000 DRONES RESTR,PayPal fees,OFFICE/GENERAL ADMINISTRATIVE EXPENSES:PayPal Fees,PayPal Bank 3,$1.19 ,"$9,901.28 "
PayPal Bank 3,12/2/23,Deposit,15619324US543410T,04 PAYPAL GENERAL UNRESTR,Subject: GeneralPageTransaction ID: 15619324US543410Thttps://www.paypal.com/activity/payment/15619324US543410T,PayPal Bank 3,--,$40.00 ,"$9,941.28 "
Donations directed by individuals,12/2/23,Deposit,15619324US543410T,04 PAYPAL GENERAL UNRESTR,Support Ukraine - Support Ukraine,Contributed income:Donations directed by individuals,PayPal Bank 3,$41.31 ,"$9,982.59 "
PayPal Fees,12/2/23,Deposit,15619324US543410T,04 PAYPAL GENERAL UNRESTR,PayPal fees,OFFICE/GENERAL ADMINISTRATIVE EXPENSES:PayPal Fees,PayPal Bank 3,$1.31 ,"$9,983.90 "
PayPal Bank 3,12/2/23,Deposit,98P35547VD153335N,04 PAYPAL GENERAL UNRESTR,Note: Flower Painting fundraiserTransaction ID: 98P35547VD153335Nhttps://www.paypal.com/activity/payment/98P35547VD153335N,PayPal Bank 3,--,$33.81 ,"$10,017.71 "
Donations directed by individuals,12/2/23,Deposit,98P35547VD153335N,04 PAYPAL GENERAL UNRESTR,Money in to PayPal,Contributed income:Donations directed by individuals,PayPal Bank 3,$35.00 ,"$10,052.71 "
PayPal Fees,12/2/23,Deposit,98P35547VD153335N,04 PAYPAL GENERAL UNRESTR,PayPal fees,OFFICE/GENERAL ADMINISTRATIVE EXPENSES:PayPal Fees,PayPal Bank 3,$1.19 ,"$10,053.90 "
PayPal Bank 3,12/2/23,Deposit,21248917KM7991249,04 PAYPAL GENERAL UNRESTR,Subject: GeneralPageTransaction ID: 21248917KM7991249https://www.paypal.com/activity/payment/21248917KM7991249,PayPal Bank 3,--,$68.12 ,"$10,122.02 "
Donations directed by individuals,12/2/23,Deposit,21248917KM7991249,04 PAYPAL GENERAL UNRESTR,Support Ukraine - Support Ukraine,Contributed income:Donations directed by individuals,PayPal Bank 3,$70.00 ,"$10,192.02 "
PayPal Fees,12/2/23,Deposit,21248917KM7991249,04 PAYPAL GENERAL UNRESTR,PayPal fees,OFFICE/GENERAL ADMINISTRATIVE EXPENSES:PayPal Fees,PayPal Bank 3,$1.88 ,"$10,193.90 "
PayPal Bank 3,12/2/23,Deposit,2MR64989XV673864D,04 PAYPAL GENERAL UNRESTR,Subject: GeneralPageTransaction ID: 2MR64989XV673864Dhttps://www.paypal.com/activity/payment/2MR64989XV673864D,PayPal Bank 3,--,$14.21 ,"$10,208.11 "
Donations directed by individuals,12/2/23,Deposit,2MR64989XV673864D,04 PAYPAL GENERAL UNRESTR,Support Ukraine - Support Ukraine,Contributed income:Donations directed by individuals,PayPal Bank 3,$15.00 ,"$10,223.11 "
PayPal Fees,12/2/23,Deposit,2MR64989XV673864D,04 PAYPAL GENERAL UNRESTR,PayPal fees,OFFICE/GENERAL ADMINISTRATIVE EXPENSES:PayPal Fees,PayPal Bank 3,$0.79 ,"$10,223.90 "
PayPal Bank 3,12/2/23,Deposit,64T689865K3999101,09 MSU RESTR,Subject: New 10 UnitsTransaction ID: 64T689865K3999101https://www.paypal.com/activity/payment/64T689865K3999101,PayPal Bank 3,--,$979.61 ,"$11,203.51 "
Donations directed by individuals,12/2/23,Deposit,64T689865K3999101,09 MSU RESTR,donation-form,Contributed income:Donations directed by individuals,PayPal Bank 3,"$1,000.00 ","$12,203.51 "
PayPal Fees,12/2/23,Deposit,64T689865K3999101,09 MSU RESTR,PayPal fees,OFFICE/GENERAL ADMINISTRATIVE EXPENSES:PayPal Fees,PayPal Bank 3,$20.39 ,"$12,223.90 "
PayPal Bank 3,12/2/23,Deposit,0X191330EH9103244,04 PAYPAL GENERAL UNRESTR,Subject: GeneralPageTransaction ID: 0X191330EH9103244https://www.paypal.com/activity/payment/0X191330EH9103244,PayPal Bank 3,--,$19.69 ,"$12,243.59 "
Donations directed by individuals,12/2/23,Deposit,0X191330EH9103244,04 PAYPAL GENERAL UNRESTR,Support Ukraine - Support Ukraine,Contributed income:Donations directed by individuals,PayPal Bank 3,$20.91 ,"$12,264.50 "
PayPal Fees,12/2/23,Deposit,0X191330EH9103244,04 PAYPAL GENERAL UNRESTR,PayPal fees,OFFICE/GENERAL ADMINISTRATIVE EXPENSES:PayPal Fees,PayPal Bank 3,$1.22 ,"$12,265.72 "
PayPal Bank 3,12/1/23,Deposit,12S75413G5573382F,07 1000 DRONES RESTR,Subject: 1000 DRONES FOR UKRAINETransaction ID: 12S75413G5573382Fhttps://www.paypal.com/activity/payment/12S75413G5573382F,PayPal Bank 3,--,$24.84 ,"$12,290.56 "
Donations directed by individuals,12/1/23,Deposit,12S75413G5573382F,07 1000 DRONES RESTR,Money in to PayPal,Contributed income:Donations directed by individuals,PayPal Bank 3,$26.25 ,"$12,316.81 "
PayPal Fees,12/1/23,Deposit,12S75413G5573382F,07 1000 DRONES RESTR,PayPal fees,OFFICE/GENERAL ADMINISTRATIVE EXPENSES:PayPal Fees,PayPal Bank 3,$1.41 ,"$12,318.22 "
PayPal Bank 3,12/1/23,Deposit,8TF70532EK564994C,04 PAYPAL GENERAL UNRESTR,Subject: GeneralPageTransaction ID: 8TF70532EK564994Chttps://www.paypal.com/activity/payment/8TF70532EK564994C,PayPal Bank 3,--,$50.00 ,"$12,368.22 "
Donations directed by individuals,12/1/23,Deposit,8TF70532EK564994C,04 PAYPAL GENERAL UNRESTR,Support Ukraine - Support Ukraine,Contributed income:Donations directed by individuals,PayPal Bank 3,$51.52 ,"$12,419.74 "
PayPal Fees,12/1/23,Deposit,8TF70532EK564994C,04 PAYPAL GENERAL UNRESTR,PayPal fees,OFFICE/GENERAL ADMINISTRATIVE EXPENSES:PayPal Fees,PayPal Bank 3,$1.52 ,"$12,421.26 "
PayPal Bank 3,12/1/23,Deposit,7A458619XU585532C,04 PAYPAL GENERAL UNRESTR,Subject: GeneralPageTransaction ID: 7A458619XU585532Chttps://www.paypal.com/activity/payment/7A458619XU585532C,PayPal Bank 3,--,$39.38 ,"$12,460.64 "
Donations directed by individuals,12/1/23,Deposit,7A458619XU585532C,04 PAYPAL GENERAL UNRESTR,Support Ukraine - Support Ukraine,Contributed income:Donations directed by individuals,PayPal Bank 3,$41.31 ,"$12,501.95 "
PayPal Fees,12/1/23,Deposit,7A458619XU585532C,04 PAYPAL GENERAL UNRESTR,PayPal fees,OFFICE/GENERAL ADMINISTRATIVE EXPENSES:PayPal Fees,PayPal Bank 3,$1.93 ,"$12,503.88 "
PayPal Bank 3,12/1/23,Deposit,3UN72140TN081664C,09 MSU RESTR,Subject: New 10 UnitsTransaction ID: 3UN72140TN081664Chttps://www.paypal.com/activity/payment/3UN72140TN081664C,PayPal Bank 3,--,$587.57 ,"$13,091.45 "
Donations directed by individuals,12/1/23,Deposit,3UN72140TN081664C,09 MSU RESTR,donation-form,Contributed income:Donations directed by individuals,PayPal Bank 3,$600.00 ,"$13,691.45 "
PayPal Fees,12/1/23,Deposit,3UN72140TN081664C,09 MSU RESTR,PayPal fees,OFFICE/GENERAL ADMINISTRATIVE EXPENSES:PayPal Fees,PayPal Bank 3,$12.43 ,"$13,703.88 "
PayPal Bank 3,12/1/23,Deposit,8K144118BW632884Y,07 1000 DRONES RESTR,Subject: 1000DRONESTransaction ID: 8K144118BW632884Yhttps://www.paypal.com/activity/payment/8K144118BW632884Y,PayPal Bank 3,--,$49.23 ,"$13,753.11 "
Donations directed by individuals,12/1/23,Deposit,8K144118BW632884Y,07 1000 DRONES RESTR,1000 DRONES FOR UKRAINE - 1000 DRONES FOR UKRAINE,Contributed income:Donations directed by individuals,PayPal Bank 3,$51.52 ,"$13,804.63 "
PayPal Fees,12/1/23,Deposit,8K144118BW632884Y,07 1000 DRONES RESTR,PayPal fees,OFFICE/GENERAL ADMINISTRATIVE EXPENSES:PayPal Fees,PayPal Bank 3,$2.29 ,"$13,806.92 "
PayPal Bank 3,12/1/23,Deposit,17899519B7235184L,04 PAYPAL GENERAL UNRESTR,Subject: GeneralPageTransaction ID: 17899519B7235184Lhttps://www.paypal.com/activity/payment/17899519B7235184L,PayPal Bank 3,--,$50.00 ,"$13,856.92 "
Donations directed by individuals,12/1/23,Deposit,17899519B7235184L,04 PAYPAL GENERAL UNRESTR,Support Ukraine - Support Ukraine,Contributed income:Donations directed by individuals,PayPal Bank 3,$51.52 ,"$13,908.44 "
PayPal Fees,12/1/23,Deposit,17899519B7235184L,04 PAYPAL GENERAL UNRESTR,PayPal fees,OFFICE/GENERAL ADMINISTRATIVE EXPENSES:PayPal Fees,PayPal Bank 3,$1.52 ,"$13,909.96 "
CHASE ENDING IN 5315,11/30/23,Deposit,--,05 VENMO UNRESTR,ORIG CO NAME:VENMO ORIG ID:5264681992 DESC DATE:231129 CO ENTRY DESCR:CASHOUT SEC:PPD TRACE#:091000016292346 EED:231130 IND ID: IND NAME:OKSANA PATRINA TRN: 334 XXX2346TC,CHASE ENDING IN 5315,Donations directed by individuals,$17.56 ,"$13,927.52 "
Donations directed by individuals,11/30/23,Deposit,--,05 VENMO UNRESTR,ORIG CO NAME:VENMO ORIG ID:5264681992 DESC DATE:231129 CO ENTRY DESCR:CASHOUT SEC:PPD TRACE#:091000016292346 EED:231130 IND ID: IND NAME:OKSANA PATRINA TRN: 334 XXX2346TC,Contributed income:Donations directed by individuals,CHASE ENDING IN 5315,$17.56 ,"$13,945.08 "
PayPal Bank 3,11/30/23,Deposit,0CS30330TE368115M,04 PAYPAL GENERAL UNRESTR,"Subject: GeneralPageNote: Greetings, This is Lesya Kalynska.   This donation of $55.  00 dollars was from our screening of A Rising Fury at Penn State University on Sept 15th 2023 from cash donations.   Money from ticket sales was already sent to Dignitas from the movie theater.Transaction ID: 0CS30330TE368115Mhttps://www.paypal.com/activity/payment/0CS30330TE368115M",PayPal Bank 3,--,$53.42 ,"$13,998.50 "
Donations directed by individuals,11/30/23,Deposit,0CS30330TE368115M,04 PAYPAL GENERAL UNRESTR,Support Ukraine - Support Ukraine,Contributed income:Donations directed by individuals,PayPal Bank 3,$55.00 ,"$14,053.50 "
PayPal Fees,11/30/23,Deposit,0CS30330TE368115M,04 PAYPAL GENERAL UNRESTR,PayPal fees,OFFICE/GENERAL ADMINISTRATIVE EXPENSES:PayPal Fees,PayPal Bank 3,$1.58 ,"$14,055.08 "
PayPal Bank 3,11/30/23,Deposit,9SK59048RM7511043,04 PAYPAL GENERAL UNRESTR,Subject: Support UkraineTransaction ID: 9SK59048RM7511043https://www.paypal.com/activity/payment/9SK59048RM7511043,PayPal Bank 3,--,$195.53 ,"$14,250.61 "
Donations directed by individuals,11/30/23,Deposit,9SK59048RM7511043,04 PAYPAL GENERAL UNRESTR,Money in to PayPal,Contributed income:Donations directed by individuals,PayPal Bank 3,$200.00 ,"$14,450.61 "
PayPal Fees,11/30/23,Deposit,9SK59048RM7511043,04 PAYPAL GENERAL UNRESTR,PayPal fees,OFFICE/GENERAL ADMINISTRATIVE EXPENSES:PayPal Fees,PayPal Bank 3,$4.47 ,"$14,455.08 "
PayPal Bank 3,11/30/23,Deposit,2DG09611EF440872B,04 PAYPAL GENERAL UNRESTR,Subject: Support UkraineTransaction ID: 2DG09611EF440872Bhttps://www.paypal.com/activity/payment/2DG09611EF440872B,PayPal Bank 3,--,$5.30 ,"$14,460.38 "
Donations directed by individuals,11/30/23,Deposit,2DG09611EF440872B,04 PAYPAL GENERAL UNRESTR,Money in to PayPal,Contributed income:Donations directed by individuals,PayPal Bank 3,$6.00 ,"$14,466.38 "
PayPal Fees,11/30/23,Deposit,2DG09611EF440872B,04 PAYPAL GENERAL UNRESTR,PayPal fees,OFFICE/GENERAL ADMINISTRATIVE EXPENSES:PayPal Fees,PayPal Bank 3,$0.70 ,"$14,467.08 "
PayPal Bank 3,11/30/23,Deposit,3W567774510323132,04 PAYPAL GENERAL UNRESTR,Subject: GeneralPageTransaction ID: 3W567774510323132https://www.paypal.com/activity/payment/3W567774510323132,PayPal Bank 3,--,$147.70 ,"$14,614.78 "
Donations directed by individuals,11/30/23,Deposit,3W567774510323132,04 PAYPAL GENERAL UNRESTR,Support Ukraine - Support Ukraine,Contributed income:Donations directed by individuals,PayPal Bank 3,$153.55 ,"$14,768.33 "
PayPal Fees,11/30/23,Deposit,3W567774510323132,04 PAYPAL GENERAL UNRESTR,PayPal fees,OFFICE/GENERAL ADMINISTRATIVE EXPENSES:PayPal Fees,PayPal Bank 3,$5.85 ,"$14,774.18 "
PayPal Bank 3,11/29/23,Deposit,5WL80655TV345940T,09 MSU RESTR,Subject: New 10 UnitsTransaction ID: 5WL80655TV345940Thttps://www.paypal.com/activity/payment/5WL80655TV345940T,PayPal Bank 3,--,$24.01 ,"$14,798.19 "
Donations directed by individuals,11/29/23,Deposit,5WL80655TV345940T,09 MSU RESTR,donation-form,Contributed income:Donations directed by individuals,PayPal Bank 3,$25.00 ,"$14,823.19 "
PayPal Fees,11/29/23,Deposit,5WL80655TV345940T,09 MSU RESTR,PayPal fees,OFFICE/GENERAL ADMINISTRATIVE EXPENSES:PayPal Fees,PayPal Bank 3,$0.99 ,"$14,824.18 "
PayPal Bank 3,11/29/23,Deposit,6FS94151GG3464215,09 MSU RESTR,Subject: New 10 UnitsTransaction ID: 6FS94151GG3464215https://www.paypal.com/activity/payment/6FS94151GG3464215,PayPal Bank 3,--,$9.16 ,"$14,833.34 "
Donations directed by individuals,11/29/23,Deposit,6FS94151GG3464215,09 MSU RESTR,donation-form,Contributed income:Donations directed by individuals,PayPal Bank 3,$10.00 ,"$14,843.34 "
PayPal Fees,11/29/23,Deposit,6FS94151GG3464215,09 MSU RESTR,PayPal fees,OFFICE/GENERAL ADMINISTRATIVE EXPENSES:PayPal Fees,PayPal Bank 3,$0.84 ,"$14,844.18 "
PayPal Bank 3,11/29/23,Deposit,190458380N117622W,10 Flight to Recovery RESTR,Subject: FlightToRecoveryTransaction ID: 190458380N117622Whttps://www.paypal.com/activity/payment/190458380N117622W,PayPal Bank 3,--,$9.84 ,"$14,854.02 "
Donations directed by individuals,11/29/23,Deposit,190458380N117622W,10 Flight to Recovery RESTR,Flight to Recovery - Flight to Recovery,Contributed income:Donations directed by individuals,PayPal Bank 3,$10.70 ,"$14,864.72 "
PayPal Fees,11/29/23,Deposit,190458380N117622W,10 Flight to Recovery RESTR,PayPal fees,OFFICE/GENERAL ADMINISTRATIVE EXPENSES:PayPal Fees,PayPal Bank 3,$0.86 ,"$14,865.58 "
PayPal Bank 3,11/29/23,Deposit,8EW08251KA338861B,09 MSU RESTR,Subject: New 10 UnitsTransaction ID: 8EW08251KA338861Bhttps://www.paypal.com/activity/payment/8EW08251KA338861B,PayPal Bank 3,--,$9.16 ,"$14,874.74 "
Donations directed by individuals,11/29/23,Deposit,8EW08251KA338861B,09 MSU RESTR,donation-form,Contributed income:Donations directed by individuals,PayPal Bank 3,$10.00 ,"$14,884.74 "
PayPal Fees,11/29/23,Deposit,8EW08251KA338861B,09 MSU RESTR,PayPal fees,OFFICE/GENERAL ADMINISTRATIVE EXPENSES:PayPal Fees,PayPal Bank 3,$0.84 ,"$14,885.58 "
PayPal Bank 3,11/29/23,Deposit,8ES85625GF749702K,07 1000 DRONES RESTR,Subject: 1000DRONESTransaction ID: 8ES85625GF749702Khttps://www.paypal.com/activity/payment/8ES85625GF749702K,PayPal Bank 3,--,$9.84 ,"$14,895.42 "
Donations directed by individuals,11/29/23,Deposit,8ES85625GF749702K,07 1000 DRONES RESTR,1000 DRONES FOR UKRAINE - 1000 DRONES FOR UKRAINE,Contributed income:Donations directed by individuals,PayPal Bank 3,$10.70 ,"$14,906.12 "
PayPal Fees,11/29/23,Deposit,8ES85625GF749702K,07 1000 DRONES RESTR,PayPal fees,OFFICE/GENERAL ADMINISTRATIVE EXPENSES:PayPal Fees,PayPal Bank 3,$0.86 ,"$14,906.98 "
PayPal Bank 3,11/29/23,Deposit,9S591860SA3967359,04 PAYPAL GENERAL UNRESTR,Subject: Support UkraineTransaction ID: 9S591860SA3967359https://www.paypal.com/activity/payment/9S591860SA3967359,PayPal Bank 3,--,$99.38 ,"$15,006.36 "
Donations directed by individuals,11/29/23,Deposit,9S591860SA3967359,04 PAYPAL GENERAL UNRESTR,Money in to PayPal,Contributed income:Donations directed by individuals,PayPal Bank 3,$103.48 ,"$15,109.84 "
PayPal Fees,11/29/23,Deposit,9S591860SA3967359,04 PAYPAL GENERAL UNRESTR,PayPal fees,OFFICE/GENERAL ADMINISTRATIVE EXPENSES:PayPal Fees,PayPal Bank 3,$4.10 ,"$15,113.94 "
PayPal Bank 3,11/29/23,Deposit,17F37046TV0274405,08 VICTORY DRONES RESTR,Subject: VictoryDronesTransaction ID: 17F37046TV0274405https://www.paypal.com/activity/payment/17F37046TV0274405,PayPal Bank 3,--,$47.76 ,"$15,161.70 "
Donations directed by individuals,11/29/23,Deposit,17F37046TV0274405,08 VICTORY DRONES RESTR,VICTORY DRONES - VICTORY DRONES,Contributed income:Donations directed by individuals,PayPal Bank 3,$50.00 ,"$15,211.70 "
PayPal Fees,11/29/23,Deposit,17F37046TV0274405,08 VICTORY DRONES RESTR,PayPal fees,OFFICE/GENERAL ADMINISTRATIVE EXPENSES:PayPal Fees,PayPal Bank 3,$2.24 ,"$15,213.94 "
PayPal Bank 3,11/29/23,Transfer,--,--,Transaction ID: 3P105627UP255000Khttps://www.paypal.com/activity/payment/3P105627UP255000K,PayPal Bank 3,CHASE ENDING IN 5315,"($17,500.00)","($2,286.06)"
CHASE ENDING IN 5315,11/29/23,Transfer,--,--,Transaction ID: 3P105627UP255000Khttps://www.paypal.com/activity/payment/3P105627UP255000K,CHASE ENDING IN 5315,PayPal Bank 3,"$17,500.00 ","$15,213.94 "
PayPal Bank 3,11/29/23,Deposit,17443188F22916318,07 1000 DRONES RESTR,Subject: 1000DRONESTransaction ID: 17443188F22916318https://www.paypal.com/activity/payment/17443188F22916318,PayPal Bank 3,--,$157.55 ,"$15,371.49 "
Donations directed by individuals,11/29/23,Deposit,17443188F22916318,07 1000 DRONES RESTR,1000 DRONES FOR UKRAINE - 1000 DRONES FOR UKRAINE,Contributed income:Donations directed by individuals,PayPal Bank 3,$163.75 ,"$15,535.24 "
PayPal Fees,11/29/23,Deposit,17443188F22916318,07 1000 DRONES RESTR,PayPal fees,OFFICE/GENERAL ADMINISTRATIVE EXPENSES:PayPal Fees,PayPal Bank 3,$6.20 ,"$15,541.44 "
PayPal Bank 3,11/29/23,Deposit,4WF43322KG673811P,07 1000 DRONES RESTR,Subject: 1000DRONESTransaction ID: 4WF43322KG673811Phttps://www.paypal.com/activity/payment/4WF43322KG673811P,PayPal Bank 3,--,$47.76 ,"$15,589.20 "
Donations directed by individuals,11/29/23,Deposit,4WF43322KG673811P,07 1000 DRONES RESTR,1000 DRONES FOR UKRAINE - 1000 DRONES FOR UKRAINE,Contributed income:Donations directed by individuals,PayPal Bank 3,$50.00 ,"$15,639.20 "
PayPal Fees,11/29/23,Deposit,4WF43322KG673811P,07 1000 DRONES RESTR,PayPal fees,OFFICE/GENERAL ADMINISTRATIVE EXPENSES:PayPal Fees,PayPal Bank 3,$2.24 ,"$15,641.44 "
PayPal Bank 3,11/28/23,Deposit,8192284935956112L,09 MSU RESTR,Subject: New 10 UnitsTransaction ID: 8192284935956112Lhttps://www.paypal.com/activity/payment/8192284935956112L,PayPal Bank 3,--,$19.11 ,"$15,660.55 "
Donations directed by individuals,11/28/23,Deposit,8192284935956112L,09 MSU RESTR,donation-form,Contributed income:Donations directed by individuals,PayPal Bank 3,$20.00 ,"$15,680.55 "
PayPal Fees,11/28/23,Deposit,8192284935956112L,09 MSU RESTR,PayPal fees,OFFICE/GENERAL ADMINISTRATIVE EXPENSES:PayPal Fees,PayPal Bank 3,$0.89 ,"$15,681.44 "
PayPal Bank 3,11/28/23,Deposit,8RK724992B876601F,04 PAYPAL GENERAL UNRESTR,Subject: Support UkraineTransaction ID: 8RK724992B876601Fhttps://www.paypal.com/activity/payment/8RK724992B876601F,PayPal Bank 3,--,$149.07 ,"$15,830.51 "
Donations directed by individuals,11/28/23,Deposit,8RK724992B876601F,04 PAYPAL GENERAL UNRESTR,Money in to PayPal,Contributed income:Donations directed by individuals,PayPal Bank 3,$154.97 ,"$15,985.48 "
PayPal Fees,11/28/23,Deposit,8RK724992B876601F,04 PAYPAL GENERAL UNRESTR,PayPal fees,OFFICE/GENERAL ADMINISTRATIVE EXPENSES:PayPal Fees,PayPal Bank 3,$5.90 ,"$15,991.38 "
PayPal Bank 3,11/28/23,Deposit,2GF93699TM888840D,04 PAYPAL GENERAL UNRESTR,Subject: Support UkraineTransaction ID: 2GF93699TM888840Dhttps://www.paypal.com/activity/payment/2GF93699TM888840D,PayPal Bank 3,--,$50.47 ,"$16,041.85 "
Donations directed by individuals,11/28/23,Deposit,2GF93699TM888840D,04 PAYPAL GENERAL UNRESTR,Money in to PayPal,Contributed income:Donations directed by individuals,PayPal Bank 3,$51.99 ,"$16,093.84 "
PayPal Fees,11/28/23,Deposit,2GF93699TM888840D,04 PAYPAL GENERAL UNRESTR,PayPal fees,OFFICE/GENERAL ADMINISTRATIVE EXPENSES:PayPal Fees,PayPal Bank 3,$1.52 ,"$16,095.36 "
PayPal Bank 3,11/28/23,Deposit,93825927UJ649100V,04 PAYPAL GENERAL UNRESTR,Subject: Support UkraineTransaction ID: 93825927UJ649100Vhttps://www.paypal.com/activity/payment/93825927UJ649100V,PayPal Bank 3,--,$24.84 ,"$16,120.20 "
Donations directed by individuals,11/28/23,Deposit,93825927UJ649100V,04 PAYPAL GENERAL UNRESTR,Money in to PayPal,Contributed income:Donations directed by individuals,PayPal Bank 3,$26.25 ,"$16,146.45 "
PayPal Fees,11/28/23,Deposit,93825927UJ649100V,04 PAYPAL GENERAL UNRESTR,PayPal fees,OFFICE/GENERAL ADMINISTRATIVE EXPENSES:PayPal Fees,PayPal Bank 3,$1.41 ,"$16,147.86 "
PayPal Bank 3,11/28/23,Deposit,6PP442992V526344F,04 PAYPAL GENERAL UNRESTR,Subject: Support UkraineTransaction ID: 6PP442992V526344Fhttps://www.paypal.com/activity/payment/6PP442992V526344F,PayPal Bank 3,--,$9.93 ,"$16,157.79 "
Donations directed by individuals,11/28/23,Deposit,6PP442992V526344F,04 PAYPAL GENERAL UNRESTR,Money in to PayPal,Contributed income:Donations directed by individuals,PayPal Bank 3,$10.80 ,"$16,168.59 "
PayPal Fees,11/28/23,Deposit,6PP442992V526344F,04 PAYPAL GENERAL UNRESTR,PayPal fees,OFFICE/GENERAL ADMINISTRATIVE EXPENSES:PayPal Fees,PayPal Bank 3,$0.87 ,"$16,169.46 "
PayPal Bank 3,11/28/23,Deposit,7NL890112F382811B,04 PAYPAL GENERAL UNRESTR,Subject: Support UkraineTransaction ID: 7NL890112F382811Bhttps://www.paypal.com/activity/payment/7NL890112F382811B,PayPal Bank 3,--,$4.96 ,"$16,174.42 "
Donations directed by individuals,11/28/23,Deposit,7NL890112F382811B,04 PAYPAL GENERAL UNRESTR,Money in to PayPal,Contributed income:Donations directed by individuals,PayPal Bank 3,$5.65 ,"$16,180.07 "
PayPal Fees,11/28/23,Deposit,7NL890112F382811B,04 PAYPAL GENERAL UNRESTR,PayPal fees,OFFICE/GENERAL ADMINISTRATIVE EXPENSES:PayPal Fees,PayPal Bank 3,$0.69 ,"$16,180.76 "
PayPal Bank 3,11/28/23,Deposit,9UK79911ED425482A,07 1000 DRONES RESTR,"Subject: 1000DRONESNote: Birthday wishes for/from my cousin, Levko! Slava Ukraini!Transaction ID: 9UK79911ED425482Ahttps://www.paypal.com/activity/payment/9UK79911ED425482A",PayPal Bank 3,--,$98.46 ,"$16,279.22 "
Donations directed by individuals,11/28/23,Deposit,9UK79911ED425482A,07 1000 DRONES RESTR,1000 DRONES FOR UKRAINE - 1000 DRONES FOR UKRAINE,Contributed income:Donations directed by individuals,PayPal Bank 3,$102.53 ,"$16,381.75 "
PayPal Fees,11/28/23,Deposit,9UK79911ED425482A,07 1000 DRONES RESTR,PayPal fees,OFFICE/GENERAL ADMINISTRATIVE EXPENSES:PayPal Fees,PayPal Bank 3,$4.07 ,"$16,385.82 "
PayPal Bank 3,11/28/23,Deposit,0MW09868S0906745E,04 PAYPAL GENERAL UNRESTR,Subject: GeneralPageTransaction ID: 0MW09868S0906745Ehttps://www.paypal.com/activity/payment/0MW09868S0906745E,PayPal Bank 3,--,$20.00 ,"$16,405.82 "
Donations directed by individuals,11/28/23,Deposit,0MW09868S0906745E,04 PAYPAL GENERAL UNRESTR,Support Ukraine - Support Ukraine,Contributed income:Donations directed by individuals,PayPal Bank 3,$20.91 ,"$16,426.73 "
PayPal Fees,11/28/23,Deposit,0MW09868S0906745E,04 PAYPAL GENERAL UNRESTR,PayPal fees,OFFICE/GENERAL ADMINISTRATIVE EXPENSES:PayPal Fees,PayPal Bank 3,$0.91 ,"$16,427.64 "
PayPal Bank 3,11/28/23,Deposit,76F9214224917952X,09 MSU RESTR,Subject: New 10 UnitsTransaction ID: 76F9214224917952Xhttps://www.paypal.com/activity/payment/76F9214224917952X,PayPal Bank 3,--,$48.51 ,"$16,476.15 "
Donations directed by individuals,11/28/23,Deposit,76F9214224917952X,09 MSU RESTR,donation-form,Contributed income:Donations directed by individuals,PayPal Bank 3,$50.00 ,"$16,526.15 "
PayPal Fees,11/28/23,Deposit,76F9214224917952X,09 MSU RESTR,PayPal fees,OFFICE/GENERAL ADMINISTRATIVE EXPENSES:PayPal Fees,PayPal Bank 3,$1.49 ,"$16,527.64 "
PayPal Bank 3,11/28/23,Deposit,6WY25289KY4912607,09 MSU RESTR,Subject: New 10 UnitsTransaction ID: 6WY25289KY4912607https://www.paypal.com/activity/payment/6WY25289KY4912607,PayPal Bank 3,--,$97.52 ,"$16,625.16 "
Donations directed by individuals,11/28/23,Deposit,6WY25289KY4912607,09 MSU RESTR,donation-form,Contributed income:Donations directed by individuals,PayPal Bank 3,$100.00 ,"$16,725.16 "
PayPal Fees,11/28/23,Deposit,6WY25289KY4912607,09 MSU RESTR,PayPal fees,OFFICE/GENERAL ADMINISTRATIVE EXPENSES:PayPal Fees,PayPal Bank 3,$2.48 ,"$16,727.64 "
PayPal Bank 3,11/27/23,Deposit,91D50112T52088104,07 1000 DRONES RESTR,Subject: 1000DRONESTransaction ID: 91D50112T52088104https://www.paypal.com/activity/payment/91D50112T52088104,PayPal Bank 3,--,$100.00 ,"$16,827.64 "
Donations directed by individuals,11/27/23,Deposit,91D50112T52088104,07 1000 DRONES RESTR,1000 DRONES FOR UKRAINE - 1000 DRONES FOR UKRAINE,Contributed income:Donations directed by individuals,PayPal Bank 3,$102.53 ,"$16,930.17 "
PayPal Fees,11/27/23,Deposit,91D50112T52088104,07 1000 DRONES RESTR,PayPal fees,OFFICE/GENERAL ADMINISTRATIVE EXPENSES:PayPal Fees,PayPal Bank 3,$2.53 ,"$16,932.70 "
PayPal Bank 3,11/27/23,Deposit,8UM88794R53216747,04 PAYPAL GENERAL UNRESTR,Subject: GeneralPageTransaction ID: 8UM88794R53216747https://www.paypal.com/activity/payment/8UM88794R53216747,PayPal Bank 3,--,$98.46 ,"$17,031.16 "
Donations directed by individuals,11/27/23,Deposit,8UM88794R53216747,04 PAYPAL GENERAL UNRESTR,Support Ukraine - Support Ukraine,Contributed income:Donations directed by individuals,PayPal Bank 3,$102.53 ,"$17,133.69 "
PayPal Fees,11/27/23,Deposit,8UM88794R53216747,04 PAYPAL GENERAL UNRESTR,PayPal fees,OFFICE/GENERAL ADMINISTRATIVE EXPENSES:PayPal Fees,PayPal Bank 3,$4.07 ,"$17,137.76 "
PayPal Bank 3,11/27/23,Deposit,3LH984674H965421V,--,Subject: Support UkraineTransaction ID: 3LH984674H965421Vhttps://www.paypal.com/activity/payment/3LH984674H965421V,PayPal Bank 3,--,$25.24 ,"$17,163.00 "
Donations directed by individuals,11/27/23,Deposit,3LH984674H965421V,--,Money in to PayPal,Contributed income:Donations directed by individuals,PayPal Bank 3,$26.25 ,"$17,189.25 "
PayPal Fees,11/27/23,Deposit,3LH984674H965421V,--,PayPal fees,OFFICE/GENERAL ADMINISTRATIVE EXPENSES:PayPal Fees,PayPal Bank 3,$1.01 ,"$17,190.26 "
PayPal Bank 3,11/27/23,Deposit,11700335Y7511251E,10 Flight to Recovery RESTR,Subject: FlightToRecoveryTransaction ID: 11700335Y7511251Ehttps://www.paypal.com/activity/payment/11700335Y7511251E,PayPal Bank 3,--,$18.81 ,"$17,209.07 "
Donations directed by individuals,11/27/23,Deposit,11700335Y7511251E,10 Flight to Recovery RESTR,Flight to Recovery - Flight to Recovery,Contributed income:Donations directed by individuals,PayPal Bank 3,$20.00 ,"$17,229.07 "
PayPal Fees,11/27/23,Deposit,11700335Y7511251E,10 Flight to Recovery RESTR,PayPal fees,OFFICE/GENERAL ADMINISTRATIVE EXPENSES:PayPal Fees,PayPal Bank 3,$1.19 ,"$17,230.26 "
PayPal Bank 3,11/27/23,Deposit,5SC22996SP0747445,09 MSU RESTR,Subject: New 10 UnitsTransaction ID: 5SC22996SP0747445https://www.paypal.com/activity/payment/5SC22996SP0747445,PayPal Bank 3,--,$47.76 ,"$17,278.02 "
Donations directed by individuals,11/27/23,Deposit,5SC22996SP0747445,09 MSU RESTR,donation-form,Contributed income:Donations directed by individuals,PayPal Bank 3,$50.00 ,"$17,328.02 "
PayPal Fees,11/27/23,Deposit,5SC22996SP0747445,09 MSU RESTR,PayPal fees,OFFICE/GENERAL ADMINISTRATIVE EXPENSES:PayPal Fees,PayPal Bank 3,$2.24 ,"$17,330.26 "
PayPal Bank 3,11/27/23,Deposit,7HW10979F5348170E,04 PAYPAL GENERAL UNRESTR,Subject: GeneralPageNote: Thank you for your bravery.   We are 100% behind your effort.Transaction ID: 7HW10979F5348170Ehttps://www.paypal.com/activity/payment/7HW10979F5348170E,PayPal Bank 3,--,$100.00 ,"$17,430.26 "
Donations directed by individuals,11/27/23,Deposit,7HW10979F5348170E,04 PAYPAL GENERAL UNRESTR,Support Ukraine - Support Ukraine,Contributed income:Donations directed by individuals,PayPal Bank 3,$102.53 ,"$17,532.79 "
PayPal Fees,11/27/23,Deposit,7HW10979F5348170E,04 PAYPAL GENERAL UNRESTR,PayPal fees,OFFICE/GENERAL ADMINISTRATIVE EXPENSES:PayPal Fees,PayPal Bank 3,$2.53 ,"$17,535.32 "
PayPal Bank 3,11/27/23,Deposit,8S090093AM688972C,08 VICTORY DRONES RESTR,Subject: VICTORY DRONESTransaction ID: 8S090093AM688972Chttps://www.paypal.com/activity/payment/8S090093AM688972C,PayPal Bank 3,--,$100.93 ,"$17,636.25 "
Donations directed by individuals,11/27/23,Deposit,8S090093AM688972C,08 VICTORY DRONES RESTR,Money in to PayPal,Contributed income:Donations directed by individuals,PayPal Bank 3,$103.48 ,"$17,739.73 "
PayPal Fees,11/27/23,Deposit,8S090093AM688972C,08 VICTORY DRONES RESTR,PayPal fees,OFFICE/GENERAL ADMINISTRATIVE EXPENSES:PayPal Fees,PayPal Bank 3,$2.55 ,"$17,742.28 "
PayPal Bank 3,11/27/23,Deposit,0U362913815712404,04 PAYPAL GENERAL UNRESTR,Subject: GeneralPageTransaction ID: 0U362913815712404https://www.paypal.com/activity/payment/0U362913815712404,PayPal Bank 3,--,$49.23 ,"$17,791.51 "
Donations directed by individuals,11/27/23,Deposit,0U362913815712404,04 PAYPAL GENERAL UNRESTR,Support Ukraine - Support Ukraine,Contributed income:Donations directed by individuals,PayPal Bank 3,$51.52 ,"$17,843.03 "
PayPal Fees,11/27/23,Deposit,0U362913815712404,04 PAYPAL GENERAL UNRESTR,PayPal fees,OFFICE/GENERAL ADMINISTRATIVE EXPENSES:PayPal Fees,PayPal Bank 3,$2.29 ,"$17,845.32 "
PayPal Bank 3,11/27/23,Deposit,7K258496F7487793L,07 1000 DRONES RESTR,Subject: GeneralPageNote: for dronesTransaction ID: 7K258496F7487793Lhttps://www.paypal.com/activity/payment/7K258496F7487793L,PayPal Bank 3,--,$50.66 ,"$17,895.98 "
Donations directed by individuals,11/27/23,Deposit,7K258496F7487793L,07 1000 DRONES RESTR,Support Ukraine - Support Ukraine,Contributed income:Donations directed by individuals,PayPal Bank 3,$53.00 ,"$17,948.98 "
PayPal Fees,11/27/23,Deposit,7K258496F7487793L,07 1000 DRONES RESTR,PayPal fees,OFFICE/GENERAL ADMINISTRATIVE EXPENSES:PayPal Fees,PayPal Bank 3,$2.34 ,"$17,951.32 "
PayPal Bank 3,11/27/23,Deposit,3SS47357LG849521R,04 PAYPAL GENERAL UNRESTR,Subject: GeneralPageTransaction ID: 3SS47357LG849521Rhttps://www.paypal.com/activity/payment/3SS47357LG849521R,PayPal Bank 3,--,$984.68 ,"$18,936.00 "
Donations directed by individuals,11/27/23,Deposit,3SS47357LG849521R,04 PAYPAL GENERAL UNRESTR,Support Ukraine - Support Ukraine,Contributed income:Donations directed by individuals,PayPal Bank 3,"$1,020.80 ","$19,956.80 "
PayPal Fees,11/27/23,Deposit,3SS47357LG849521R,04 PAYPAL GENERAL UNRESTR,PayPal fees,OFFICE/GENERAL ADMINISTRATIVE EXPENSES:PayPal Fees,PayPal Bank 3,$36.12 ,"$19,992.92 "
CHASE ENDING IN 5315,11/27/23,Deposit,--,05 VENMO UNRESTR,ORIG CO NAME:VENMO ORIG ID:7264681992 DESC DATE:231126 CO ENTRY DESCR:ACCTVERIFYSEC:PPD TRACE#:091000016255878 EED:231127 IND ID: IND NAME:OKSANA PATRINA TRN: 3 XXXXX5878TC,CHASE ENDING IN 5315,Donations directed by individuals,$0.03 ,"$19,992.95 "
Donations directed by individuals,11/27/23,Deposit,--,05 VENMO UNRESTR,ORIG CO NAME:VENMO ORIG ID:7264681992 DESC DATE:231126 CO ENTRY DESCR:ACCTVERIFYSEC:PPD TRACE#:091000016255878 EED:231127 IND ID: IND NAME:OKSANA PATRINA TRN: 3 XXXXX5878TC,Contributed income:Donations directed by individuals,CHASE ENDING IN 5315,$0.03 ,"$19,992.98 "
CHASE ENDING IN 5315,11/27/23,Deposit,--,05 VENMO UNRESTR,ORIG CO NAME:VENMO ORIG ID:7264681992 DESC DATE:231126 CO ENTRY DESCR:ACCTVERIFYSEC:PPD TRACE#:091000016255877 EED:231127 IND ID: IND NAME:OKSANA PATRINA TRN: 3 XXXXX5877TC,CHASE ENDING IN 5315,Donations directed by individuals,$0.12 ,"$19,993.10 "
Donations directed by individuals,11/27/23,Deposit,--,05 VENMO UNRESTR,ORIG CO NAME:VENMO ORIG ID:7264681992 DESC DATE:231126 CO ENTRY DESCR:ACCTVERIFYSEC:PPD TRACE#:091000016255877 EED:231127 IND ID: IND NAME:OKSANA PATRINA TRN: 3 XXXXX5877TC,Contributed income:Donations directed by individuals,CHASE ENDING IN 5315,$0.12 ,"$19,993.22 "
CHASE ENDING IN 5315,11/27/23,Deposit,--,05 VENMO UNRESTR,ORIG CO NAME:VENMO ORIG ID:5264681992 DESC DATE:231126 CO ENTRY DESCR:CASHOUT SEC:PPD TRACE#:091000016308219 EED:231127 IND ID: IND NAME:OKSANA PATRINA TRN: 331 XXX8219TC,CHASE ENDING IN 5315,Donations directed by individuals,$182.00 ,"$20,175.22 "
Donations directed by individuals,11/27/23,Deposit,--,05 VENMO UNRESTR,ORIG CO NAME:VENMO ORIG ID:5264681992 DESC DATE:231126 CO ENTRY DESCR:CASHOUT SEC:PPD TRACE#:091000016308219 EED:231127 IND ID: IND NAME:OKSANA PATRINA TRN: 331 XXX8219TC,Contributed income:Donations directed by individuals,CHASE ENDING IN 5315,$182.00 ,"$20,357.22 "
PayPal Bank 3,11/26/23,Deposit,31N6868047777882E,09 MSU RESTR,Subject: New 10 UnitsTransaction ID: 31N6868047777882Ehttps://www.paypal.com/activity/payment/31N6868047777882E,PayPal Bank 3,--,$96.02 ,"$20,453.24 "
Donations directed by individuals,11/26/23,Deposit,31N6868047777882E,09 MSU RESTR,donation-form,Contributed income:Donations directed by individuals,PayPal Bank 3,$100.00 ,"$20,553.24 "
PayPal Fees,11/26/23,Deposit,31N6868047777882E,09 MSU RESTR,PayPal fees,OFFICE/GENERAL ADMINISTRATIVE EXPENSES:PayPal Fees,PayPal Bank 3,$3.98 ,"$20,557.22 "
PayPal Bank 3,11/26/23,Deposit,3FW60130UA040601L,04 PAYPAL GENERAL UNRESTR,Subject: GeneralPageTransaction ID: 3FW60130UA040601Lhttps://www.paypal.com/activity/payment/3FW60130UA040601L,PayPal Bank 3,--,$196.93 ,"$20,754.15 "
Donations directed by individuals,11/26/23,Deposit,3FW60130UA040601L,04 PAYPAL GENERAL UNRESTR,Support Ukraine - Support Ukraine,Contributed income:Donations directed by individuals,PayPal Bank 3,$204.56 ,"$20,958.71 "
PayPal Fees,11/26/23,Deposit,3FW60130UA040601L,04 PAYPAL GENERAL UNRESTR,PayPal fees,OFFICE/GENERAL ADMINISTRATIVE EXPENSES:PayPal Fees,PayPal Bank 3,$7.63 ,"$20,966.34 "
PayPal Bank 3,11/26/23,Deposit,6EF80245SG352483H,04 PAYPAL GENERAL UNRESTR,Subject: Support UkraineTransaction ID: 6EF80245SG352483Hhttps://www.paypal.com/activity/payment/6EF80245SG352483H,PayPal Bank 3,--,$28.91 ,"$20,995.25 "
Donations directed by individuals,11/26/23,Deposit,6EF80245SG352483H,04 PAYPAL GENERAL UNRESTR,Money in to PayPal,Contributed income:Donations directed by individuals,PayPal Bank 3,$30.00 ,"$21,025.25 "
PayPal Fees,11/26/23,Deposit,6EF80245SG352483H,04 PAYPAL GENERAL UNRESTR,PayPal fees,OFFICE/GENERAL ADMINISTRATIVE EXPENSES:PayPal Fees,PayPal Bank 3,$1.09 ,"$21,026.34 "
PayPal Bank 3,11/25/23,Deposit,0GX27528B5408582P,04 PAYPAL GENERAL UNRESTR,Subject: Support UkraineTransaction ID: 0GX27528B5408582Phttps://www.paypal.com/activity/payment/0GX27528B5408582P,PayPal Bank 3,--,$18.71 ,"$21,045.05 "
Donations directed by individuals,11/25/23,Deposit,0GX27528B5408582P,04 PAYPAL GENERAL UNRESTR,Money in to PayPal,Contributed income:Donations directed by individuals,PayPal Bank 3,$19.89 ,"$21,064.94 "
PayPal Fees,11/25/23,Deposit,0GX27528B5408582P,04 PAYPAL GENERAL UNRESTR,PayPal fees,OFFICE/GENERAL ADMINISTRATIVE EXPENSES:PayPal Fees,PayPal Bank 3,$1.18 ,"$21,066.12 "
PayPal Bank 3,11/25/23,Deposit,7KW29049S07432908,07 1000 DRONES RESTR,Subject: 1000DRONESTransaction ID: 7KW29049S07432908https://www.paypal.com/activity/payment/7KW29049S07432908,PayPal Bank 3,--,$49.23 ,"$21,115.35 "
Donations directed by individuals,11/25/23,Deposit,7KW29049S07432908,07 1000 DRONES RESTR,1000 DRONES FOR UKRAINE - 1000 DRONES FOR UKRAINE,Contributed income:Donations directed by individuals,PayPal Bank 3,$51.52 ,"$21,166.87 "
PayPal Fees,11/25/23,Deposit,7KW29049S07432908,07 1000 DRONES RESTR,PayPal fees,OFFICE/GENERAL ADMINISTRATIVE EXPENSES:PayPal Fees,PayPal Bank 3,$2.29 ,"$21,169.16 "
PayPal Bank 3,11/25/23,Deposit,4T684250T6132730G,07 1000 DRONES RESTR,Subject: GeneralPageNote: На люті пташкиTransaction ID: 4T684250T6132730Ghttps://www.paypal.com/activity/payment/4T684250T6132730G,PayPal Bank 3,--,$590.81 ,"$21,759.97 "
Donations directed by individuals,11/25/23,Deposit,4T684250T6132730G,07 1000 DRONES RESTR,Support Ukraine - Support Ukraine,Contributed income:Donations directed by individuals,PayPal Bank 3,$612.68 ,"$22,372.65 "
PayPal Fees,11/25/23,Deposit,4T684250T6132730G,07 1000 DRONES RESTR,PayPal fees,OFFICE/GENERAL ADMINISTRATIVE EXPENSES:PayPal Fees,PayPal Bank 3,$21.87 ,"$22,394.52 "
PayPal Bank 3,11/25/23,Deposit,5WA587425V526970D,07 1000 DRONES RESTR,Subject: 1000DRONESTransaction ID: 5WA587425V526970Dhttps://www.paypal.com/activity/payment/5WA587425V526970D,PayPal Bank 3,--,$196.93 ,"$22,591.45 "
Donations directed by individuals,11/25/23,Deposit,5WA587425V526970D,07 1000 DRONES RESTR,1000 DRONES FOR UKRAINE - 1000 DRONES FOR UKRAINE,Contributed income:Donations directed by individuals,PayPal Bank 3,$204.56 ,"$22,796.01 "
PayPal Fees,11/25/23,Deposit,5WA587425V526970D,07 1000 DRONES RESTR,PayPal fees,OFFICE/GENERAL ADMINISTRATIVE EXPENSES:PayPal Fees,PayPal Bank 3,$7.63 ,"$22,803.64 "
PayPal Bank 3,11/25/23,Deposit,051305330K786521L,04 PAYPAL GENERAL UNRESTR,Subject: GeneralPageTransaction ID: 051305330K786521Lhttps://www.paypal.com/activity/payment/051305330K786521L,PayPal Bank 3,--,$9.84 ,"$22,813.48 "
Donations directed by individuals,11/25/23,Deposit,051305330K786521L,04 PAYPAL GENERAL UNRESTR,Support Ukraine - Support Ukraine,Contributed income:Donations directed by individuals,PayPal Bank 3,$10.70 ,"$22,824.18 "
PayPal Fees,11/25/23,Deposit,051305330K786521L,04 PAYPAL GENERAL UNRESTR,PayPal fees,OFFICE/GENERAL ADMINISTRATIVE EXPENSES:PayPal Fees,PayPal Bank 3,$0.86 ,"$22,825.04 "
PayPal Bank 3,11/25/23,Deposit,9MW02123YE491364N,04 PAYPAL GENERAL UNRESTR,Subject: GeneralPageTransaction ID: 9MW02123YE491364Nhttps://www.paypal.com/activity/payment/9MW02123YE491364N,PayPal Bank 3,--,$29.53 ,"$22,854.57 "
Donations directed by individuals,11/25/23,Deposit,9MW02123YE491364N,04 PAYPAL GENERAL UNRESTR,Support Ukraine - Support Ukraine,Contributed income:Donations directed by individuals,PayPal Bank 3,$31.11 ,"$22,885.68 "
PayPal Fees,11/25/23,Deposit,9MW02123YE491364N,04 PAYPAL GENERAL UNRESTR,PayPal fees,OFFICE/GENERAL ADMINISTRATIVE EXPENSES:PayPal Fees,PayPal Bank 3,$1.58 ,"$22,887.26 "
PayPal Bank 3,11/25/23,Deposit,9WG817616W512203H,04 PAYPAL GENERAL UNRESTR,Subject: GeneralPageTransaction ID: 9WG817616W512203Hhttps://www.paypal.com/activity/payment/9WG817616W512203H,PayPal Bank 3,--,$100.00 ,"$22,987.26 "
Donations directed by individuals,11/25/23,Deposit,9WG817616W512203H,04 PAYPAL GENERAL UNRESTR,Support Ukraine - Support Ukraine,Contributed income:Donations directed by individuals,PayPal Bank 3,$102.53 ,"$23,089.79 "
PayPal Fees,11/25/23,Deposit,9WG817616W512203H,04 PAYPAL GENERAL UNRESTR,PayPal fees,OFFICE/GENERAL ADMINISTRATIVE EXPENSES:PayPal Fees,PayPal Bank 3,$2.53 ,"$23,092.32 "
PayPal Bank 3,11/25/23,Deposit,3LT71298P6952171J,04 PAYPAL GENERAL UNRESTR,Subject: GeneralPageTransaction ID: 3LT71298P6952171Jhttps://www.paypal.com/activity/payment/3LT71298P6952171J,PayPal Bank 3,--,$19.69 ,"$23,112.01 "
Donations directed by individuals,11/25/23,Deposit,3LT71298P6952171J,04 PAYPAL GENERAL UNRESTR,Support Ukraine - Support Ukraine,Contributed income:Donations directed by individuals,PayPal Bank 3,$20.91 ,"$23,132.92 "
PayPal Fees,11/25/23,Deposit,3LT71298P6952171J,04 PAYPAL GENERAL UNRESTR,PayPal fees,OFFICE/GENERAL ADMINISTRATIVE EXPENSES:PayPal Fees,PayPal Bank 3,$1.22 ,"$23,134.14 "
PayPal Bank 3,11/24/23,Deposit,23T29475VW450432F,10 Flight to Recovery RESTR,Subject: Flight to RecoveryTransaction ID: 23T29475VW450432Fhttps://www.paypal.com/activity/payment/23T29475VW450432F,PayPal Bank 3,--,$50.00 ,"$23,184.14 "
Donations directed by individuals,11/24/23,Deposit,23T29475VW450432F,10 Flight to Recovery RESTR,Money in to PayPal,Contributed income:Donations directed by individuals,PayPal Bank 3,$51.52 ,"$23,235.66 "
PayPal Fees,11/24/23,Deposit,23T29475VW450432F,10 Flight to Recovery RESTR,PayPal fees,OFFICE/GENERAL ADMINISTRATIVE EXPENSES:PayPal Fees,PayPal Bank 3,$1.52 ,"$23,237.18 "
PayPal Bank 3,11/24/23,Deposit,82400142N47206118,04 PAYPAL GENERAL UNRESTR,Subject: GeneralPageTransaction ID: 82400142N47206118https://www.paypal.com/activity/payment/82400142N47206118,PayPal Bank 3,--,"$10,000.00 ","$33,237.18 "
Donations directed by individuals,11/24/23,Deposit,82400142N47206118,04 PAYPAL GENERAL UNRESTR,Support Ukraine - Support Ukraine,Contributed income:Donations directed by individuals,PayPal Bank 3,"$10,203.54 ","$43,440.72 "
PayPal Fees,11/24/23,Deposit,82400142N47206118,04 PAYPAL GENERAL UNRESTR,PayPal fees,OFFICE/GENERAL ADMINISTRATIVE EXPENSES:PayPal Fees,PayPal Bank 3,$203.54 ,"$43,644.26 "
PayPal Bank 3,11/24/23,Deposit,5KF19005WF2695508,07 1000 DRONES RESTR,Subject: 1000DRONESTransaction ID: 5KF19005WF2695508https://www.paypal.com/activity/payment/5KF19005WF2695508,PayPal Bank 3,--,$25.00 ,"$43,669.26 "
Donations directed by individuals,11/24/23,Deposit,5KF19005WF2695508,07 1000 DRONES RESTR,1000 DRONES FOR UKRAINE - 1000 DRONES FOR UKRAINE,Contributed income:Donations directed by individuals,PayPal Bank 3,$26.01 ,"$43,695.27 "
PayPal Fees,11/24/23,Deposit,5KF19005WF2695508,07 1000 DRONES RESTR,PayPal fees,OFFICE/GENERAL ADMINISTRATIVE EXPENSES:PayPal Fees,PayPal Bank 3,$1.01 ,"$43,696.28 "
PayPal Bank 3,11/23/23,Deposit,23H353613M979391X,04 PAYPAL GENERAL UNRESTR,Subject: GeneralPageTransaction ID: 23H353613M979391Xhttps://www.paypal.com/activity/payment/23H353613M979391X,PayPal Bank 3,--,$78.76 ,"$43,775.04 "
Donations directed by individuals,11/23/23,Deposit,23H353613M979391X,04 PAYPAL GENERAL UNRESTR,Support Ukraine - Support Ukraine,Contributed income:Donations directed by individuals,PayPal Bank 3,$82.12 ,"$43,857.16 "
PayPal Fees,11/23/23,Deposit,23H353613M979391X,04 PAYPAL GENERAL UNRESTR,PayPal fees,OFFICE/GENERAL ADMINISTRATIVE EXPENSES:PayPal Fees,PayPal Bank 3,$3.36 ,"$43,860.52 "
PayPal Bank 3,11/23/23,Deposit,6F032898JR0993712,08 VICTORY DRONES RESTR,Subject: VICTORY DRONESTransaction ID: 6F032898JR0993712https://www.paypal.com/activity/payment/6F032898JR0993712,PayPal Bank 3,--,$2.97 ,"$43,863.49 "
Donations directed by individuals,11/23/23,Deposit,6F032898JR0993712,08 VICTORY DRONES RESTR,Money in to PayPal,Contributed income:Donations directed by individuals,PayPal Bank 3,$3.59 ,"$43,867.08 "
PayPal Fees,11/23/23,Deposit,6F032898JR0993712,08 VICTORY DRONES RESTR,PayPal fees,OFFICE/GENERAL ADMINISTRATIVE EXPENSES:PayPal Fees,PayPal Bank 3,$0.62 ,"$43,867.70 "
PayPal Bank 3,11/23/23,Deposit,2SE16079PR916784A,04 PAYPAL GENERAL UNRESTR,Subject: Support UkraineTransaction ID: 2SE16079PR916784Ahttps://www.paypal.com/activity/payment/2SE16079PR916784A,PayPal Bank 3,--,$50.47 ,"$43,918.17 "
Donations directed by individuals,11/23/23,Deposit,2SE16079PR916784A,04 PAYPAL GENERAL UNRESTR,Money in to PayPal,Contributed income:Donations directed by individuals,PayPal Bank 3,$51.99 ,"$43,970.16 "
PayPal Fees,11/23/23,Deposit,2SE16079PR916784A,04 PAYPAL GENERAL UNRESTR,PayPal fees,OFFICE/GENERAL ADMINISTRATIVE EXPENSES:PayPal Fees,PayPal Bank 3,$1.52 ,"$43,971.68 "
PayPal Bank 3,11/23/23,Deposit,4G737420JA1618043,04 PAYPAL GENERAL UNRESTR,Subject: GeneralPageTransaction ID: 4G737420JA1618043https://www.paypal.com/activity/payment/4G737420JA1618043,PayPal Bank 3,--,$500.00 ,"$44,471.68 "
Donations directed by individuals,11/23/23,Deposit,4G737420JA1618043,04 PAYPAL GENERAL UNRESTR,Support Ukraine - Support Ukraine,Contributed income:Donations directed by individuals,PayPal Bank 3,$510.65 ,"$44,982.33 "
PayPal Fees,11/23/23,Deposit,4G737420JA1618043,04 PAYPAL GENERAL UNRESTR,PayPal fees,OFFICE/GENERAL ADMINISTRATIVE EXPENSES:PayPal Fees,PayPal Bank 3,$10.65 ,"$44,992.98 "
PayPal Bank 3,11/23/23,Deposit,9XM84196GG2949641,04 PAYPAL GENERAL UNRESTR,Subject: GeneralPageTransaction ID: 9XM84196GG2949641https://www.paypal.com/activity/payment/9XM84196GG2949641,PayPal Bank 3,--,$50.00 ,"$45,042.98 "
Donations directed by individuals,11/23/23,Deposit,9XM84196GG2949641,04 PAYPAL GENERAL UNRESTR,Support Ukraine - Support Ukraine,Contributed income:Donations directed by individuals,PayPal Bank 3,$51.52 ,"$45,094.50 "
PayPal Fees,11/23/23,Deposit,9XM84196GG2949641,04 PAYPAL GENERAL UNRESTR,PayPal fees,OFFICE/GENERAL ADMINISTRATIVE EXPENSES:PayPal Fees,PayPal Bank 3,$1.52 ,"$45,096.02 "
PayPal Bank 3,11/23/23,Deposit,2SR895994M1188117,04 PAYPAL GENERAL UNRESTR,Subject: GeneralPageTransaction ID: 2SR895994M1188117https://www.paypal.com/activity/payment/2SR895994M1188117,PayPal Bank 3,--,$28.46 ,"$45,124.48 "
Donations directed by individuals,11/23/23,Deposit,2SR895994M1188117,04 PAYPAL GENERAL UNRESTR,Support Ukraine - Support Ukraine,Contributed income:Donations directed by individuals,PayPal Bank 3,$30.00 ,"$45,154.48 "
PayPal Fees,11/23/23,Deposit,2SR895994M1188117,04 PAYPAL GENERAL UNRESTR,PayPal fees,OFFICE/GENERAL ADMINISTRATIVE EXPENSES:PayPal Fees,PayPal Bank 3,$1.54 ,"$45,156.02 "
PayPal Bank 3,11/23/23,Deposit,2WY669761D916612N,08 VICTORY DRONES RESTR,Subject: VictoryDronesTransaction ID: 2WY669761D916612Nhttps://www.paypal.com/activity/payment/2WY669761D916612N,PayPal Bank 3,--,$97.52 ,"$45,253.54 "
Donations directed by individuals,11/23/23,Deposit,2WY669761D916612N,08 VICTORY DRONES RESTR,VICTORY DRONES - VICTORY DRONES,Contributed income:Donations directed by individuals,PayPal Bank 3,$100.00 ,"$45,353.54 "
PayPal Fees,11/23/23,Deposit,2WY669761D916612N,08 VICTORY DRONES RESTR,PayPal fees,OFFICE/GENERAL ADMINISTRATIVE EXPENSES:PayPal Fees,PayPal Bank 3,$2.48 ,"$45,356.02 "
Donations directed by individuals,11/23/23,Journal Entry,19,--,--,Contributed income:Donations directed by individuals,--,$309.43 ,"$45,665.45 "
PayPal Bank 3,11/23/23,Journal Entry,19,--,--,PayPal Bank 3,--,$298.14 ,"$45,963.59 "
PayPal Fees,11/23/23,Journal Entry,19,--,--,OFFICE/GENERAL ADMINISTRATIVE EXPENSES:PayPal Fees,--,$11.29 ,"$45,974.88 "
PayPal Bank 3,11/22/23,Deposit,1U426201N7447882M,07 1000 DRONES RESTR,Subject: 1000DRONESTransaction ID: 1U426201N7447882Mhttps://www.paypal.com/activity/payment/1U426201N7447882M,PayPal Bank 3,--,$9.16 ,"$45,984.04 "
Donations directed by individuals,11/22/23,Deposit,1U426201N7447882M,07 1000 DRONES RESTR,1000 DRONES FOR UKRAINE - 1000 DRONES FOR UKRAINE,Contributed income:Donations directed by individuals,PayPal Bank 3,$10.00 ,"$45,994.04 "
PayPal Fees,11/22/23,Deposit,1U426201N7447882M,07 1000 DRONES RESTR,PayPal fees,OFFICE/GENERAL ADMINISTRATIVE EXPENSES:PayPal Fees,PayPal Bank 3,$0.84 ,"$45,994.88 "
PayPal Bank 3,11/22/23,Deposit,6EY05401BP0464255,04 PAYPAL GENERAL UNRESTR,Subject: GeneralPageTransaction ID: 6EY05401BP0464255https://www.paypal.com/activity/payment/6EY05401BP0464255,PayPal Bank 3,--,$9.16 ,"$46,004.04 "
Donations directed by individuals,11/22/23,Deposit,6EY05401BP0464255,04 PAYPAL GENERAL UNRESTR,Support Ukraine - Support Ukraine,Contributed income:Donations directed by individuals,PayPal Bank 3,$10.00 ,"$46,014.04 "
PayPal Fees,11/22/23,Deposit,6EY05401BP0464255,04 PAYPAL GENERAL UNRESTR,PayPal fees,OFFICE/GENERAL ADMINISTRATIVE EXPENSES:PayPal Fees,PayPal Bank 3,$0.84 ,"$46,014.88 "
PayPal Bank 3,11/22/23,Deposit,5FP24855065411035,04 PAYPAL GENERAL UNRESTR,Subject: GeneralPageTransaction ID: 5FP24855065411035https://www.paypal.com/activity/payment/5FP24855065411035,PayPal Bank 3,--,$500.00 ,"$46,514.88 "
Donations directed by individuals,11/22/23,Deposit,5FP24855065411035,04 PAYPAL GENERAL UNRESTR,Support Ukraine - Support Ukraine,Contributed income:Donations directed by individuals,PayPal Bank 3,$510.65 ,"$47,025.53 "
PayPal Fees,11/22/23,Deposit,5FP24855065411035,04 PAYPAL GENERAL UNRESTR,PayPal fees,OFFICE/GENERAL ADMINISTRATIVE EXPENSES:PayPal Fees,PayPal Bank 3,$10.65 ,"$47,036.18 "
PayPal Bank 3,11/22/23,Deposit,4N2931039J953594P,07 1000 DRONES RESTR,Subject: 1000 DRONES FOR UKRAINETransaction ID: 4N2931039J953594Phttps://www.paypal.com/activity/payment/4N2931039J953594P,PayPal Bank 3,--,$157.55 ,"$47,193.73 "
Donations directed by individuals,11/22/23,Deposit,4N2931039J953594P,07 1000 DRONES RESTR,Money in to PayPal,Contributed income:Donations directed by individuals,PayPal Bank 3,$163.75 ,"$47,357.48 "
PayPal Fees,11/22/23,Deposit,4N2931039J953594P,07 1000 DRONES RESTR,PayPal fees,OFFICE/GENERAL ADMINISTRATIVE EXPENSES:PayPal Fees,PayPal Bank 3,$6.20 ,"$47,363.68 "
PayPal Bank 3,11/22/23,Deposit,6C096253HR694951W,04 PAYPAL GENERAL UNRESTR,Subject: Support UkraineTransaction ID: 6C096253HR694951Whttps://www.paypal.com/activity/payment/6C096253HR694951W,PayPal Bank 3,--,$19.87 ,"$47,383.55 "
Donations directed by individuals,11/22/23,Deposit,6C096253HR694951W,04 PAYPAL GENERAL UNRESTR,Money in to PayPal,Contributed income:Donations directed by individuals,PayPal Bank 3,$21.10 ,"$47,404.65 "
PayPal Fees,11/22/23,Deposit,6C096253HR694951W,04 PAYPAL GENERAL UNRESTR,PayPal fees,OFFICE/GENERAL ADMINISTRATIVE EXPENSES:PayPal Fees,PayPal Bank 3,$1.23 ,"$47,405.88 "
PayPal Bank 3,11/21/23,Deposit,4CY7547329935040W,04 PAYPAL GENERAL UNRESTR,Subject: Support UkraineTransaction ID: 4CY7547329935040Whttps://www.paypal.com/activity/payment/4CY7547329935040W,PayPal Bank 3,--,$50.47 ,"$47,456.35 "
Donations directed by individuals,11/21/23,Deposit,4CY7547329935040W,04 PAYPAL GENERAL UNRESTR,Money in to PayPal,Contributed income:Donations directed by individuals,PayPal Bank 3,$51.99 ,"$47,508.34 "
PayPal Fees,11/21/23,Deposit,4CY7547329935040W,04 PAYPAL GENERAL UNRESTR,PayPal fees,OFFICE/GENERAL ADMINISTRATIVE EXPENSES:PayPal Fees,PayPal Bank 3,$1.52 ,"$47,509.86 "
PayPal Bank 3,11/21/23,Deposit,48N97635X10033144,04 PAYPAL GENERAL UNRESTR,Subject: Support UkraineTransaction ID: 48N97635X10033144https://www.paypal.com/activity/payment/48N97635X10033144,PayPal Bank 3,--,$24.84 ,"$47,534.70 "
Donations directed by individuals,11/21/23,Deposit,48N97635X10033144,04 PAYPAL GENERAL UNRESTR,Money in to PayPal,Contributed income:Donations directed by individuals,PayPal Bank 3,$26.25 ,"$47,560.95 "
PayPal Fees,11/21/23,Deposit,48N97635X10033144,04 PAYPAL GENERAL UNRESTR,PayPal fees,OFFICE/GENERAL ADMINISTRATIVE EXPENSES:PayPal Fees,PayPal Bank 3,$1.41 ,"$47,562.36 "
PayPal Bank 3,11/21/23,Deposit,10R01838R4978223D,04 PAYPAL GENERAL UNRESTR,Subject: GeneralPageTransaction ID: 10R01838R4978223Dhttps://www.paypal.com/activity/payment/10R01838R4978223D,PayPal Bank 3,--,$34.46 ,"$47,596.82 "
Donations directed by individuals,11/21/23,Deposit,10R01838R4978223D,04 PAYPAL GENERAL UNRESTR,Support Ukraine - Support Ukraine,Contributed income:Donations directed by individuals,PayPal Bank 3,$36.21 ,"$47,633.03 "
PayPal Fees,11/21/23,Deposit,10R01838R4978223D,04 PAYPAL GENERAL UNRESTR,PayPal fees,OFFICE/GENERAL ADMINISTRATIVE EXPENSES:PayPal Fees,PayPal Bank 3,$1.75 ,"$47,634.78 "
PayPal Bank 3,11/21/23,Deposit,5JG69579PP810320T,04 PAYPAL GENERAL UNRESTR,Subject: Support UkraineTransaction ID: 5JG69579PP810320Thttps://www.paypal.com/activity/payment/5JG69579PP810320T,PayPal Bank 3,--,$23.63 ,"$47,658.41 "
Donations directed by individuals,11/21/23,Deposit,5JG69579PP810320T,04 PAYPAL GENERAL UNRESTR,Money in to PayPal,Contributed income:Donations directed by individuals,PayPal Bank 3,$24.99 ,"$47,683.40 "
PayPal Fees,11/21/23,Deposit,5JG69579PP810320T,04 PAYPAL GENERAL UNRESTR,PayPal fees,OFFICE/GENERAL ADMINISTRATIVE EXPENSES:PayPal Fees,PayPal Bank 3,$1.36 ,"$47,684.76 "
PayPal Bank 3,11/21/23,Deposit,253365199H341794T,--,"Subject: GeneralPageNote: Дякую, Любо!Transaction ID: 253365199H341794Thttps://www.paypal.com/activity/payment/253365199H341794T",PayPal Bank 3,--,$250.00 ,"$47,934.76 "
Donations directed by individuals,11/21/23,Deposit,253365199H341794T,--,Support Ukraine - Support Ukraine,Contributed income:Donations directed by individuals,PayPal Bank 3,$255.58 ,"$48,190.34 "
PayPal Fees,11/21/23,Deposit,253365199H341794T,--,PayPal fees,OFFICE/GENERAL ADMINISTRATIVE EXPENSES:PayPal Fees,PayPal Bank 3,$5.58 ,"$48,195.92 "
PayPal Bank 3,11/20/23,Deposit,8V7241598D265010J,04 PAYPAL GENERAL UNRESTR,Subject: GeneralPageTransaction ID: 8V7241598D265010Jhttps://www.paypal.com/activity/payment/8V7241598D265010J,PayPal Bank 3,--,$50.00 ,"$48,245.92 "
Donations directed by individuals,11/20/23,Deposit,8V7241598D265010J,04 PAYPAL GENERAL UNRESTR,Support Ukraine - Support Ukraine,Contributed income:Donations directed by individuals,PayPal Bank 3,$51.52 ,"$48,297.44 "
PayPal Fees,11/20/23,Deposit,8V7241598D265010J,04 PAYPAL GENERAL UNRESTR,PayPal fees,OFFICE/GENERAL ADMINISTRATIVE EXPENSES:PayPal Fees,PayPal Bank 3,$1.52 ,"$48,298.96 "
PayPal Bank 3,11/20/23,Deposit,6W059068G6709415E,07 1000 DRONES RESTR,Subject: 1000DRONESTransaction ID: 6W059068G6709415Ehttps://www.paypal.com/activity/payment/6W059068G6709415E,PayPal Bank 3,--,$34.46 ,"$48,333.42 "
Donations directed by individuals,11/20/23,Deposit,6W059068G6709415E,07 1000 DRONES RESTR,1000 DRONES FOR UKRAINE - 1000 DRONES FOR UKRAINE,Contributed income:Donations directed by individuals,PayPal Bank 3,$36.21 ,"$48,369.63 "
PayPal Fees,11/20/23,Deposit,6W059068G6709415E,07 1000 DRONES RESTR,PayPal fees,OFFICE/GENERAL ADMINISTRATIVE EXPENSES:PayPal Fees,PayPal Bank 3,$1.75 ,"$48,371.38 "
PayPal Bank 3,11/20/23,Deposit,0HF1095302855471A,04 PAYPAL GENERAL UNRESTR,Subject: Support UkraineTransaction ID: 0HF1095302855471Ahttps://www.paypal.com/activity/payment/0HF1095302855471A,PayPal Bank 3,--,$9.16 ,"$48,380.54 "
Donations directed by individuals,11/20/23,Deposit,0HF1095302855471A,04 PAYPAL GENERAL UNRESTR,Money in to PayPal,Contributed income:Donations directed by individuals,PayPal Bank 3,$10.00 ,"$48,390.54 "
PayPal Fees,11/20/23,Deposit,0HF1095302855471A,04 PAYPAL GENERAL UNRESTR,PayPal fees,OFFICE/GENERAL ADMINISTRATIVE EXPENSES:PayPal Fees,PayPal Bank 3,$0.84 ,"$48,391.38 "
PayPal Bank 3,11/20/23,Deposit,33557123ES158280K,04 PAYPAL GENERAL UNRESTR,Subject: GeneralPageTransaction ID: 33557123ES158280Khttps://www.paypal.com/activity/payment/33557123ES158280K,PayPal Bank 3,--,$29.53 ,"$48,420.91 "
Donations directed by individuals,11/20/23,Deposit,33557123ES158280K,04 PAYPAL GENERAL UNRESTR,Support Ukraine - Support Ukraine,Contributed income:Donations directed by individuals,PayPal Bank 3,$31.11 ,"$48,452.02 "
PayPal Fees,11/20/23,Deposit,33557123ES158280K,04 PAYPAL GENERAL UNRESTR,PayPal fees,OFFICE/GENERAL ADMINISTRATIVE EXPENSES:PayPal Fees,PayPal Bank 3,$1.58 ,"$48,453.60 "
PayPal Bank 3,11/20/23,Deposit,00E57764GC219760N,04 PAYPAL GENERAL UNRESTR,Subject: GeneralPageTransaction ID: 00E57764GC219760Nhttps://www.paypal.com/activity/payment/00E57764GC219760N,PayPal Bank 3,--,$9.84 ,"$48,463.44 "
Donations directed by individuals,11/20/23,Deposit,00E57764GC219760N,04 PAYPAL GENERAL UNRESTR,Support Ukraine - Support Ukraine,Contributed income:Donations directed by individuals,PayPal Bank 3,$10.70 ,"$48,474.14 "
PayPal Fees,11/20/23,Deposit,00E57764GC219760N,04 PAYPAL GENERAL UNRESTR,PayPal fees,OFFICE/GENERAL ADMINISTRATIVE EXPENSES:PayPal Fees,PayPal Bank 3,$0.86 ,"$48,475.00 "
PayPal Bank 3,11/20/23,Deposit,7FP76769EF635015G,04 PAYPAL GENERAL UNRESTR,Subject: Support UkraineTransaction ID: 7FP76769EF635015Ghttps://www.paypal.com/activity/payment/7FP76769EF635015G,PayPal Bank 3,--,$9.16 ,"$48,484.16 "
Donations directed by individuals,11/20/23,Deposit,7FP76769EF635015G,04 PAYPAL GENERAL UNRESTR,Money in to PayPal,Contributed income:Donations directed by individuals,PayPal Bank 3,$10.00 ,"$48,494.16 "
PayPal Fees,11/20/23,Deposit,7FP76769EF635015G,04 PAYPAL GENERAL UNRESTR,PayPal fees,OFFICE/GENERAL ADMINISTRATIVE EXPENSES:PayPal Fees,PayPal Bank 3,$0.84 ,"$48,495.00 "
PayPal Bank 3,11/20/23,Deposit,4DB2006608285014V,04 PAYPAL GENERAL UNRESTR,Subject: GeneralPageTransaction ID: 4DB2006608285014Vhttps://www.paypal.com/activity/payment/4DB2006608285014V,PayPal Bank 3,--,$97.52 ,"$48,592.52 "
Donations directed by individuals,11/20/23,Deposit,4DB2006608285014V,04 PAYPAL GENERAL UNRESTR,Support Ukraine - Support Ukraine,Contributed income:Donations directed by individuals,PayPal Bank 3,$100.00 ,"$48,692.52 "
PayPal Fees,11/20/23,Deposit,4DB2006608285014V,04 PAYPAL GENERAL UNRESTR,PayPal fees,OFFICE/GENERAL ADMINISTRATIVE EXPENSES:PayPal Fees,PayPal Bank 3,$2.48 ,"$48,695.00 "
PayPal Bank 3,11/20/23,Deposit,6BW69333JG702230U,04 PAYPAL GENERAL UNRESTR,Subject: Support UkraineTransaction ID: 6BW69333JG702230Uhttps://www.paypal.com/activity/payment/6BW69333JG702230U,PayPal Bank 3,--,$70.08 ,"$48,765.08 "
Donations directed by individuals,11/20/23,Deposit,6BW69333JG702230U,04 PAYPAL GENERAL UNRESTR,Money in to PayPal,Contributed income:Donations directed by individuals,PayPal Bank 3,$72.00 ,"$48,837.08 "
PayPal Fees,11/20/23,Deposit,6BW69333JG702230U,04 PAYPAL GENERAL UNRESTR,PayPal fees,OFFICE/GENERAL ADMINISTRATIVE EXPENSES:PayPal Fees,PayPal Bank 3,$1.92 ,"$48,839.00 "
PayPal Bank 3,11/20/23,Deposit,0GL91133V98395644,07 1000 DRONES RESTR,Subject: 1000DRONESTransaction ID: 0GL91133V98395644https://www.paypal.com/activity/payment/0GL91133V98395644,PayPal Bank 3,--,$19.69 ,"$48,858.69 "
Donations directed by individuals,11/20/23,Deposit,0GL91133V98395644,07 1000 DRONES RESTR,1000 DRONES FOR UKRAINE - 1000 DRONES FOR UKRAINE,Contributed income:Donations directed by individuals,PayPal Bank 3,$20.91 ,"$48,879.60 "
PayPal Fees,11/20/23,Deposit,0GL91133V98395644,07 1000 DRONES RESTR,PayPal fees,OFFICE/GENERAL ADMINISTRATIVE EXPENSES:PayPal Fees,PayPal Bank 3,$1.22 ,"$48,880.82 "
PayPal Bank 3,11/20/23,Deposit,1JJ41240WY4893701,04 PAYPAL GENERAL UNRESTR,Subject: GeneralPageTransaction ID: 1JJ41240WY4893701https://www.paypal.com/activity/payment/1JJ41240WY4893701,PayPal Bank 3,--,$9.16 ,"$48,889.98 "
Donations directed by individuals,11/20/23,Deposit,1JJ41240WY4893701,04 PAYPAL GENERAL UNRESTR,Support Ukraine - Support Ukraine,Contributed income:Donations directed by individuals,PayPal Bank 3,$10.00 ,"$48,899.98 "
PayPal Fees,11/20/23,Deposit,1JJ41240WY4893701,04 PAYPAL GENERAL UNRESTR,PayPal fees,OFFICE/GENERAL ADMINISTRATIVE EXPENSES:PayPal Fees,PayPal Bank 3,$0.84 ,"$48,900.82 "
PayPal Bank 3,11/19/23,Deposit,7AW0007980209540U,04 PAYPAL GENERAL UNRESTR,Subject: GeneralPageTransaction ID: 7AW0007980209540Uhttps://www.paypal.com/activity/payment/7AW0007980209540U,PayPal Bank 3,--,$9.31 ,"$48,910.13 "
Donations directed by individuals,11/19/23,Deposit,7AW0007980209540U,04 PAYPAL GENERAL UNRESTR,Support Ukraine - Support Ukraine,Contributed income:Donations directed by individuals,PayPal Bank 3,$10.00 ,"$48,920.13 "
PayPal Fees,11/19/23,Deposit,7AW0007980209540U,04 PAYPAL GENERAL UNRESTR,PayPal fees,OFFICE/GENERAL ADMINISTRATIVE EXPENSES:PayPal Fees,PayPal Bank 3,$0.69 ,"$48,920.82 "
PayPal Bank 3,11/19/23,Deposit,41U22115V6649302L,07 1000 DRONES RESTR,Subject: 1000 DRONES FOR UKRAINETransaction ID: 41U22115V6649302Lhttps://www.paypal.com/activity/payment/41U22115V6649302L,PayPal Bank 3,--,$18.81 ,"$48,939.63 "
Donations directed by individuals,11/19/23,Deposit,41U22115V6649302L,07 1000 DRONES RESTR,Money in to PayPal,Contributed income:Donations directed by individuals,PayPal Bank 3,$20.00 ,"$48,959.63 "
PayPal Fees,11/19/23,Deposit,41U22115V6649302L,07 1000 DRONES RESTR,PayPal fees,OFFICE/GENERAL ADMINISTRATIVE EXPENSES:PayPal Fees,PayPal Bank 3,$1.19 ,"$48,960.82 "
PayPal Bank 3,11/19/23,Deposit,36N5900591660730M,04 PAYPAL GENERAL UNRESTR,Subject: Support UkraineTransaction ID: 36N5900591660730Mhttps://www.paypal.com/activity/payment/36N5900591660730M,PayPal Bank 3,--,$9.93 ,"$48,970.75 "
Donations directed by individuals,11/19/23,Deposit,36N5900591660730M,04 PAYPAL GENERAL UNRESTR,Money in to PayPal,Contributed income:Donations directed by individuals,PayPal Bank 3,$10.80 ,"$48,981.55 "
PayPal Fees,11/19/23,Deposit,36N5900591660730M,04 PAYPAL GENERAL UNRESTR,PayPal fees,OFFICE/GENERAL ADMINISTRATIVE EXPENSES:PayPal Fees,PayPal Bank 3,$0.87 ,"$48,982.42 "
PayPal Bank 3,11/19/23,Deposit,99V92616V09718308,04 PAYPAL GENERAL UNRESTR,Subject: Support UkraineTransaction ID: 99V92616V09718308https://www.paypal.com/activity/payment/99V92616V09718308,PayPal Bank 3,--,$47.70 ,"$49,030.12 "
Donations directed by individuals,11/19/23,Deposit,99V92616V09718308,04 PAYPAL GENERAL UNRESTR,Money in to PayPal,Contributed income:Donations directed by individuals,PayPal Bank 3,$49.93 ,"$49,080.05 "
PayPal Fees,11/19/23,Deposit,99V92616V09718308,04 PAYPAL GENERAL UNRESTR,PayPal fees,OFFICE/GENERAL ADMINISTRATIVE EXPENSES:PayPal Fees,PayPal Bank 3,$2.23 ,"$49,082.28 "
PayPal Bank 3,11/19/23,Deposit,30V01694B0899741R,04 PAYPAL GENERAL UNRESTR,Subject: Support UkraineTransaction ID: 30V01694B0899741Rhttps://www.paypal.com/activity/payment/30V01694B0899741R,PayPal Bank 3,--,$19.87 ,"$49,102.15 "
Donations directed by individuals,11/19/23,Deposit,30V01694B0899741R,04 PAYPAL GENERAL UNRESTR,Money in to PayPal,Contributed income:Donations directed by individuals,PayPal Bank 3,$21.10 ,"$49,123.25 "
PayPal Fees,11/19/23,Deposit,30V01694B0899741R,04 PAYPAL GENERAL UNRESTR,PayPal fees,OFFICE/GENERAL ADMINISTRATIVE EXPENSES:PayPal Fees,PayPal Bank 3,$1.23 ,"$49,124.48 "
PayPal Bank 3,11/19/23,Deposit,7W470114K4993945V,04 PAYPAL GENERAL UNRESTR,Subject: GeneralPageTransaction ID: 7W470114K4993945Vhttps://www.paypal.com/activity/payment/7W470114K4993945V,PayPal Bank 3,--,$9.16 ,"$49,133.64 "
Donations directed by individuals,11/19/23,Deposit,7W470114K4993945V,04 PAYPAL GENERAL UNRESTR,Support Ukraine - Support Ukraine,Contributed income:Donations directed by individuals,PayPal Bank 3,$10.00 ,"$49,143.64 "
PayPal Fees,11/19/23,Deposit,7W470114K4993945V,04 PAYPAL GENERAL UNRESTR,PayPal fees,OFFICE/GENERAL ADMINISTRATIVE EXPENSES:PayPal Fees,PayPal Bank 3,$0.84 ,"$49,144.48 "
PayPal Bank 3,11/18/23,Transfer,--,--,ORIG CO NAME:PAYPAL ORIG ID:PAYPALSD11 DESC DATE:231117 CO ENTRY DESCR:TRANSFER SEC:PPD TRACE#:091000010037318 EED:231120 IND ID: IND NAME:DIGNITAS UKRAINE TRN: XXXXXX7318TC,PayPal Bank 3,CHASE ENDING IN 5315,"($11,500.00)","$37,644.48 "
CHASE ENDING IN 5315,11/18/23,Transfer,--,--,ORIG CO NAME:PAYPAL ORIG ID:PAYPALSD11 DESC DATE:231117 CO ENTRY DESCR:TRANSFER SEC:PPD TRACE#:091000010037318 EED:231120 IND ID: IND NAME:DIGNITAS UKRAINE TRN: XXXXXX7318TC,CHASE ENDING IN 5315,PayPal Bank 3,"$11,500.00 ","$49,144.48 "
PayPal Bank 3,11/18/23,Deposit,4XA71597YP164750V,04 PAYPAL GENERAL UNRESTR,Subject: GeneralPageTransaction ID: 4XA71597YP164750Vhttps://www.paypal.com/activity/payment/4XA71597YP164750V,PayPal Bank 3,--,$20.00 ,"$49,164.48 "
Donations directed by individuals,11/18/23,Deposit,4XA71597YP164750V,04 PAYPAL GENERAL UNRESTR,Support Ukraine - Support Ukraine,Contributed income:Donations directed by individuals,PayPal Bank 3,$20.91 ,"$49,185.39 "
PayPal Fees,11/18/23,Deposit,4XA71597YP164750V,04 PAYPAL GENERAL UNRESTR,PayPal fees,OFFICE/GENERAL ADMINISTRATIVE EXPENSES:PayPal Fees,PayPal Bank 3,$0.91 ,"$49,186.30 "
PayPal Bank 3,11/18/23,Deposit,4YW78504J8812132N,04 PAYPAL GENERAL UNRESTR,Subject: GeneralPageTransaction ID: 4YW78504J8812132Nhttps://www.paypal.com/activity/payment/4YW78504J8812132N,PayPal Bank 3,--,$98.46 ,"$49,284.76 "
Donations directed by individuals,11/18/23,Deposit,4YW78504J8812132N,04 PAYPAL GENERAL UNRESTR,Support Ukraine - Support Ukraine,Contributed income:Donations directed by individuals,PayPal Bank 3,$102.53 ,"$49,387.29 "
PayPal Fees,11/18/23,Deposit,4YW78504J8812132N,04 PAYPAL GENERAL UNRESTR,PayPal fees,OFFICE/GENERAL ADMINISTRATIVE EXPENSES:PayPal Fees,PayPal Bank 3,$4.07 ,"$49,391.36 "
PayPal Bank 3,11/18/23,Deposit,67E00611110789140,04 PAYPAL GENERAL UNRESTR,Subject: GeneralPageTransaction ID: 67E00611110789140https://www.paypal.com/activity/payment/67E00611110789140,PayPal Bank 3,--,$200.00 ,"$49,591.36 "
Donations directed by individuals,11/18/23,Deposit,67E00611110789140,04 PAYPAL GENERAL UNRESTR,Support Ukraine - Support Ukraine,Contributed income:Donations directed by individuals,PayPal Bank 3,$204.56 ,"$49,795.92 "
PayPal Fees,11/18/23,Deposit,67E00611110789140,04 PAYPAL GENERAL UNRESTR,PayPal fees,OFFICE/GENERAL ADMINISTRATIVE EXPENSES:PayPal Fees,PayPal Bank 3,$4.56 ,"$49,800.48 "
PayPal Bank 3,11/18/23,Deposit,1E678340YS7240746,04 PAYPAL GENERAL UNRESTR,Subject: Support UkraineTransaction ID: 1E678340YS7240746https://www.paypal.com/activity/payment/1E678340YS7240746,PayPal Bank 3,--,$47.76 ,"$49,848.24 "
Donations directed by individuals,11/18/23,Deposit,1E678340YS7240746,04 PAYPAL GENERAL UNRESTR,Money in to PayPal,Contributed income:Donations directed by individuals,PayPal Bank 3,$50.00 ,"$49,898.24 "
PayPal Fees,11/18/23,Deposit,1E678340YS7240746,04 PAYPAL GENERAL UNRESTR,PayPal fees,OFFICE/GENERAL ADMINISTRATIVE EXPENSES:PayPal Fees,PayPal Bank 3,$2.24 ,"$49,900.48 "
PayPal Bank 3,11/18/23,Deposit,0YK72624BP374931J,09 MSU RESTR,Subject: New 10 UnitsTransaction ID: 0YK72624BP374931Jhttps://www.paypal.com/activity/payment/0YK72624BP374931J,PayPal Bank 3,--,$48.51 ,"$49,948.99 "
Donations directed by individuals,11/18/23,Deposit,0YK72624BP374931J,09 MSU RESTR,donation-form,Contributed income:Donations directed by individuals,PayPal Bank 3,$50.00 ,"$49,998.99 "
PayPal Fees,11/18/23,Deposit,0YK72624BP374931J,09 MSU RESTR,PayPal fees,OFFICE/GENERAL ADMINISTRATIVE EXPENSES:PayPal Fees,PayPal Bank 3,$1.49 ,"$50,000.48 "
PayPal Bank 3,11/18/23,Deposit,5DF65154JB865143F,04 PAYPAL GENERAL UNRESTR,Subject: GeneralPageTransaction ID: 5DF65154JB865143Fhttps://www.paypal.com/activity/payment/5DF65154JB865143F,PayPal Bank 3,--,$18.81 ,"$50,019.29 "
Donations directed by individuals,11/18/23,Deposit,5DF65154JB865143F,04 PAYPAL GENERAL UNRESTR,Support Ukraine - Support Ukraine,Contributed income:Donations directed by individuals,PayPal Bank 3,$20.00 ,"$50,039.29 "
PayPal Fees,11/18/23,Deposit,5DF65154JB865143F,04 PAYPAL GENERAL UNRESTR,PayPal fees,OFFICE/GENERAL ADMINISTRATIVE EXPENSES:PayPal Fees,PayPal Bank 3,$1.19 ,"$50,040.48 "
PayPal Bank 3,11/17/23,Deposit,1K185757M7106850K,08 VICTORY DRONES RESTR,Subject: VICTORY DRONESTransaction ID: 1K185757M7106850Khttps://www.paypal.com/activity/payment/1K185757M7106850K,PayPal Bank 3,--,$2.97 ,"$50,043.45 "
Donations directed by individuals,11/17/23,Deposit,1K185757M7106850K,08 VICTORY DRONES RESTR,Money in to PayPal,Contributed income:Donations directed by individuals,PayPal Bank 3,$3.59 ,"$50,047.04 "
PayPal Fees,11/17/23,Deposit,1K185757M7106850K,08 VICTORY DRONES RESTR,PayPal fees,OFFICE/GENERAL ADMINISTRATIVE EXPENSES:PayPal Fees,PayPal Bank 3,$0.62 ,"$50,047.66 "
PayPal Bank 3,11/17/23,Deposit,6J4245493J161114B,04 PAYPAL GENERAL UNRESTR,Subject: GeneralPageTransaction ID: 6J4245493J161114Bhttps://www.paypal.com/activity/payment/6J4245493J161114B,PayPal Bank 3,--,$14.76 ,"$50,062.42 "
Donations directed by individuals,11/17/23,Deposit,6J4245493J161114B,04 PAYPAL GENERAL UNRESTR,Support Ukraine - Support Ukraine,Contributed income:Donations directed by individuals,PayPal Bank 3,$15.80 ,"$50,078.22 "
PayPal Fees,11/17/23,Deposit,6J4245493J161114B,04 PAYPAL GENERAL UNRESTR,PayPal fees,OFFICE/GENERAL ADMINISTRATIVE EXPENSES:PayPal Fees,PayPal Bank 3,$1.04 ,"$50,079.26 "
PayPal Bank 3,11/17/23,Deposit,7VR32295WD960731K,09 MSU RESTR,Subject: New 10 UnitsTransaction ID: 7VR32295WD960731Khttps://www.paypal.com/activity/payment/7VR32295WD960731K,PayPal Bank 3,--,$48.51 ,"$50,127.77 "
Donations directed by individuals,11/17/23,Deposit,7VR32295WD960731K,09 MSU RESTR,donation-form,Contributed income:Donations directed by individuals,PayPal Bank 3,$50.00 ,"$50,177.77 "
PayPal Fees,11/17/23,Deposit,7VR32295WD960731K,09 MSU RESTR,PayPal fees,OFFICE/GENERAL ADMINISTRATIVE EXPENSES:PayPal Fees,PayPal Bank 3,$1.49 ,"$50,179.26 "
PayPal Bank 3,11/17/23,Deposit,9LT38414GY201121K,04 PAYPAL GENERAL UNRESTR,Subject: Support UkraineTransaction ID: 9LT38414GY201121Khttps://www.paypal.com/activity/payment/9LT38414GY201121K,PayPal Bank 3,--,$47.76 ,"$50,227.02 "
Donations directed by individuals,11/17/23,Deposit,9LT38414GY201121K,04 PAYPAL GENERAL UNRESTR,Money in to PayPal,Contributed income:Donations directed by individuals,PayPal Bank 3,$50.00 ,"$50,277.02 "
PayPal Fees,11/17/23,Deposit,9LT38414GY201121K,04 PAYPAL GENERAL UNRESTR,PayPal fees,OFFICE/GENERAL ADMINISTRATIVE EXPENSES:PayPal Fees,PayPal Bank 3,$2.24 ,"$50,279.26 "
PayPal Bank 3,11/17/23,Deposit,4H291932RP475962P,09 MSU RESTR,Subject: New 10 UnitsTransaction ID: 4H291932RP475962Phttps://www.paypal.com/activity/payment/4H291932RP475962P,PayPal Bank 3,--,$9.31 ,"$50,288.57 "
Donations directed by individuals,11/17/23,Deposit,4H291932RP475962P,09 MSU RESTR,donation-form,Contributed income:Donations directed by individuals,PayPal Bank 3,$10.00 ,"$50,298.57 "
PayPal Fees,11/17/23,Deposit,4H291932RP475962P,09 MSU RESTR,PayPal fees,OFFICE/GENERAL ADMINISTRATIVE EXPENSES:PayPal Fees,PayPal Bank 3,$0.69 ,"$50,299.26 "
PayPal Bank 3,11/17/23,Deposit,946590784K897934L,09 MSU RESTR,Subject: New 10 UnitsTransaction ID: 946590784K897934Lhttps://www.paypal.com/activity/payment/946590784K897934L,PayPal Bank 3,--,$675.08 ,"$50,974.34 "
Donations directed by individuals,11/17/23,Deposit,946590784K897934L,09 MSU RESTR,donation-form,Contributed income:Donations directed by individuals,PayPal Bank 3,$700.00 ,"$51,674.34 "
PayPal Fees,11/17/23,Deposit,946590784K897934L,09 MSU RESTR,PayPal fees,OFFICE/GENERAL ADMINISTRATIVE EXPENSES:PayPal Fees,PayPal Bank 3,$24.92 ,"$51,699.26 "
PayPal Bank 3,11/16/23,Deposit,1RP33938FU887203C,04 PAYPAL GENERAL UNRESTR,Subject: GeneralPageTransaction ID: 1RP33938FU887203Chttps://www.paypal.com/activity/payment/1RP33938FU887203C,PayPal Bank 3,--,$19.69 ,"$51,718.95 "
Donations directed by individuals,11/16/23,Deposit,1RP33938FU887203C,04 PAYPAL GENERAL UNRESTR,Support Ukraine - Support Ukraine,Contributed income:Donations directed by individuals,PayPal Bank 3,$20.91 ,"$51,739.86 "
PayPal Fees,11/16/23,Deposit,1RP33938FU887203C,04 PAYPAL GENERAL UNRESTR,PayPal fees,OFFICE/GENERAL ADMINISTRATIVE EXPENSES:PayPal Fees,PayPal Bank 3,$1.22 ,"$51,741.08 "
PayPal Bank 3,11/16/23,Deposit,4NM84474AD8908245,04 PAYPAL GENERAL UNRESTR,Subject: Support UkraineTransaction ID: 4NM84474AD8908245https://www.paypal.com/activity/payment/4NM84474AD8908245,PayPal Bank 3,--,$20.95 ,"$51,762.03 "
Donations directed by individuals,11/16/23,Deposit,4NM84474AD8908245,04 PAYPAL GENERAL UNRESTR,Money in to PayPal,Contributed income:Donations directed by individuals,PayPal Bank 3,$22.22 ,"$51,784.25 "
PayPal Fees,11/16/23,Deposit,4NM84474AD8908245,04 PAYPAL GENERAL UNRESTR,PayPal fees,OFFICE/GENERAL ADMINISTRATIVE EXPENSES:PayPal Fees,PayPal Bank 3,$1.27 ,"$51,785.52 "
PayPal Bank 3,11/16/23,Deposit,6U502206B3752410U,04 PAYPAL GENERAL UNRESTR,Subject: Support UkraineTransaction ID: 6U502206B3752410Uhttps://www.paypal.com/activity/payment/6U502206B3752410U,PayPal Bank 3,--,$96.02 ,"$51,881.54 "
Donations directed by individuals,11/16/23,Deposit,6U502206B3752410U,04 PAYPAL GENERAL UNRESTR,Money in to PayPal,Contributed income:Donations directed by individuals,PayPal Bank 3,$100.00 ,"$51,981.54 "
PayPal Fees,11/16/23,Deposit,6U502206B3752410U,04 PAYPAL GENERAL UNRESTR,PayPal fees,OFFICE/GENERAL ADMINISTRATIVE EXPENSES:PayPal Fees,PayPal Bank 3,$3.98 ,"$51,985.52 "
PayPal Bank 3,11/16/23,Deposit,8N631128NU283800D,04 PAYPAL GENERAL UNRESTR,Subject: Support UkraineTransaction ID: 8N631128NU283800Dhttps://www.paypal.com/activity/payment/8N631128NU283800D,PayPal Bank 3,--,$99.38 ,"$52,084.90 "
Donations directed by individuals,11/16/23,Deposit,8N631128NU283800D,04 PAYPAL GENERAL UNRESTR,Money in to PayPal,Contributed income:Donations directed by individuals,PayPal Bank 3,$103.48 ,"$52,188.38 "
PayPal Fees,11/16/23,Deposit,8N631128NU283800D,04 PAYPAL GENERAL UNRESTR,PayPal fees,OFFICE/GENERAL ADMINISTRATIVE EXPENSES:PayPal Fees,PayPal Bank 3,$4.10 ,"$52,192.48 "
PayPal Bank 3,11/15/23,Deposit,5DU69793R9774634B,04 PAYPAL GENERAL UNRESTR,Subject: GeneralPageTransaction ID: 5DU69793R9774634Bhttps://www.paypal.com/activity/payment/5DU69793R9774634B,PayPal Bank 3,--,$29.53 ,"$52,222.01 "
Donations directed by individuals,11/15/23,Deposit,5DU69793R9774634B,04 PAYPAL GENERAL UNRESTR,Support Ukraine - Support Ukraine,Contributed income:Donations directed by individuals,PayPal Bank 3,$31.11 ,"$52,253.12 "
PayPal Fees,11/15/23,Deposit,5DU69793R9774634B,04 PAYPAL GENERAL UNRESTR,PayPal fees,OFFICE/GENERAL ADMINISTRATIVE EXPENSES:PayPal Fees,PayPal Bank 3,$1.58 ,"$52,254.70 "
PayPal Bank 3,11/15/23,Deposit,63F41457RF437581V,04 PAYPAL GENERAL UNRESTR,Subject: GeneralPageNote: Підтримую Марію БерлінськуTransaction ID: 63F41457RF437581Vhttps://www.paypal.com/activity/payment/63F41457RF437581V,PayPal Bank 3,--,$344.64 ,"$52,599.34 "
Donations directed by individuals,11/15/23,Deposit,63F41457RF437581V,04 PAYPAL GENERAL UNRESTR,Support Ukraine - Support Ukraine,Contributed income:Donations directed by individuals,PayPal Bank 3,$357.61 ,"$52,956.95 "
PayPal Fees,11/15/23,Deposit,63F41457RF437581V,04 PAYPAL GENERAL UNRESTR,PayPal fees,OFFICE/GENERAL ADMINISTRATIVE EXPENSES:PayPal Fees,PayPal Bank 3,$12.97 ,"$52,969.92 "
PayPal Bank 3,11/14/23,Deposit,2KV57684GJ548525A,07 1000 DRONES RESTR,Subject: 1000DRONESTransaction ID: 2KV57684GJ548525Ahttps://www.paypal.com/activity/payment/2KV57684GJ548525A,PayPal Bank 3,--,$9.84 ,"$52,979.76 "
Donations directed by individuals,11/14/23,Deposit,2KV57684GJ548525A,07 1000 DRONES RESTR,1000 DRONES FOR UKRAINE - 1000 DRONES FOR UKRAINE,Contributed income:Donations directed by individuals,PayPal Bank 3,$10.70 ,"$52,990.46 "
PayPal Fees,11/14/23,Deposit,2KV57684GJ548525A,07 1000 DRONES RESTR,PayPal fees,OFFICE/GENERAL ADMINISTRATIVE EXPENSES:PayPal Fees,PayPal Bank 3,$0.86 ,"$52,991.32 "
PayPal Bank 3,11/14/23,Deposit,15439952BG7656434,04 PAYPAL GENERAL UNRESTR,Subject: GeneralPageTransaction ID: 15439952BG7656434https://www.paypal.com/activity/payment/15439952BG7656434,PayPal Bank 3,--,$9.84 ,"$53,001.16 "
Donations directed by individuals,11/14/23,Deposit,15439952BG7656434,04 PAYPAL GENERAL UNRESTR,Support Ukraine - Support Ukraine,Contributed income:Donations directed by individuals,PayPal Bank 3,$10.70 ,"$53,011.86 "
PayPal Fees,11/14/23,Deposit,15439952BG7656434,04 PAYPAL GENERAL UNRESTR,PayPal fees,OFFICE/GENERAL ADMINISTRATIVE EXPENSES:PayPal Fees,PayPal Bank 3,$0.86 ,"$53,012.72 "
CHASE ENDING IN 5315,11/13/23,Expense,--,QuickBooks Payments,ORIG CO NAME:INTUIT * ORIG ID:0000756346 DESC DATE:231113 CO ENTRY DESCR:QBooks OnlSEC:CCD TRACE#:021000028042721 EED:231113 IND ID:1049765 IND NAME:DIGNITAS UK RAINE INC XXX-XXX-8848 TRN: XXXXXX2721 TC,CHASE ENDING IN 5315,Software & apps,($85.00),"$52,927.72 "
Software & apps,11/13/23,Expense,--,QuickBooks Payments,ORIG CO NAME:INTUIT * ORIG ID:0000756346 DESC DATE:231113 CO ENTRY DESCR:QBooks OnlSEC:CCD TRACE#:021000028042721 EED:231113 IND ID:1049765 IND NAME:DIGNITAS UK RAINE INC XXX-XXX-8848 TRN: XXXXXX2721 TC,OFFICE/GENERAL ADMINISTRATIVE EXPENSES:Software & apps,CHASE ENDING IN 5315,$85.00 ,"$53,012.72 "
PayPal Bank 3,11/13/23,Deposit,78869021TW708474E,10 Flight to Recovery RESTR,Subject: FlightToRecoveryNote: IsaacTransaction ID: 78869021TW708474Ehttps://www.paypal.com/activity/payment/78869021TW708474E,PayPal Bank 3,--,$50.00 ,"$53,062.72 "
Donations directed by individuals,11/13/23,Deposit,78869021TW708474E,10 Flight to Recovery RESTR,Flight to Recovery - Flight to Recovery,Contributed income:Donations directed by individuals,PayPal Bank 3,$51.52 ,"$53,114.24 "
PayPal Fees,11/13/23,Deposit,78869021TW708474E,10 Flight to Recovery RESTR,PayPal fees,OFFICE/GENERAL ADMINISTRATIVE EXPENSES:PayPal Fees,PayPal Bank 3,$1.52 ,"$53,115.76 "
PayPal Bank 3,11/13/23,Deposit,0RS08551F78623230,04 PAYPAL GENERAL UNRESTR,Subject: GeneralPageTransaction ID: 0RS08551F78623230https://www.paypal.com/activity/payment/0RS08551F78623230,PayPal Bank 3,--,$29.53 ,"$53,145.29 "
Donations directed by individuals,11/13/23,Deposit,0RS08551F78623230,04 PAYPAL GENERAL UNRESTR,Support Ukraine - Support Ukraine,Contributed income:Donations directed by individuals,PayPal Bank 3,$31.11 ,"$53,176.40 "
PayPal Fees,11/13/23,Deposit,0RS08551F78623230,04 PAYPAL GENERAL UNRESTR,PayPal fees,OFFICE/GENERAL ADMINISTRATIVE EXPENSES:PayPal Fees,PayPal Bank 3,$1.58 ,"$53,177.98 "
PayPal Bank 3,11/13/23,Deposit,36V58161VY376170A,04 PAYPAL GENERAL UNRESTR,Subject: Support UkraineTransaction ID: 36V58161VY376170Ahttps://www.paypal.com/activity/payment/36V58161VY376170A,PayPal Bank 3,--,$47.76 ,"$53,225.74 "
Donations directed by individuals,11/13/23,Deposit,36V58161VY376170A,04 PAYPAL GENERAL UNRESTR,Money in to PayPal,Contributed income:Donations directed by individuals,PayPal Bank 3,$50.00 ,"$53,275.74 "
PayPal Fees,11/13/23,Deposit,36V58161VY376170A,04 PAYPAL GENERAL UNRESTR,PayPal fees,OFFICE/GENERAL ADMINISTRATIVE EXPENSES:PayPal Fees,PayPal Bank 3,$2.24 ,"$53,277.98 "
PayPal Bank 3,11/13/23,Deposit,56T20513P1956125C,04 PAYPAL GENERAL UNRESTR,Subject: GeneralPageTransaction ID: 56T20513P1956125Chttps://www.paypal.com/activity/payment/56T20513P1956125C,PayPal Bank 3,--,"$1,969.39 ","$55,247.37 "
Donations directed by individuals,11/13/23,Deposit,56T20513P1956125C,04 PAYPAL GENERAL UNRESTR,Support Ukraine - Support Ukraine,Contributed income:Donations directed by individuals,PayPal Bank 3,"$2,041.11 ","$57,288.48 "
PayPal Fees,11/13/23,Deposit,56T20513P1956125C,04 PAYPAL GENERAL UNRESTR,PayPal fees,OFFICE/GENERAL ADMINISTRATIVE EXPENSES:PayPal Fees,PayPal Bank 3,$71.72 ,"$57,360.20 "
PayPal Bank 3,11/13/23,Deposit,7B755064TX917653F,04 PAYPAL GENERAL UNRESTR,Subject: Support UkraineTransaction ID: 7B755064TX917653Fhttps://www.paypal.com/activity/payment/7B755064TX917653F,PayPal Bank 3,--,$25.24 ,"$57,385.44 "
Donations directed by individuals,11/13/23,Deposit,7B755064TX917653F,04 PAYPAL GENERAL UNRESTR,Money in to PayPal,Contributed income:Donations directed by individuals,PayPal Bank 3,$26.25 ,"$57,411.69 "
PayPal Fees,11/13/23,Deposit,7B755064TX917653F,04 PAYPAL GENERAL UNRESTR,PayPal fees,OFFICE/GENERAL ADMINISTRATIVE EXPENSES:PayPal Fees,PayPal Bank 3,$1.01 ,"$57,412.70 "
PayPal Bank 3,11/13/23,Deposit,8X736057NS3616720,04 PAYPAL GENERAL UNRESTR,Subject: GeneralPageTransaction ID: 8X736057NS3616720https://www.paypal.com/activity/payment/8X736057NS3616720,PayPal Bank 3,--,$100.00 ,"$57,512.70 "
Donations directed by individuals,11/13/23,Deposit,8X736057NS3616720,04 PAYPAL GENERAL UNRESTR,Support Ukraine - Support Ukraine,Contributed income:Donations directed by individuals,PayPal Bank 3,$102.53 ,"$57,615.23 "
PayPal Fees,11/13/23,Deposit,8X736057NS3616720,04 PAYPAL GENERAL UNRESTR,PayPal fees,OFFICE/GENERAL ADMINISTRATIVE EXPENSES:PayPal Fees,PayPal Bank 3,$2.53 ,"$57,617.76 "
PayPal Bank 3,11/13/23,Deposit,654961033L200014S,09 MSU RESTR,Subject: GeneralPageTransaction ID: 654961033L200014Shttps://www.paypal.com/activity/payment/654961033L200014S,PayPal Bank 3,--,$500.00 ,"$58,117.76 "
Donations directed by individuals,11/13/23,Deposit,654961033L200014S,09 MSU RESTR,Support Ukraine - Support Ukraine,Contributed income:Donations directed by individuals,PayPal Bank 3,$510.65 ,"$58,628.41 "
PayPal Fees,11/13/23,Deposit,654961033L200014S,09 MSU RESTR,PayPal fees,OFFICE/GENERAL ADMINISTRATIVE EXPENSES:PayPal Fees,PayPal Bank 3,$10.65 ,"$58,639.06 "
PayPal Bank 3,11/12/23,Deposit,1D374671VH947992T,04 PAYPAL GENERAL UNRESTR,Subject: Support UkraineTransaction ID: 1D374671VH947992Thttps://www.paypal.com/activity/payment/1D374671VH947992T,PayPal Bank 3,--,$50.47 ,"$58,689.53 "
Donations directed by individuals,11/12/23,Deposit,1D374671VH947992T,04 PAYPAL GENERAL UNRESTR,Money in to PayPal,Contributed income:Donations directed by individuals,PayPal Bank 3,$51.99 ,"$58,741.52 "
PayPal Fees,11/12/23,Deposit,1D374671VH947992T,04 PAYPAL GENERAL UNRESTR,PayPal fees,OFFICE/GENERAL ADMINISTRATIVE EXPENSES:PayPal Fees,PayPal Bank 3,$1.52 ,"$58,743.04 "
PayPal Bank 3,11/12/23,Deposit,87R761628E259863L,04 PAYPAL GENERAL UNRESTR,Subject: GeneralPageNote: This is in memory of Alan GrodinTransaction ID: 87R761628E259863Lhttps://www.paypal.com/activity/payment/87R761628E259863L,PayPal Bank 3,--,$34.79 ,"$58,777.83 "
Donations directed by individuals,11/12/23,Deposit,87R761628E259863L,04 PAYPAL GENERAL UNRESTR,Support Ukraine - Support Ukraine,Contributed income:Donations directed by individuals,PayPal Bank 3,$36.00 ,"$58,813.83 "
PayPal Fees,11/12/23,Deposit,87R761628E259863L,04 PAYPAL GENERAL UNRESTR,PayPal fees,OFFICE/GENERAL ADMINISTRATIVE EXPENSES:PayPal Fees,PayPal Bank 3,$1.21 ,"$58,815.04 "
PayPal Bank 3,11/11/23,Deposit,5U7226499J3975933,09 MSU RESTR,Subject: New 10 UnitsTransaction ID: 5U7226499J3975933https://www.paypal.com/activity/payment/5U7226499J3975933,PayPal Bank 3,--,$385.55 ,"$59,200.59 "
Donations directed by individuals,11/11/23,Deposit,5U7226499J3975933,09 MSU RESTR,donation-form,Contributed income:Donations directed by individuals,PayPal Bank 3,$400.00 ,"$59,600.59 "
PayPal Fees,11/11/23,Deposit,5U7226499J3975933,09 MSU RESTR,PayPal fees,OFFICE/GENERAL ADMINISTRATIVE EXPENSES:PayPal Fees,PayPal Bank 3,$14.45 ,"$59,615.04 "
PayPal Bank 3,11/11/23,Deposit,51A94533F78069624,07 1000 DRONES RESTR,Subject: 1000DRONESTransaction ID: 51A94533F78069624https://www.paypal.com/activity/payment/51A94533F78069624,PayPal Bank 3,--,$97.52 ,"$59,712.56 "
Donations directed by individuals,11/11/23,Deposit,51A94533F78069624,07 1000 DRONES RESTR,1000 DRONES FOR UKRAINE - 1000 DRONES FOR UKRAINE,Contributed income:Donations directed by individuals,PayPal Bank 3,$100.00 ,"$59,812.56 "
PayPal Fees,11/11/23,Deposit,51A94533F78069624,07 1000 DRONES RESTR,PayPal fees,OFFICE/GENERAL ADMINISTRATIVE EXPENSES:PayPal Fees,PayPal Bank 3,$2.48 ,"$59,815.04 "
PayPal Bank 3,11/11/23,Deposit,1N655123MG198440Y,04 PAYPAL GENERAL UNRESTR,Subject: Support UkraineTransaction ID: 1N655123MG198440Yhttps://www.paypal.com/activity/payment/1N655123MG198440Y,PayPal Bank 3,--,$47.76 ,"$59,862.80 "
Donations directed by individuals,11/11/23,Deposit,1N655123MG198440Y,04 PAYPAL GENERAL UNRESTR,Money in to PayPal,Contributed income:Donations directed by individuals,PayPal Bank 3,$50.00 ,"$59,912.80 "
PayPal Fees,11/11/23,Deposit,1N655123MG198440Y,04 PAYPAL GENERAL UNRESTR,PayPal fees,OFFICE/GENERAL ADMINISTRATIVE EXPENSES:PayPal Fees,PayPal Bank 3,$2.24 ,"$59,915.04 "
PayPal Bank 3,11/11/23,Deposit,0U6546026X424724E,04 PAYPAL GENERAL UNRESTR,Subject: Support UkraineTransaction ID: 0U6546026X424724Ehttps://www.paypal.com/activity/payment/0U6546026X424724E,PayPal Bank 3,--,$4.96 ,"$59,920.00 "
Donations directed by individuals,11/11/23,Deposit,0U6546026X424724E,04 PAYPAL GENERAL UNRESTR,Money in to PayPal,Contributed income:Donations directed by individuals,PayPal Bank 3,$5.65 ,"$59,925.65 "
PayPal Fees,11/11/23,Deposit,0U6546026X424724E,04 PAYPAL GENERAL UNRESTR,PayPal fees,OFFICE/GENERAL ADMINISTRATIVE EXPENSES:PayPal Fees,PayPal Bank 3,$0.69 ,"$59,926.34 "
PayPal Bank 3,11/11/23,Deposit,9JU36938CB3463615,04 PAYPAL GENERAL UNRESTR,Subject: Support UkraineTransaction ID: 9JU36938CB3463615https://www.paypal.com/activity/payment/9JU36938CB3463615,PayPal Bank 3,--,$23.64 ,"$59,949.98 "
Donations directed by individuals,11/11/23,Deposit,9JU36938CB3463615,04 PAYPAL GENERAL UNRESTR,Money in to PayPal,Contributed income:Donations directed by individuals,PayPal Bank 3,$25.00 ,"$59,974.98 "
PayPal Fees,11/11/23,Deposit,9JU36938CB3463615,04 PAYPAL GENERAL UNRESTR,PayPal fees,OFFICE/GENERAL ADMINISTRATIVE EXPENSES:PayPal Fees,PayPal Bank 3,$1.36 ,"$59,976.34 "
PayPal Bank 3,11/11/23,Deposit,2MH54477VK815370R,04 PAYPAL GENERAL UNRESTR,Subject: Support UkraineTransaction ID: 2MH54477VK815370Rhttps://www.paypal.com/activity/payment/2MH54477VK815370R,PayPal Bank 3,--,$100.93 ,"$60,077.27 "
Donations directed by individuals,11/11/23,Deposit,2MH54477VK815370R,04 PAYPAL GENERAL UNRESTR,Money in to PayPal,Contributed income:Donations directed by individuals,PayPal Bank 3,$103.48 ,"$60,180.75 "
PayPal Fees,11/11/23,Deposit,2MH54477VK815370R,04 PAYPAL GENERAL UNRESTR,PayPal fees,OFFICE/GENERAL ADMINISTRATIVE EXPENSES:PayPal Fees,PayPal Bank 3,$2.55 ,"$60,183.30 "
PayPal Bank 3,11/11/23,Deposit,3WJ048240K5550949,04 PAYPAL GENERAL UNRESTR,Subject: Support UkraineTransaction ID: 3WJ048240K5550949https://www.paypal.com/activity/payment/3WJ048240K5550949,PayPal Bank 3,--,$18.81 ,"$60,202.11 "
Donations directed by individuals,11/11/23,Deposit,3WJ048240K5550949,04 PAYPAL GENERAL UNRESTR,Money in to PayPal,Contributed income:Donations directed by individuals,PayPal Bank 3,$20.00 ,"$60,222.11 "
PayPal Fees,11/11/23,Deposit,3WJ048240K5550949,04 PAYPAL GENERAL UNRESTR,PayPal fees,OFFICE/GENERAL ADMINISTRATIVE EXPENSES:PayPal Fees,PayPal Bank 3,$1.19 ,"$60,223.30 "
PayPal Bank 3,11/10/23,Deposit,4M375196YS401223R,04 PAYPAL GENERAL UNRESTR,Subject: GeneralPageTransaction ID: 4M375196YS401223Rhttps://www.paypal.com/activity/payment/4M375196YS401223R,PayPal Bank 3,--,$100.00 ,"$60,323.30 "
Donations directed by individuals,11/10/23,Deposit,4M375196YS401223R,04 PAYPAL GENERAL UNRESTR,Support Ukraine - Support Ukraine,Contributed income:Donations directed by individuals,PayPal Bank 3,$102.53 ,"$60,425.83 "
PayPal Fees,11/10/23,Deposit,4M375196YS401223R,04 PAYPAL GENERAL UNRESTR,PayPal fees,OFFICE/GENERAL ADMINISTRATIVE EXPENSES:PayPal Fees,PayPal Bank 3,$2.53 ,"$60,428.36 "
PayPal Bank 3,11/10/23,Deposit,265038198F498983U,09 MSU RESTR,Subject: New 10 UnitsTransaction ID: 265038198F498983Uhttps://www.paypal.com/activity/payment/265038198F498983U,PayPal Bank 3,--,$96.02 ,"$60,524.38 "
Donations directed by individuals,11/10/23,Deposit,265038198F498983U,09 MSU RESTR,donation-form,Contributed income:Donations directed by individuals,PayPal Bank 3,$100.00 ,"$60,624.38 "
PayPal Fees,11/10/23,Deposit,265038198F498983U,09 MSU RESTR,PayPal fees,OFFICE/GENERAL ADMINISTRATIVE EXPENSES:PayPal Fees,PayPal Bank 3,$3.98 ,"$60,628.36 "
PayPal Bank 3,11/10/23,Deposit,39V47375DL031561N,04 PAYPAL GENERAL UNRESTR,Subject: GeneralPageTransaction ID: 39V47375DL031561Nhttps://www.paypal.com/activity/payment/39V47375DL031561N,PayPal Bank 3,--,$49.23 ,"$60,677.59 "
Donations directed by individuals,11/10/23,Deposit,39V47375DL031561N,04 PAYPAL GENERAL UNRESTR,Support Ukraine - Support Ukraine,Contributed income:Donations directed by individuals,PayPal Bank 3,$51.52 ,"$60,729.11 "
PayPal Fees,11/10/23,Deposit,39V47375DL031561N,04 PAYPAL GENERAL UNRESTR,PayPal fees,OFFICE/GENERAL ADMINISTRATIVE EXPENSES:PayPal Fees,PayPal Bank 3,$2.29 ,"$60,731.40 "
PayPal Bank 3,11/10/23,Deposit,4UC672896T226773P,09 MSU RESTR,Subject: New 10 UnitsTransaction ID: 4UC672896T226773Phttps://www.paypal.com/activity/payment/4UC672896T226773P,PayPal Bank 3,--,$9.16 ,"$60,740.56 "
Donations directed by individuals,11/10/23,Deposit,4UC672896T226773P,09 MSU RESTR,donation-form,Contributed income:Donations directed by individuals,PayPal Bank 3,$10.00 ,"$60,750.56 "
PayPal Fees,11/10/23,Deposit,4UC672896T226773P,09 MSU RESTR,PayPal fees,OFFICE/GENERAL ADMINISTRATIVE EXPENSES:PayPal Fees,PayPal Bank 3,$0.84 ,"$60,751.40 "
PayPal Bank 3,11/10/23,Deposit,9UV35178ER036441J,04 PAYPAL GENERAL UNRESTR,Subject: GeneralPageNote: Donation for Saving UkraineTransaction ID: 9UV35178ER036441Jhttps://www.paypal.com/activity/payment/9UV35178ER036441J,PayPal Bank 3,--,$100.00 ,"$60,851.40 "
Donations directed by individuals,11/10/23,Deposit,9UV35178ER036441J,04 PAYPAL GENERAL UNRESTR,Support Ukraine - Support Ukraine,Contributed income:Donations directed by individuals,PayPal Bank 3,$102.53 ,"$60,953.93 "
PayPal Fees,11/10/23,Deposit,9UV35178ER036441J,04 PAYPAL GENERAL UNRESTR,PayPal fees,OFFICE/GENERAL ADMINISTRATIVE EXPENSES:PayPal Fees,PayPal Bank 3,$2.53 ,"$60,956.46 "
PayPal Bank 3,11/10/23,Deposit,1H080363RR630732D,04 PAYPAL GENERAL UNRESTR,Subject: Support UkraineTransaction ID: 1H080363RR630732Dhttps://www.paypal.com/activity/payment/1H080363RR630732D,PayPal Bank 3,--,$29.81 ,"$60,986.27 "
Donations directed by individuals,11/10/23,Deposit,1H080363RR630732D,04 PAYPAL GENERAL UNRESTR,Money in to PayPal,Contributed income:Donations directed by individuals,PayPal Bank 3,$31.40 ,"$61,017.67 "
PayPal Fees,11/10/23,Deposit,1H080363RR630732D,04 PAYPAL GENERAL UNRESTR,PayPal fees,OFFICE/GENERAL ADMINISTRATIVE EXPENSES:PayPal Fees,PayPal Bank 3,$1.59 ,"$61,019.26 "
PayPal Bank 3,11/10/23,Deposit,8DU565541T2160140,09 MSU RESTR,Subject: New 10 UnitsTransaction ID: 8DU565541T2160140https://www.paypal.com/activity/payment/8DU565541T2160140,PayPal Bank 3,--,$244.53 ,"$61,263.79 "
Donations directed by individuals,11/10/23,Deposit,8DU565541T2160140,09 MSU RESTR,donation-form,Contributed income:Donations directed by individuals,PayPal Bank 3,$250.00 ,"$61,513.79 "
PayPal Fees,11/10/23,Deposit,8DU565541T2160140,09 MSU RESTR,PayPal fees,OFFICE/GENERAL ADMINISTRATIVE EXPENSES:PayPal Fees,PayPal Bank 3,$5.47 ,"$61,519.26 "
PayPal Bank 3,11/10/23,Deposit,97C07921F3708191D,04 PAYPAL GENERAL UNRESTR,Subject: GeneralPageTransaction ID: 97C07921F3708191Dhttps://www.paypal.com/activity/payment/97C07921F3708191D,PayPal Bank 3,--,$49.23 ,"$61,568.49 "
Donations directed by individuals,11/10/23,Deposit,97C07921F3708191D,04 PAYPAL GENERAL UNRESTR,Support Ukraine - Support Ukraine,Contributed income:Donations directed by individuals,PayPal Bank 3,$51.52 ,"$61,620.01 "
PayPal Fees,11/10/23,Deposit,97C07921F3708191D,04 PAYPAL GENERAL UNRESTR,PayPal fees,OFFICE/GENERAL ADMINISTRATIVE EXPENSES:PayPal Fees,PayPal Bank 3,$2.29 ,"$61,622.30 "
PayPal Bank 3,11/9/23,Deposit,6AC425960S3157333,07 1000 DRONES RESTR,Subject: 1000DRONESTransaction ID: 6AC425960S3157333https://www.paypal.com/activity/payment/6AC425960S3157333,PayPal Bank 3,--,$196.93 ,"$61,819.23 "
Donations directed by individuals,11/9/23,Deposit,6AC425960S3157333,07 1000 DRONES RESTR,1000 DRONES FOR UKRAINE - 1000 DRONES FOR UKRAINE,Contributed income:Donations directed by individuals,PayPal Bank 3,$204.56 ,"$62,023.79 "
PayPal Fees,11/9/23,Deposit,6AC425960S3157333,07 1000 DRONES RESTR,PayPal fees,OFFICE/GENERAL ADMINISTRATIVE EXPENSES:PayPal Fees,PayPal Bank 3,$7.63 ,"$62,031.42 "
PayPal Bank 3,11/9/23,Deposit,88J63350RK9817538,04 PAYPAL GENERAL UNRESTR,Subject: GeneralPageTransaction ID: 88J63350RK9817538https://www.paypal.com/activity/payment/88J63350RK9817538,PayPal Bank 3,--,$50.00 ,"$62,081.42 "
Donations directed by individuals,11/9/23,Deposit,88J63350RK9817538,04 PAYPAL GENERAL UNRESTR,Support Ukraine - Support Ukraine,Contributed income:Donations directed by individuals,PayPal Bank 3,$51.52 ,"$62,132.94 "
PayPal Fees,11/9/23,Deposit,88J63350RK9817538,04 PAYPAL GENERAL UNRESTR,PayPal fees,OFFICE/GENERAL ADMINISTRATIVE EXPENSES:PayPal Fees,PayPal Bank 3,$1.52 ,"$62,134.46 "
PayPal Bank 3,11/8/23,Deposit,3BM45253DS8382105,04 PAYPAL GENERAL UNRESTR,Subject: GeneralPageTransaction ID: 3BM45253DS8382105https://www.paypal.com/activity/payment/3BM45253DS8382105,PayPal Bank 3,--,$492.34 ,"$62,626.80 "
Donations directed by individuals,11/8/23,Deposit,3BM45253DS8382105,04 PAYPAL GENERAL UNRESTR,Support Ukraine - Support Ukraine,Contributed income:Donations directed by individuals,PayPal Bank 3,$510.65 ,"$63,137.45 "
PayPal Fees,11/8/23,Deposit,3BM45253DS8382105,04 PAYPAL GENERAL UNRESTR,PayPal fees,OFFICE/GENERAL ADMINISTRATIVE EXPENSES:PayPal Fees,PayPal Bank 3,$18.31 ,"$63,155.76 "
PayPal Bank 3,11/8/23,Deposit,8ND56931PM159324A,04 PAYPAL GENERAL UNRESTR,Subject: GeneralPageTransaction ID: 8ND56931PM159324Ahttps://www.paypal.com/activity/payment/8ND56931PM159324A,PayPal Bank 3,--,$4.34 ,"$63,160.10 "
Donations directed by individuals,11/8/23,Deposit,8ND56931PM159324A,04 PAYPAL GENERAL UNRESTR,Support Ukraine - Support Ukraine,Contributed income:Donations directed by individuals,PayPal Bank 3,$5.00 ,"$63,165.10 "
PayPal Fees,11/8/23,Deposit,8ND56931PM159324A,04 PAYPAL GENERAL UNRESTR,PayPal fees,OFFICE/GENERAL ADMINISTRATIVE EXPENSES:PayPal Fees,PayPal Bank 3,$0.66 ,"$63,165.76 "
PayPal Bank 3,11/8/23,Deposit,4NU25664KM384682N,09 MSU RESTR,Subject: New 10 UnitsTransaction ID: 4NU25664KM384682Nhttps://www.paypal.com/activity/payment/4NU25664KM384682N,PayPal Bank 3,--,$24.01 ,"$63,189.77 "
Donations directed by individuals,11/8/23,Deposit,4NU25664KM384682N,09 MSU RESTR,donation-form,Contributed income:Donations directed by individuals,PayPal Bank 3,$25.00 ,"$63,214.77 "
PayPal Fees,11/8/23,Deposit,4NU25664KM384682N,09 MSU RESTR,PayPal fees,OFFICE/GENERAL ADMINISTRATIVE EXPENSES:PayPal Fees,PayPal Bank 3,$0.99 ,"$63,215.76 "
PayPal Bank 3,11/8/23,Deposit,2E109844K8437032H,04 PAYPAL GENERAL UNRESTR,Subject: GeneralPageTransaction ID: 2E109844K8437032Hhttps://www.paypal.com/activity/payment/2E109844K8437032H,PayPal Bank 3,--,$587.57 ,"$63,803.33 "
Donations directed by individuals,11/8/23,Deposit,2E109844K8437032H,04 PAYPAL GENERAL UNRESTR,Support Ukraine - Support Ukraine,Contributed income:Donations directed by individuals,PayPal Bank 3,$600.00 ,"$64,403.33 "
PayPal Fees,11/8/23,Deposit,2E109844K8437032H,04 PAYPAL GENERAL UNRESTR,PayPal fees,OFFICE/GENERAL ADMINISTRATIVE EXPENSES:PayPal Fees,PayPal Bank 3,$12.43 ,"$64,415.76 "
PayPal Bank 3,11/8/23,Deposit,6D152917S27452359,09 MSU RESTR,Subject: New 10 UnitsTransaction ID: 6D152917S27452359https://www.paypal.com/activity/payment/6D152917S27452359,PayPal Bank 3,--,$24.01 ,"$64,439.77 "
Donations directed by individuals,11/8/23,Deposit,6D152917S27452359,09 MSU RESTR,donation-form,Contributed income:Donations directed by individuals,PayPal Bank 3,$25.00 ,"$64,464.77 "
PayPal Fees,11/8/23,Deposit,6D152917S27452359,09 MSU RESTR,PayPal fees,OFFICE/GENERAL ADMINISTRATIVE EXPENSES:PayPal Fees,PayPal Bank 3,$0.99 ,"$64,465.76 "
PayPal Bank 3,11/7/23,Deposit,7D7638180F816601D,04 PAYPAL GENERAL UNRESTR,Subject: Support UkraineTransaction ID: 7D7638180F816601Dhttps://www.paypal.com/activity/payment/7D7638180F816601D,PayPal Bank 3,--,$50.00 ,"$64,515.76 "
Donations directed by individuals,11/7/23,Deposit,7D7638180F816601D,04 PAYPAL GENERAL UNRESTR,Money in to PayPal,Contributed income:Donations directed by individuals,PayPal Bank 3,$51.52 ,"$64,567.28 "
PayPal Fees,11/7/23,Deposit,7D7638180F816601D,04 PAYPAL GENERAL UNRESTR,PayPal fees,OFFICE/GENERAL ADMINISTRATIVE EXPENSES:PayPal Fees,PayPal Bank 3,$1.52 ,"$64,568.80 "
PayPal Bank 3,11/7/23,Deposit,9X597589P7464142X,04 PAYPAL GENERAL UNRESTR,Subject: GeneralPageTransaction ID: 9X597589P7464142Xhttps://www.paypal.com/activity/payment/9X597589P7464142X,PayPal Bank 3,--,$14.76 ,"$64,583.56 "
Donations directed by individuals,11/7/23,Deposit,9X597589P7464142X,04 PAYPAL GENERAL UNRESTR,Support Ukraine - Support Ukraine,Contributed income:Donations directed by individuals,PayPal Bank 3,$15.80 ,"$64,599.36 "
PayPal Fees,11/7/23,Deposit,9X597589P7464142X,04 PAYPAL GENERAL UNRESTR,PayPal fees,OFFICE/GENERAL ADMINISTRATIVE EXPENSES:PayPal Fees,PayPal Bank 3,$1.04 ,"$64,600.40 "
PayPal Bank 3,11/7/23,Deposit,6NA26645VV291590K,04 PAYPAL GENERAL UNRESTR,Subject: GeneralPageTransaction ID: 6NA26645VV291590Khttps://www.paypal.com/activity/payment/6NA26645VV291590K,PayPal Bank 3,--,$29.53 ,"$64,629.93 "
Donations directed by individuals,11/7/23,Deposit,6NA26645VV291590K,04 PAYPAL GENERAL UNRESTR,Support Ukraine - Support Ukraine,Contributed income:Donations directed by individuals,PayPal Bank 3,$31.11 ,"$64,661.04 "
PayPal Fees,11/7/23,Deposit,6NA26645VV291590K,04 PAYPAL GENERAL UNRESTR,PayPal fees,OFFICE/GENERAL ADMINISTRATIVE EXPENSES:PayPal Fees,PayPal Bank 3,$1.58 ,"$64,662.62 "
PayPal Bank 3,11/6/23,Deposit,82566927NW225203G,04 PAYPAL GENERAL UNRESTR,Subject: GeneralPageTransaction ID: 82566927NW225203Ghttps://www.paypal.com/activity/payment/82566927NW225203G,PayPal Bank 3,--,$50.00 ,"$64,712.62 "
Donations directed by individuals,11/6/23,Deposit,82566927NW225203G,04 PAYPAL GENERAL UNRESTR,Support Ukraine - Support Ukraine,Contributed income:Donations directed by individuals,PayPal Bank 3,$51.52 ,"$64,764.14 "
PayPal Fees,11/6/23,Deposit,82566927NW225203G,04 PAYPAL GENERAL UNRESTR,PayPal fees,OFFICE/GENERAL ADMINISTRATIVE EXPENSES:PayPal Fees,PayPal Bank 3,$1.52 ,"$64,765.66 "
PayPal Bank 3,11/6/23,Deposit,4S825731PT536113T,04 PAYPAL GENERAL UNRESTR,Transaction ID: 4S825731PT536113Thttps://www.paypal.com/activity/payment/4S825731PT536113T,PayPal Bank 3,Donations directed by individuals,$30.57 ,"$64,796.23 "
Donations directed by individuals,11/6/23,Deposit,4S825731PT536113T,04 PAYPAL GENERAL UNRESTR,Money in to PayPal,Contributed income:Donations directed by individuals,PayPal Bank 3,$30.57 ,"$64,826.80 "
PayPal Bank 3,11/6/23,Deposit,4CS40352D7239531V,04 PAYPAL GENERAL UNRESTR,Subject: Support UkraineTransaction ID: 4CS40352D7239531Vhttps://www.paypal.com/activity/payment/4CS40352D7239531V,PayPal Bank 3,--,$4.34 ,"$64,831.14 "
Donations directed by individuals,11/6/23,Deposit,4CS40352D7239531V,04 PAYPAL GENERAL UNRESTR,Money in to PayPal,Contributed income:Donations directed by individuals,PayPal Bank 3,$5.00 ,"$64,836.14 "
PayPal Fees,11/6/23,Deposit,4CS40352D7239531V,04 PAYPAL GENERAL UNRESTR,PayPal fees,OFFICE/GENERAL ADMINISTRATIVE EXPENSES:PayPal Fees,PayPal Bank 3,$0.66 ,"$64,836.80 "
PayPal Bank 3,11/6/23,Deposit,7J1330564C9419710,04 PAYPAL GENERAL UNRESTR,Subject: GeneralPageTransaction ID: 7J1330564C9419710https://www.paypal.com/activity/payment/7J1330564C9419710,PayPal Bank 3,--,$96.02 ,"$64,932.82 "
Donations directed by individuals,11/6/23,Deposit,7J1330564C9419710,04 PAYPAL GENERAL UNRESTR,Support Ukraine - Support Ukraine,Contributed income:Donations directed by individuals,PayPal Bank 3,$100.00 ,"$65,032.82 "
PayPal Fees,11/6/23,Deposit,7J1330564C9419710,04 PAYPAL GENERAL UNRESTR,PayPal fees,OFFICE/GENERAL ADMINISTRATIVE EXPENSES:PayPal Fees,PayPal Bank 3,$3.98 ,"$65,036.80 "
PayPal Bank 3,11/6/23,Deposit,0L889328759168148,04 PAYPAL GENERAL UNRESTR,Subject: Support UkraineTransaction ID: 0L889328759168148https://www.paypal.com/activity/payment/0L889328759168148,PayPal Bank 3,--,$69.00 ,"$65,105.80 "
Donations directed by individuals,11/6/23,Deposit,0L889328759168148,04 PAYPAL GENERAL UNRESTR,Money in to PayPal,Contributed income:Donations directed by individuals,PayPal Bank 3,$72.00 ,"$65,177.80 "
PayPal Fees,11/6/23,Deposit,0L889328759168148,04 PAYPAL GENERAL UNRESTR,PayPal fees,OFFICE/GENERAL ADMINISTRATIVE EXPENSES:PayPal Fees,PayPal Bank 3,$3.00 ,"$65,180.80 "
PayPal Bank 3,11/5/23,Deposit,4DF52576C2571600D,04 PAYPAL GENERAL UNRESTR,Subject: GeneralPageTransaction ID: 4DF52576C2571600Dhttps://www.paypal.com/activity/payment/4DF52576C2571600D,PayPal Bank 3,--,$34.79 ,"$65,215.59 "
Donations directed by individuals,11/5/23,Deposit,4DF52576C2571600D,04 PAYPAL GENERAL UNRESTR,Support Ukraine - Support Ukraine,Contributed income:Donations directed by individuals,PayPal Bank 3,$36.00 ,"$65,251.59 "
PayPal Fees,11/5/23,Deposit,4DF52576C2571600D,04 PAYPAL GENERAL UNRESTR,PayPal fees,OFFICE/GENERAL ADMINISTRATIVE EXPENSES:PayPal Fees,PayPal Bank 3,$1.21 ,"$65,252.80 "
PayPal Bank 3,11/5/23,Deposit,9X960290TE256110F,07 1000 DRONES RESTR,Subject: 1000 DRONES FOR UKRAINETransaction ID: 9X960290TE256110Fhttps://www.paypal.com/activity/payment/9X960290TE256110F,PayPal Bank 3,--,$24.84 ,"$65,277.64 "
Donations directed by individuals,11/5/23,Deposit,9X960290TE256110F,07 1000 DRONES RESTR,Money in to PayPal,Contributed income:Donations directed by individuals,PayPal Bank 3,$26.25 ,"$65,303.89 "
PayPal Fees,11/5/23,Deposit,9X960290TE256110F,07 1000 DRONES RESTR,PayPal fees,OFFICE/GENERAL ADMINISTRATIVE EXPENSES:PayPal Fees,PayPal Bank 3,$1.41 ,"$65,305.30 "
PayPal Bank 3,11/5/23,Deposit,5DF10798AN556245H,04 PAYPAL GENERAL UNRESTR,Subject: GeneralPageTransaction ID: 5DF10798AN556245Hhttps://www.paypal.com/activity/payment/5DF10798AN556245H,PayPal Bank 3,--,$49.23 ,"$65,354.53 "
Donations directed by individuals,11/5/23,Deposit,5DF10798AN556245H,04 PAYPAL GENERAL UNRESTR,Support Ukraine - Support Ukraine,Contributed income:Donations directed by individuals,PayPal Bank 3,$51.52 ,"$65,406.05 "
PayPal Fees,11/5/23,Deposit,5DF10798AN556245H,04 PAYPAL GENERAL UNRESTR,PayPal fees,OFFICE/GENERAL ADMINISTRATIVE EXPENSES:PayPal Fees,PayPal Bank 3,$2.29 ,"$65,408.34 "
PayPal Bank 3,11/5/23,Deposit,4YB35206YB127561M,04 PAYPAL GENERAL UNRESTR,Subject: GeneralPageNote: Glory to UkraineTransaction ID: 4YB35206YB127561Mhttps://www.paypal.com/activity/payment/4YB35206YB127561M,PayPal Bank 3,--,$489.56 ,"$65,897.90 "
Donations directed by individuals,11/5/23,Deposit,4YB35206YB127561M,04 PAYPAL GENERAL UNRESTR,Support Ukraine - Support Ukraine,Contributed income:Donations directed by individuals,PayPal Bank 3,$500.00 ,"$66,397.90 "
PayPal Fees,11/5/23,Deposit,4YB35206YB127561M,04 PAYPAL GENERAL UNRESTR,PayPal fees,OFFICE/GENERAL ADMINISTRATIVE EXPENSES:PayPal Fees,PayPal Bank 3,$10.44 ,"$66,408.34 "
PayPal Bank 3,11/5/23,Deposit,1TV21081GK059772S,04 PAYPAL GENERAL UNRESTR,Subject: Support UkraineTransaction ID: 1TV21081GK059772Shttps://www.paypal.com/activity/payment/1TV21081GK059772S,PayPal Bank 3,--,$11.92 ,"$66,420.26 "
Donations directed by individuals,11/5/23,Deposit,1TV21081GK059772S,04 PAYPAL GENERAL UNRESTR,Money in to PayPal,Contributed income:Donations directed by individuals,PayPal Bank 3,$12.86 ,"$66,433.12 "
PayPal Fees,11/5/23,Deposit,1TV21081GK059772S,04 PAYPAL GENERAL UNRESTR,PayPal fees,OFFICE/GENERAL ADMINISTRATIVE EXPENSES:PayPal Fees,PayPal Bank 3,$0.94 ,"$66,434.06 "
PayPal Bank 3,11/5/23,Deposit,3PS78966SG9335847,07 1000 DRONES RESTR,Subject: 1000 DRONES FOR UKRAINETransaction ID: 3PS78966SG9335847https://www.paypal.com/activity/payment/3PS78966SG9335847,PayPal Bank 3,--,$10.93 ,"$66,444.99 "
Donations directed by individuals,11/5/23,Deposit,3PS78966SG9335847,07 1000 DRONES RESTR,Money in to PayPal,Contributed income:Donations directed by individuals,PayPal Bank 3,$11.83 ,"$66,456.82 "
PayPal Fees,11/5/23,Deposit,3PS78966SG9335847,07 1000 DRONES RESTR,PayPal fees,OFFICE/GENERAL ADMINISTRATIVE EXPENSES:PayPal Fees,PayPal Bank 3,$0.90 ,"$66,457.72 "
PayPal Bank 3,11/5/23,Deposit,3KG50446G6980404Y,04 PAYPAL GENERAL UNRESTR,Subject: GeneralPageTransaction ID: 3KG50446G6980404Yhttps://www.paypal.com/activity/payment/3KG50446G6980404Y,PayPal Bank 3,--,$47.76 ,"$66,505.48 "
Donations directed by individuals,11/5/23,Deposit,3KG50446G6980404Y,04 PAYPAL GENERAL UNRESTR,Support Ukraine - Support Ukraine,Contributed income:Donations directed by individuals,PayPal Bank 3,$50.00 ,"$66,555.48 "
PayPal Fees,11/5/23,Deposit,3KG50446G6980404Y,04 PAYPAL GENERAL UNRESTR,PayPal fees,OFFICE/GENERAL ADMINISTRATIVE EXPENSES:PayPal Fees,PayPal Bank 3,$2.24 ,"$66,557.72 "
PayPal Bank 3,11/5/23,Deposit,2FD91573BU3783408,04 PAYPAL GENERAL UNRESTR,Subject: Support UkraineTransaction ID: 2FD91573BU3783408https://www.paypal.com/activity/payment/2FD91573BU3783408,PayPal Bank 3,--,$50.00 ,"$66,607.72 "
Donations directed by individuals,11/5/23,Deposit,2FD91573BU3783408,04 PAYPAL GENERAL UNRESTR,Money in to PayPal,Contributed income:Donations directed by individuals,PayPal Bank 3,$51.52 ,"$66,659.24 "
PayPal Fees,11/5/23,Deposit,2FD91573BU3783408,04 PAYPAL GENERAL UNRESTR,PayPal fees,OFFICE/GENERAL ADMINISTRATIVE EXPENSES:PayPal Fees,PayPal Bank 3,$1.52 ,"$66,660.76 "
PayPal Bank 3,11/5/23,Deposit,2LT016854L959084U,04 PAYPAL GENERAL UNRESTR,Subject: GeneralPageTransaction ID: 2LT016854L959084Uhttps://www.paypal.com/activity/payment/2LT016854L959084U,PayPal Bank 3,--,$300.00 ,"$66,960.76 "
Donations directed by individuals,11/5/23,Deposit,2LT016854L959084U,04 PAYPAL GENERAL UNRESTR,Support Ukraine - Support Ukraine,Contributed income:Donations directed by individuals,PayPal Bank 3,$306.59 ,"$67,267.35 "
PayPal Fees,11/5/23,Deposit,2LT016854L959084U,04 PAYPAL GENERAL UNRESTR,PayPal fees,OFFICE/GENERAL ADMINISTRATIVE EXPENSES:PayPal Fees,PayPal Bank 3,$6.59 ,"$67,273.94 "
PayPal Bank 3,11/5/23,Deposit,6EU44732M2785030E,07 1000 DRONES RESTR,Subject: 1000DRONESTransaction ID: 6EU44732M2785030Ehttps://www.paypal.com/activity/payment/6EU44732M2785030E,PayPal Bank 3,--,$98.46 ,"$67,372.40 "
Donations directed by individuals,11/5/23,Deposit,6EU44732M2785030E,07 1000 DRONES RESTR,1000 DRONES FOR UKRAINE - 1000 DRONES FOR UKRAINE,Contributed income:Donations directed by individuals,PayPal Bank 3,$102.53 ,"$67,474.93 "
PayPal Fees,11/5/23,Deposit,6EU44732M2785030E,07 1000 DRONES RESTR,PayPal fees,OFFICE/GENERAL ADMINISTRATIVE EXPENSES:PayPal Fees,PayPal Bank 3,$4.07 ,"$67,479.00 "
PayPal Bank 3,11/5/23,Deposit,2CC666159C950690R,04 PAYPAL GENERAL UNRESTR,Subject: GeneralPageTransaction ID: 2CC666159C950690Rhttps://www.paypal.com/activity/payment/2CC666159C950690R,PayPal Bank 3,--,$9.84 ,"$67,488.84 "
Donations directed by individuals,11/5/23,Deposit,2CC666159C950690R,04 PAYPAL GENERAL UNRESTR,Support Ukraine - Support Ukraine,Contributed income:Donations directed by individuals,PayPal Bank 3,$10.70 ,"$67,499.54 "
PayPal Fees,11/5/23,Deposit,2CC666159C950690R,04 PAYPAL GENERAL UNRESTR,PayPal fees,OFFICE/GENERAL ADMINISTRATIVE EXPENSES:PayPal Fees,PayPal Bank 3,$0.86 ,"$67,500.40 "
PayPal Bank 3,11/5/23,Deposit,01J482401B636171F,04 PAYPAL GENERAL UNRESTR,Subject: Support UkraineTransaction ID: 01J482401B636171Fhttps://www.paypal.com/activity/payment/01J482401B636171F,PayPal Bank 3,--,$98.46 ,"$67,598.86 "
Donations directed by individuals,11/5/23,Deposit,01J482401B636171F,04 PAYPAL GENERAL UNRESTR,Money in to PayPal,Contributed income:Donations directed by individuals,PayPal Bank 3,$102.53 ,"$67,701.39 "
PayPal Fees,11/5/23,Deposit,01J482401B636171F,04 PAYPAL GENERAL UNRESTR,PayPal fees,OFFICE/GENERAL ADMINISTRATIVE EXPENSES:PayPal Fees,PayPal Bank 3,$4.07 ,"$67,705.46 "
PayPal Bank 3,11/5/23,Deposit,0RF43823UR961231Y,09 MSU RESTR,Subject: New 10 UnitsTransaction ID: 0RF43823UR961231Yhttps://www.paypal.com/activity/payment/0RF43823UR961231Y,PayPal Bank 3,--,$9.31 ,"$67,714.77 "
Donations directed by individuals,11/5/23,Deposit,0RF43823UR961231Y,09 MSU RESTR,donation-form,Contributed income:Donations directed by individuals,PayPal Bank 3,$10.00 ,"$67,724.77 "
PayPal Fees,11/5/23,Deposit,0RF43823UR961231Y,09 MSU RESTR,PayPal fees,OFFICE/GENERAL ADMINISTRATIVE EXPENSES:PayPal Fees,PayPal Bank 3,$0.69 ,"$67,725.46 "
PayPal Bank 3,11/5/23,Deposit,4RK44825YF203294X,04 PAYPAL GENERAL UNRESTR,Subject: GeneralPageTransaction ID: 4RK44825YF203294Xhttps://www.paypal.com/activity/payment/4RK44825YF203294X,PayPal Bank 3,--,$98.46 ,"$67,823.92 "
Donations directed by individuals,11/5/23,Deposit,4RK44825YF203294X,04 PAYPAL GENERAL UNRESTR,Support Ukraine - Support Ukraine,Contributed income:Donations directed by individuals,PayPal Bank 3,$102.53 ,"$67,926.45 "
PayPal Fees,11/5/23,Deposit,4RK44825YF203294X,04 PAYPAL GENERAL UNRESTR,PayPal fees,OFFICE/GENERAL ADMINISTRATIVE EXPENSES:PayPal Fees,PayPal Bank 3,$4.07 ,"$67,930.52 "
PayPal Bank 3,11/5/23,Deposit,8RD43581YN547854B,07 1000 DRONES RESTR,Subject: 1000DRONESTransaction ID: 8RD43581YN547854Bhttps://www.paypal.com/activity/payment/8RD43581YN547854B,PayPal Bank 3,--,$97.52 ,"$68,028.04 "
Donations directed by individuals,11/5/23,Deposit,8RD43581YN547854B,07 1000 DRONES RESTR,1000 DRONES FOR UKRAINE - 1000 DRONES FOR UKRAINE,Contributed income:Donations directed by individuals,PayPal Bank 3,$100.00 ,"$68,128.04 "
PayPal Fees,11/5/23,Deposit,8RD43581YN547854B,07 1000 DRONES RESTR,PayPal fees,OFFICE/GENERAL ADMINISTRATIVE EXPENSES:PayPal Fees,PayPal Bank 3,$2.48 ,"$68,130.52 "
PayPal Bank 3,11/5/23,Deposit,2AR2865650922993Y,04 PAYPAL GENERAL UNRESTR,Subject: Support UkraineTransaction ID: 2AR2865650922993Yhttps://www.paypal.com/activity/payment/2AR2865650922993Y,PayPal Bank 3,--,$29.81 ,"$68,160.33 "
Donations directed by individuals,11/5/23,Deposit,2AR2865650922993Y,04 PAYPAL GENERAL UNRESTR,Money in to PayPal,Contributed income:Donations directed by individuals,PayPal Bank 3,$31.40 ,"$68,191.73 "
PayPal Fees,11/5/23,Deposit,2AR2865650922993Y,04 PAYPAL GENERAL UNRESTR,PayPal fees,OFFICE/GENERAL ADMINISTRATIVE EXPENSES:PayPal Fees,PayPal Bank 3,$1.59 ,"$68,193.32 "
PayPal Bank 3,11/5/23,Deposit,25589971AV562435E,07 1000 DRONES RESTR,Subject: 1000DRONESTransaction ID: 25589971AV562435Ehttps://www.paypal.com/activity/payment/25589971AV562435E,PayPal Bank 3,--,$33.29 ,"$68,226.61 "
Donations directed by individuals,11/5/23,Deposit,25589971AV562435E,07 1000 DRONES RESTR,1000 DRONES FOR UKRAINE - 1000 DRONES FOR UKRAINE,Contributed income:Donations directed by individuals,PayPal Bank 3,$35.00 ,"$68,261.61 "
PayPal Fees,11/5/23,Deposit,25589971AV562435E,07 1000 DRONES RESTR,PayPal fees,OFFICE/GENERAL ADMINISTRATIVE EXPENSES:PayPal Fees,PayPal Bank 3,$1.71 ,"$68,263.32 "
PayPal Bank 3,11/5/23,Deposit,9N722833B7849450H,08 VICTORY DRONES RESTR,Subject: VICTORY DRONESTransaction ID: 9N722833B7849450Hhttps://www.paypal.com/activity/payment/9N722833B7849450H,PayPal Bank 3,--,$99.38 ,"$68,362.70 "
Donations directed by individuals,11/5/23,Deposit,9N722833B7849450H,08 VICTORY DRONES RESTR,Money in to PayPal,Contributed income:Donations directed by individuals,PayPal Bank 3,$103.48 ,"$68,466.18 "
PayPal Fees,11/5/23,Deposit,9N722833B7849450H,08 VICTORY DRONES RESTR,PayPal fees,OFFICE/GENERAL ADMINISTRATIVE EXPENSES:PayPal Fees,PayPal Bank 3,$4.10 ,"$68,470.28 "
PayPal Bank 3,11/5/23,Deposit,97P29807VV5375237,10 Flight to Recovery RESTR,Subject: Dignitas Ukraine Flight to RecoveryTransaction ID: 97P29807VV5375237https://www.paypal.com/activity/payment/97P29807VV5375237,PayPal Bank 3,--,$99.38 ,"$68,569.66 "
Donations directed by individuals,11/5/23,Deposit,97P29807VV5375237,10 Flight to Recovery RESTR,Money in to PayPal,Contributed income:Donations directed by individuals,PayPal Bank 3,$103.48 ,"$68,673.14 "
PayPal Fees,11/5/23,Deposit,97P29807VV5375237,10 Flight to Recovery RESTR,PayPal fees,OFFICE/GENERAL ADMINISTRATIVE EXPENSES:PayPal Fees,PayPal Bank 3,$4.10 ,"$68,677.24 "
PayPal Bank 3,11/5/23,Deposit,5LT23684R07683725,10 Flight to Recovery RESTR,Subject: Dignitas Ukraine Flight to RecoveryTransaction ID: 5LT23684R07683725https://www.paypal.com/activity/payment/5LT23684R07683725,PayPal Bank 3,--,$50.47 ,"$68,727.71 "
Donations directed by individuals,11/5/23,Deposit,5LT23684R07683725,10 Flight to Recovery RESTR,Money in to PayPal,Contributed income:Donations directed by individuals,PayPal Bank 3,$51.99 ,"$68,779.70 "
PayPal Fees,11/5/23,Deposit,5LT23684R07683725,10 Flight to Recovery RESTR,PayPal fees,OFFICE/GENERAL ADMINISTRATIVE EXPENSES:PayPal Fees,PayPal Bank 3,$1.52 ,"$68,781.22 "
PayPal Bank 3,11/5/23,Deposit,3EB92737WN208953A,07 1000 DRONES RESTR,Subject: 1000DRONESTransaction ID: 3EB92737WN208953Ahttps://www.paypal.com/activity/payment/3EB92737WN208953A,PayPal Bank 3,--,$50.00 ,"$68,831.22 "
Donations directed by individuals,11/5/23,Deposit,3EB92737WN208953A,07 1000 DRONES RESTR,1000 DRONES FOR UKRAINE - 1000 DRONES FOR UKRAINE,Contributed income:Donations directed by individuals,PayPal Bank 3,$51.52 ,"$68,882.74 "
PayPal Fees,11/5/23,Deposit,3EB92737WN208953A,07 1000 DRONES RESTR,PayPal fees,OFFICE/GENERAL ADMINISTRATIVE EXPENSES:PayPal Fees,PayPal Bank 3,$1.52 ,"$68,884.26 "
PayPal Bank 3,11/5/23,Deposit,88V228802K136161H,07 1000 DRONES RESTR,Subject: 1000DRONESTransaction ID: 88V228802K136161Hhttps://www.paypal.com/activity/payment/88V228802K136161H,PayPal Bank 3,--,$118.16 ,"$69,002.42 "
Donations directed by individuals,11/5/23,Deposit,88V228802K136161H,07 1000 DRONES RESTR,1000 DRONES FOR UKRAINE - 1000 DRONES FOR UKRAINE,Contributed income:Donations directed by individuals,PayPal Bank 3,$122.94 ,"$69,125.36 "
PayPal Fees,11/5/23,Deposit,88V228802K136161H,07 1000 DRONES RESTR,PayPal fees,OFFICE/GENERAL ADMINISTRATIVE EXPENSES:PayPal Fees,PayPal Bank 3,$4.78 ,"$69,130.14 "
PayPal Bank 3,11/5/23,Deposit,1PG864757L132402T,09 MSU RESTR,Subject: New 10 UnitsTransaction ID: 1PG864757L132402Thttps://www.paypal.com/activity/payment/1PG864757L132402T,PayPal Bank 3,--,$48.51 ,"$69,178.65 "
Donations directed by individuals,11/5/23,Deposit,1PG864757L132402T,09 MSU RESTR,donation-form,Contributed income:Donations directed by individuals,PayPal Bank 3,$50.00 ,"$69,228.65 "
PayPal Fees,11/5/23,Deposit,1PG864757L132402T,09 MSU RESTR,PayPal fees,OFFICE/GENERAL ADMINISTRATIVE EXPENSES:PayPal Fees,PayPal Bank 3,$1.49 ,"$69,230.14 "
PayPal Bank 3,11/5/23,Deposit,18T273452J963242H,04 PAYPAL GENERAL UNRESTR,Subject: GeneralPageTransaction ID: 18T273452J963242Hhttps://www.paypal.com/activity/payment/18T273452J963242H,PayPal Bank 3,--,$48.51 ,"$69,278.65 "
Donations directed by individuals,11/5/23,Deposit,18T273452J963242H,04 PAYPAL GENERAL UNRESTR,Support Ukraine - Support Ukraine,Contributed income:Donations directed by individuals,PayPal Bank 3,$50.00 ,"$69,328.65 "
PayPal Fees,11/5/23,Deposit,18T273452J963242H,04 PAYPAL GENERAL UNRESTR,PayPal fees,OFFICE/GENERAL ADMINISTRATIVE EXPENSES:PayPal Fees,PayPal Bank 3,$1.49 ,"$69,330.14 "
PayPal Bank 3,11/5/23,Deposit,9CC47767NC359583L,09 MSU RESTR,Subject: MobileShowersTransaction ID: 9CC47767NC359583Lhttps://www.paypal.com/activity/payment/9CC47767NC359583L,PayPal Bank 3,--,$96.49 ,"$69,426.63 "
Donations directed by individuals,11/5/23,Deposit,9CC47767NC359583L,09 MSU RESTR,Mobile Shower/Laundry Units - Mobile Shower/Laundry Units,Contributed income:Donations directed by individuals,PayPal Bank 3,$100.49 ,"$69,527.12 "
PayPal Fees,11/5/23,Deposit,9CC47767NC359583L,09 MSU RESTR,PayPal fees,OFFICE/GENERAL ADMINISTRATIVE EXPENSES:PayPal Fees,PayPal Bank 3,$4.00 ,"$69,531.12 "
PayPal Bank 3,11/5/23,Deposit,1SC80570W3523930K,07 1000 DRONES RESTR,Subject: 1000DRONESTransaction ID: 1SC80570W3523930Khttps://www.paypal.com/activity/payment/1SC80570W3523930K,PayPal Bank 3,--,$146.52 ,"$69,677.64 "
Donations directed by individuals,11/5/23,Deposit,1SC80570W3523930K,07 1000 DRONES RESTR,1000 DRONES FOR UKRAINE - 1000 DRONES FOR UKRAINE,Contributed income:Donations directed by individuals,PayPal Bank 3,$150.00 ,"$69,827.64 "
PayPal Fees,11/5/23,Deposit,1SC80570W3523930K,07 1000 DRONES RESTR,PayPal fees,OFFICE/GENERAL ADMINISTRATIVE EXPENSES:PayPal Fees,PayPal Bank 3,$3.48 ,"$69,831.12 "
PayPal Bank 3,11/5/23,Deposit,52485945VE245320N,07 1000 DRONES RESTR,Subject: 1000DRONESTransaction ID: 52485945VE245320Nhttps://www.paypal.com/activity/payment/52485945VE245320N,PayPal Bank 3,--,$393.87 ,"$70,224.99 "
Donations directed by individuals,11/5/23,Deposit,52485945VE245320N,07 1000 DRONES RESTR,1000 DRONES FOR UKRAINE - 1000 DRONES FOR UKRAINE,Contributed income:Donations directed by individuals,PayPal Bank 3,$408.62 ,"$70,633.61 "
PayPal Fees,11/5/23,Deposit,52485945VE245320N,07 1000 DRONES RESTR,PayPal fees,OFFICE/GENERAL ADMINISTRATIVE EXPENSES:PayPal Fees,PayPal Bank 3,$14.75 ,"$70,648.36 "
PayPal Bank 3,11/5/23,Deposit,0XM19224N83721744,09 MSU RESTR,Subject: MobileShowersNote: Keep up the great work.   Ukraine will win this war!!!!!!!!!!!!Transaction ID: 0XM19224N83721744https://www.paypal.com/activity/payment/0XM19224N83721744,PayPal Bank 3,--,$200.00 ,"$70,848.36 "
Donations directed by individuals,11/5/23,Deposit,0XM19224N83721744,09 MSU RESTR,Mobile Shower/Laundry Units - Mobile Shower/Laundry Units,Contributed income:Donations directed by individuals,PayPal Bank 3,$204.56 ,"$71,052.92 "
PayPal Fees,11/5/23,Deposit,0XM19224N83721744,09 MSU RESTR,PayPal fees,OFFICE/GENERAL ADMINISTRATIVE EXPENSES:PayPal Fees,PayPal Bank 3,$4.56 ,"$71,057.48 "
PayPal Bank 3,11/5/23,Deposit,45V540329Y2977325,07 1000 DRONES RESTR,Subject: 1000DRONESTransaction ID: 45V540329Y2977325https://www.paypal.com/activity/payment/45V540329Y2977325,PayPal Bank 3,--,$97.52 ,"$71,155.00 "
Donations directed by individuals,11/5/23,Deposit,45V540329Y2977325,07 1000 DRONES RESTR,1000 DRONES FOR UKRAINE - 1000 DRONES FOR UKRAINE,Contributed income:Donations directed by individuals,PayPal Bank 3,$100.00 ,"$71,255.00 "
PayPal Fees,11/5/23,Deposit,45V540329Y2977325,07 1000 DRONES RESTR,PayPal fees,OFFICE/GENERAL ADMINISTRATIVE EXPENSES:PayPal Fees,PayPal Bank 3,$2.48 ,"$71,257.48 "
PayPal Bank 3,11/5/23,Deposit,53E435826W121344M,07 1000 DRONES RESTR,Subject: 1000DRONESTransaction ID: 53E435826W121344Mhttps://www.paypal.com/activity/payment/53E435826W121344M,PayPal Bank 3,--,$14.76 ,"$71,272.24 "
Donations directed by individuals,11/5/23,Deposit,53E435826W121344M,07 1000 DRONES RESTR,1000 DRONES FOR UKRAINE - 1000 DRONES FOR UKRAINE,Contributed income:Donations directed by individuals,PayPal Bank 3,$15.80 ,"$71,288.04 "
PayPal Fees,11/5/23,Deposit,53E435826W121344M,07 1000 DRONES RESTR,PayPal fees,OFFICE/GENERAL ADMINISTRATIVE EXPENSES:PayPal Fees,PayPal Bank 3,$1.04 ,"$71,289.08 "
PayPal Bank 3,11/5/23,Deposit,9A98266633457280M,09 MSU RESTR,Subject: New 10 UnitsTransaction ID: 9A98266633457280Mhttps://www.paypal.com/activity/payment/9A98266633457280M,PayPal Bank 3,--,$13.99 ,"$71,303.07 "
Donations directed by individuals,11/5/23,Deposit,9A98266633457280M,09 MSU RESTR,donation-form,Contributed income:Donations directed by individuals,PayPal Bank 3,$15.00 ,"$71,318.07 "
PayPal Fees,11/5/23,Deposit,9A98266633457280M,09 MSU RESTR,PayPal fees,OFFICE/GENERAL ADMINISTRATIVE EXPENSES:PayPal Fees,PayPal Bank 3,$1.01 ,"$71,319.08 "
PayPal Bank 3,11/5/23,Deposit,32A7740179613930U,04 PAYPAL GENERAL UNRESTR,Subject: GeneralPageTransaction ID: 32A7740179613930Uhttps://www.paypal.com/activity/payment/32A7740179613930U,PayPal Bank 3,--,$9.84 ,"$71,328.92 "
Donations directed by individuals,11/5/23,Deposit,32A7740179613930U,04 PAYPAL GENERAL UNRESTR,Support Ukraine - Support Ukraine,Contributed income:Donations directed by individuals,PayPal Bank 3,$10.70 ,"$71,339.62 "
PayPal Fees,11/5/23,Deposit,32A7740179613930U,04 PAYPAL GENERAL UNRESTR,PayPal fees,OFFICE/GENERAL ADMINISTRATIVE EXPENSES:PayPal Fees,PayPal Bank 3,$0.86 ,"$71,340.48 "
PayPal Bank 3,11/5/23,Deposit,66Y794376F7357127,09 MSU RESTR,Subject: New 10 UnitsTransaction ID: 66Y794376F7357127https://www.paypal.com/activity/payment/66Y794376F7357127,PayPal Bank 3,--,$489.56 ,"$71,830.04 "
Donations directed by individuals,11/5/23,Deposit,66Y794376F7357127,09 MSU RESTR,donation-form,Contributed income:Donations directed by individuals,PayPal Bank 3,$500.00 ,"$72,330.04 "
PayPal Fees,11/5/23,Deposit,66Y794376F7357127,09 MSU RESTR,PayPal fees,OFFICE/GENERAL ADMINISTRATIVE EXPENSES:PayPal Fees,PayPal Bank 3,$10.44 ,"$72,340.48 "
PayPal Bank 3,11/5/23,Deposit,40U541568N532984S,07 1000 DRONES RESTR,Subject: 1000DRONESTransaction ID: 40U541568N532984Shttps://www.paypal.com/activity/payment/40U541568N532984S,PayPal Bank 3,--,$14.76 ,"$72,355.24 "
Donations directed by individuals,11/5/23,Deposit,40U541568N532984S,07 1000 DRONES RESTR,1000 DRONES FOR UKRAINE - 1000 DRONES FOR UKRAINE,Contributed income:Donations directed by individuals,PayPal Bank 3,$15.80 ,"$72,371.04 "
PayPal Fees,11/5/23,Deposit,40U541568N532984S,07 1000 DRONES RESTR,PayPal fees,OFFICE/GENERAL ADMINISTRATIVE EXPENSES:PayPal Fees,PayPal Bank 3,$1.04 ,"$72,372.08 "
PayPal Bank 3,11/5/23,Deposit,593837728H206982C,07 1000 DRONES RESTR,Subject: 1000DRONESTransaction ID: 593837728H206982Chttps://www.paypal.com/activity/payment/593837728H206982C,PayPal Bank 3,--,$97.52 ,"$72,469.60 "
Donations directed by individuals,11/5/23,Deposit,593837728H206982C,07 1000 DRONES RESTR,1000 DRONES FOR UKRAINE - 1000 DRONES FOR UKRAINE,Contributed income:Donations directed by individuals,PayPal Bank 3,$100.00 ,"$72,569.60 "
PayPal Fees,11/5/23,Deposit,593837728H206982C,07 1000 DRONES RESTR,PayPal fees,OFFICE/GENERAL ADMINISTRATIVE EXPENSES:PayPal Fees,PayPal Bank 3,$2.48 ,"$72,572.08 "
PayPal Bank 3,11/3/23,Deposit,31329143V1351235M,04 PAYPAL GENERAL UNRESTR,Subject: GeneralPageNote: Go UkraineTransaction ID: 31329143V1351235Mhttps://www.paypal.com/activity/payment/31329143V1351235M,PayPal Bank 3,--,$18.81 ,"$72,590.89 "
Donations directed by individuals,11/3/23,Deposit,31329143V1351235M,04 PAYPAL GENERAL UNRESTR,Support Ukraine - Support Ukraine,Contributed income:Donations directed by individuals,PayPal Bank 3,$20.00 ,"$72,610.89 "
PayPal Fees,11/3/23,Deposit,31329143V1351235M,04 PAYPAL GENERAL UNRESTR,PayPal fees,OFFICE/GENERAL ADMINISTRATIVE EXPENSES:PayPal Fees,PayPal Bank 3,$1.19 ,"$72,612.08 "
PayPal Bank 3,11/3/23,Deposit,67W50184PR851213W,04 PAYPAL GENERAL UNRESTR,Subject: GeneralPageTransaction ID: 67W50184PR851213Whttps://www.paypal.com/activity/payment/67W50184PR851213W,PayPal Bank 3,--,$50.00 ,"$72,662.08 "
Donations directed by individuals,11/3/23,Deposit,67W50184PR851213W,04 PAYPAL GENERAL UNRESTR,Support Ukraine - Support Ukraine,Contributed income:Donations directed by individuals,PayPal Bank 3,$51.52 ,"$72,713.60 "
PayPal Fees,11/3/23,Deposit,67W50184PR851213W,04 PAYPAL GENERAL UNRESTR,PayPal fees,OFFICE/GENERAL ADMINISTRATIVE EXPENSES:PayPal Fees,PayPal Bank 3,$1.52 ,"$72,715.12 "
PayPal Bank 3,11/3/23,Deposit,7KL77716B7303870X,08 VICTORY DRONES RESTR,Subject: VictoryDronesTransaction ID: 7KL77716B7303870Xhttps://www.paypal.com/activity/payment/7KL77716B7303870X,PayPal Bank 3,--,$98.46 ,"$72,813.58 "
Donations directed by individuals,11/3/23,Deposit,7KL77716B7303870X,08 VICTORY DRONES RESTR,VICTORY DRONES - VICTORY DRONES,Contributed income:Donations directed by individuals,PayPal Bank 3,$102.53 ,"$72,916.11 "
PayPal Fees,11/3/23,Deposit,7KL77716B7303870X,08 VICTORY DRONES RESTR,PayPal fees,OFFICE/GENERAL ADMINISTRATIVE EXPENSES:PayPal Fees,PayPal Bank 3,$4.07 ,"$72,920.18 "
PayPal Bank 3,11/3/23,Deposit,9NE468945J383160S,04 PAYPAL GENERAL UNRESTR,Subject: GeneralPageTransaction ID: 9NE468945J383160Shttps://www.paypal.com/activity/payment/9NE468945J383160S,PayPal Bank 3,--,$984.68 ,"$73,904.86 "
Donations directed by individuals,11/3/23,Deposit,9NE468945J383160S,04 PAYPAL GENERAL UNRESTR,Support Ukraine - Support Ukraine,Contributed income:Donations directed by individuals,PayPal Bank 3,"$1,020.80 ","$74,925.66 "
PayPal Fees,11/3/23,Deposit,9NE468945J383160S,04 PAYPAL GENERAL UNRESTR,PayPal fees,OFFICE/GENERAL ADMINISTRATIVE EXPENSES:PayPal Fees,PayPal Bank 3,$36.12 ,"$74,961.78 "
PayPal Bank 3,11/3/23,Deposit,0NB58438XM008824P,04 PAYPAL GENERAL UNRESTR,Subject: Support UkraineTransaction ID: 0NB58438XM008824Phttps://www.paypal.com/activity/payment/0NB58438XM008824P,PayPal Bank 3,--,$195.53 ,"$75,157.31 "
Donations directed by individuals,11/3/23,Deposit,0NB58438XM008824P,04 PAYPAL GENERAL UNRESTR,Money in to PayPal,Contributed income:Donations directed by individuals,PayPal Bank 3,$200.00 ,"$75,357.31 "
PayPal Fees,11/3/23,Deposit,0NB58438XM008824P,04 PAYPAL GENERAL UNRESTR,PayPal fees,OFFICE/GENERAL ADMINISTRATIVE EXPENSES:PayPal Fees,PayPal Bank 3,$4.47 ,"$75,361.78 "
PayPal Bank 3,11/2/23,Deposit,7TB34639Y8051010X,04 PAYPAL GENERAL UNRESTR,Subject: GeneralPageTransaction ID: 7TB34639Y8051010Xhttps://www.paypal.com/activity/payment/7TB34639Y8051010X,PayPal Bank 3,--,$979.61 ,"$76,341.39 "
Donations directed by individuals,11/2/23,Deposit,7TB34639Y8051010X,04 PAYPAL GENERAL UNRESTR,Support Ukraine - Support Ukraine,Contributed income:Donations directed by individuals,PayPal Bank 3,"$1,000.00 ","$77,341.39 "
PayPal Fees,11/2/23,Deposit,7TB34639Y8051010X,04 PAYPAL GENERAL UNRESTR,PayPal fees,OFFICE/GENERAL ADMINISTRATIVE EXPENSES:PayPal Fees,PayPal Bank 3,$20.39 ,"$77,361.78 "
PayPal Bank 3,11/2/23,Deposit,13G78199BR5571225,04 PAYPAL GENERAL UNRESTR,Subject: Support UkraineTransaction ID: 13G78199BR5571225https://www.paypal.com/activity/payment/13G78199BR5571225,PayPal Bank 3,--,$25.24 ,"$77,387.02 "
Donations directed by individuals,11/2/23,Deposit,13G78199BR5571225,04 PAYPAL GENERAL UNRESTR,Money in to PayPal,Contributed income:Donations directed by individuals,PayPal Bank 3,$26.25 ,"$77,413.27 "
PayPal Fees,11/2/23,Deposit,13G78199BR5571225,04 PAYPAL GENERAL UNRESTR,PayPal fees,OFFICE/GENERAL ADMINISTRATIVE EXPENSES:PayPal Fees,PayPal Bank 3,$1.01 ,"$77,414.28 "
PayPal Bank 3,11/2/23,Deposit,1L6016670J8910054,04 PAYPAL GENERAL UNRESTR,Subject: GeneralPageTransaction ID: 1L6016670J8910054https://www.paypal.com/activity/payment/1L6016670J8910054,PayPal Bank 3,--,$100.00 ,"$77,514.28 "
Donations directed by individuals,11/2/23,Deposit,1L6016670J8910054,04 PAYPAL GENERAL UNRESTR,Support Ukraine - Support Ukraine,Contributed income:Donations directed by individuals,PayPal Bank 3,$102.53 ,"$77,616.81 "
PayPal Fees,11/2/23,Deposit,1L6016670J8910054,04 PAYPAL GENERAL UNRESTR,PayPal fees,OFFICE/GENERAL ADMINISTRATIVE EXPENSES:PayPal Fees,PayPal Bank 3,$2.53 ,"$77,619.34 "
PayPal Bank 3,11/2/23,Deposit,76W645309G683473U,04 PAYPAL GENERAL UNRESTR,Subject: GeneralPageTransaction ID: 76W645309G683473Uhttps://www.paypal.com/activity/payment/76W645309G683473U,PayPal Bank 3,--,$47.76 ,"$77,667.10 "
Donations directed by individuals,11/2/23,Deposit,76W645309G683473U,04 PAYPAL GENERAL UNRESTR,Support Ukraine - Support Ukraine,Contributed income:Donations directed by individuals,PayPal Bank 3,$50.00 ,"$77,717.10 "
PayPal Fees,11/2/23,Deposit,76W645309G683473U,04 PAYPAL GENERAL UNRESTR,PayPal fees,OFFICE/GENERAL ADMINISTRATIVE EXPENSES:PayPal Fees,PayPal Bank 3,$2.24 ,"$77,719.34 "
PayPal Bank 3,11/2/23,Deposit,6FD973956K689600H,04 PAYPAL GENERAL UNRESTR,Subject: Support UkraineTransaction ID: 6FD973956K689600Hhttps://www.paypal.com/activity/payment/6FD973956K689600H,PayPal Bank 3,--,$69.00 ,"$77,788.34 "
Donations directed by individuals,11/2/23,Deposit,6FD973956K689600H,04 PAYPAL GENERAL UNRESTR,Money in to PayPal,Contributed income:Donations directed by individuals,PayPal Bank 3,$72.00 ,"$77,860.34 "
PayPal Fees,11/2/23,Deposit,6FD973956K689600H,04 PAYPAL GENERAL UNRESTR,PayPal fees,OFFICE/GENERAL ADMINISTRATIVE EXPENSES:PayPal Fees,PayPal Bank 3,$3.00 ,"$77,863.34 "
PayPal Bank 3,11/2/23,Deposit,11K48568GE477421V,04 PAYPAL GENERAL UNRESTR,Subject: GeneralPageTransaction ID: 11K48568GE477421Vhttps://www.paypal.com/activity/payment/11K48568GE477421V,PayPal Bank 3,--,$100.00 ,"$77,963.34 "
Donations directed by individuals,11/2/23,Deposit,11K48568GE477421V,04 PAYPAL GENERAL UNRESTR,Support Ukraine - Support Ukraine,Contributed income:Donations directed by individuals,PayPal Bank 3,$102.53 ,"$78,065.87 "
PayPal Fees,11/2/23,Deposit,11K48568GE477421V,04 PAYPAL GENERAL UNRESTR,PayPal fees,OFFICE/GENERAL ADMINISTRATIVE EXPENSES:PayPal Fees,PayPal Bank 3,$2.53 ,"$78,068.40 "
PayPal Bank 3,11/2/23,Deposit,63R46588H0486211W,04 PAYPAL GENERAL UNRESTR,Subject: GeneralPageNote: Щоб їбашити руснюTransaction ID: 63R46588H0486211Whttps://www.paypal.com/activity/payment/63R46588H0486211W,PayPal Bank 3,--,$49.23 ,"$78,117.63 "
Donations directed by individuals,11/2/23,Deposit,63R46588H0486211W,04 PAYPAL GENERAL UNRESTR,Support Ukraine - Support Ukraine,Contributed income:Donations directed by individuals,PayPal Bank 3,$51.52 ,"$78,169.15 "
PayPal Fees,11/2/23,Deposit,63R46588H0486211W,04 PAYPAL GENERAL UNRESTR,PayPal fees,OFFICE/GENERAL ADMINISTRATIVE EXPENSES:PayPal Fees,PayPal Bank 3,$2.29 ,"$78,171.44 "
PayPal Bank 3,11/2/23,Deposit,535595476U611613C,04 PAYPAL GENERAL UNRESTR,Subject: GeneralPageTransaction ID: 535595476U611613Chttps://www.paypal.com/activity/payment/535595476U611613C,PayPal Bank 3,--,$28.46 ,"$78,199.90 "
Donations directed by individuals,11/2/23,Deposit,535595476U611613C,04 PAYPAL GENERAL UNRESTR,Support Ukraine - Support Ukraine,Contributed income:Donations directed by individuals,PayPal Bank 3,$30.00 ,"$78,229.90 "
PayPal Fees,11/2/23,Deposit,535595476U611613C,04 PAYPAL GENERAL UNRESTR,PayPal fees,OFFICE/GENERAL ADMINISTRATIVE EXPENSES:PayPal Fees,PayPal Bank 3,$1.54 ,"$78,231.44 "
PayPal Bank 3,11/2/23,Deposit,5FG038106W132400N,07 1000 DRONES RESTR,Subject: 1000DRONESTransaction ID: 5FG038106W132400Nhttps://www.paypal.com/activity/payment/5FG038106W132400N,PayPal Bank 3,--,$31.85 ,"$78,263.29 "
Donations directed by individuals,11/2/23,Deposit,5FG038106W132400N,07 1000 DRONES RESTR,1000 DRONES FOR UKRAINE - 1000 DRONES FOR UKRAINE,Contributed income:Donations directed by individuals,PayPal Bank 3,$33.00 ,"$78,296.29 "
PayPal Fees,11/2/23,Deposit,5FG038106W132400N,07 1000 DRONES RESTR,PayPal fees,OFFICE/GENERAL ADMINISTRATIVE EXPENSES:PayPal Fees,PayPal Bank 3,$1.15 ,"$78,297.44 "
PayPal Bank 3,11/2/23,Deposit,29P22347EK084674M,07 1000 DRONES RESTR,Subject: 1000DRONESTransaction ID: 29P22347EK084674Mhttps://www.paypal.com/activity/payment/29P22347EK084674M,PayPal Bank 3,--,$200.00 ,"$78,497.44 "
Donations directed by individuals,11/2/23,Deposit,29P22347EK084674M,07 1000 DRONES RESTR,1000 DRONES FOR UKRAINE - 1000 DRONES FOR UKRAINE,Contributed income:Donations directed by individuals,PayPal Bank 3,$204.56 ,"$78,702.00 "
PayPal Fees,11/2/23,Deposit,29P22347EK084674M,07 1000 DRONES RESTR,PayPal fees,OFFICE/GENERAL ADMINISTRATIVE EXPENSES:PayPal Fees,PayPal Bank 3,$4.56 ,"$78,706.56 "
PayPal Bank 3,11/2/23,Deposit,2AT657827L627915D,07 1000 DRONES RESTR,Subject: 1000DRONESTransaction ID: 2AT657827L627915Dhttps://www.paypal.com/activity/payment/2AT657827L627915D,PayPal Bank 3,--,$196.93 ,"$78,903.49 "
Donations directed by individuals,11/2/23,Deposit,2AT657827L627915D,07 1000 DRONES RESTR,1000 DRONES FOR UKRAINE - 1000 DRONES FOR UKRAINE,Contributed income:Donations directed by individuals,PayPal Bank 3,$204.56 ,"$79,108.05 "
PayPal Fees,11/2/23,Deposit,2AT657827L627915D,07 1000 DRONES RESTR,PayPal fees,OFFICE/GENERAL ADMINISTRATIVE EXPENSES:PayPal Fees,PayPal Bank 3,$7.63 ,"$79,115.68 "
PayPal Bank 3,11/2/23,Deposit,1EH92644R24871441,07 1000 DRONES RESTR,Subject: 1000DRONESTransaction ID: 1EH92644R24871441https://www.paypal.com/activity/payment/1EH92644R24871441,PayPal Bank 3,--,$49.23 ,"$79,164.91 "
Donations directed by individuals,11/2/23,Deposit,1EH92644R24871441,07 1000 DRONES RESTR,1000 DRONES FOR UKRAINE - 1000 DRONES FOR UKRAINE,Contributed income:Donations directed by individuals,PayPal Bank 3,$51.52 ,"$79,216.43 "
PayPal Fees,11/2/23,Deposit,1EH92644R24871441,07 1000 DRONES RESTR,PayPal fees,OFFICE/GENERAL ADMINISTRATIVE EXPENSES:PayPal Fees,PayPal Bank 3,$2.29 ,"$79,218.72 "
PayPal Bank 3,11/2/23,Deposit,1Y767928E73575017,04 PAYPAL GENERAL UNRESTR,Subject: GeneralPageTransaction ID: 1Y767928E73575017https://www.paypal.com/activity/payment/1Y767928E73575017,PayPal Bank 3,--,$28.46 ,"$79,247.18 "
Donations directed by individuals,11/2/23,Deposit,1Y767928E73575017,04 PAYPAL GENERAL UNRESTR,Support Ukraine - Support Ukraine,Contributed income:Donations directed by individuals,PayPal Bank 3,$30.00 ,"$79,277.18 "
PayPal Fees,11/2/23,Deposit,1Y767928E73575017,04 PAYPAL GENERAL UNRESTR,PayPal fees,OFFICE/GENERAL ADMINISTRATIVE EXPENSES:PayPal Fees,PayPal Bank 3,$1.54 ,"$79,278.72 "
PayPal Bank 3,11/2/23,Deposit,7CY11024J6075894R,04 PAYPAL GENERAL UNRESTR,Note: Le soutien pour l'UkraineTransaction ID: 7CY11024J6075894Rhttps://www.paypal.com/activity/payment/7CY11024J6075894R,PayPal Bank 3,--,$96.20 ,"$79,374.92 "
Donations directed by individuals,11/2/23,Deposit,7CY11024J6075894R,04 PAYPAL GENERAL UNRESTR,Money in to PayPal,Contributed income:Donations directed by individuals,PayPal Bank 3,$100.19 ,"$79,475.11 "
PayPal Fees,11/2/23,Deposit,7CY11024J6075894R,04 PAYPAL GENERAL UNRESTR,PayPal fees,OFFICE/GENERAL ADMINISTRATIVE EXPENSES:PayPal Fees,PayPal Bank 3,$3.99 ,"$79,479.10 "
PayPal Bank 3,11/2/23,Deposit,5W8307794H413024X,04 PAYPAL GENERAL UNRESTR,Subject: Support UkraineTransaction ID: 5W8307794H413024Xhttps://www.paypal.com/activity/payment/5W8307794H413024X,PayPal Bank 3,--,$29.81 ,"$79,508.91 "
Donations directed by individuals,11/2/23,Deposit,5W8307794H413024X,04 PAYPAL GENERAL UNRESTR,Money in to PayPal,Contributed income:Donations directed by individuals,PayPal Bank 3,$31.40 ,"$79,540.31 "
PayPal Fees,11/2/23,Deposit,5W8307794H413024X,04 PAYPAL GENERAL UNRESTR,PayPal fees,OFFICE/GENERAL ADMINISTRATIVE EXPENSES:PayPal Fees,PayPal Bank 3,$1.59 ,"$79,541.90 "
PayPal Bank 3,11/2/23,Deposit,04R22566J0206603T,04 PAYPAL GENERAL UNRESTR,Subject: Support UkraineTransaction ID: 04R22566J0206603Thttps://www.paypal.com/activity/payment/04R22566J0206603T,PayPal Bank 3,--,$23.64 ,"$79,565.54 "
Donations directed by individuals,11/2/23,Deposit,04R22566J0206603T,04 PAYPAL GENERAL UNRESTR,Money in to PayPal,Contributed income:Donations directed by individuals,PayPal Bank 3,$25.00 ,"$79,590.54 "
PayPal Fees,11/2/23,Deposit,04R22566J0206603T,04 PAYPAL GENERAL UNRESTR,PayPal fees,OFFICE/GENERAL ADMINISTRATIVE EXPENSES:PayPal Fees,PayPal Bank 3,$1.36 ,"$79,591.90 "
PayPal Bank 3,11/2/23,Deposit,6BB825684H157352C,04 PAYPAL GENERAL UNRESTR,Subject: Support UkraineTransaction ID: 6BB825684H157352Chttps://www.paypal.com/activity/payment/6BB825684H157352C,PayPal Bank 3,--,$100.93 ,"$79,692.83 "
Donations directed by individuals,11/2/23,Deposit,6BB825684H157352C,04 PAYPAL GENERAL UNRESTR,Money in to PayPal,Contributed income:Donations directed by individuals,PayPal Bank 3,$103.48 ,"$79,796.31 "
PayPal Fees,11/2/23,Deposit,6BB825684H157352C,04 PAYPAL GENERAL UNRESTR,PayPal fees,OFFICE/GENERAL ADMINISTRATIVE EXPENSES:PayPal Fees,PayPal Bank 3,$2.55 ,"$79,798.86 "
PayPal Bank 3,11/2/23,Deposit,82W383273R430244F,04 PAYPAL GENERAL UNRESTR,Subject: Support UkraineTransaction ID: 82W383273R430244Fhttps://www.paypal.com/activity/payment/82W383273R430244F,PayPal Bank 3,--,$47.76 ,"$79,846.62 "
Donations directed by individuals,11/2/23,Deposit,82W383273R430244F,04 PAYPAL GENERAL UNRESTR,Money in to PayPal,Contributed income:Donations directed by individuals,PayPal Bank 3,$50.00 ,"$79,896.62 "
PayPal Fees,11/2/23,Deposit,82W383273R430244F,04 PAYPAL GENERAL UNRESTR,PayPal fees,OFFICE/GENERAL ADMINISTRATIVE EXPENSES:PayPal Fees,PayPal Bank 3,$2.24 ,"$79,898.86 "
PayPal Bank 3,11/2/23,Deposit,86L96832PD468583P,04 PAYPAL GENERAL UNRESTR,Subject: Support UkraineTransaction ID: 86L96832PD468583Phttps://www.paypal.com/activity/payment/86L96832PD468583P,PayPal Bank 3,--,$4.96 ,"$79,903.82 "
Donations directed by individuals,11/2/23,Deposit,86L96832PD468583P,04 PAYPAL GENERAL UNRESTR,Money in to PayPal,Contributed income:Donations directed by individuals,PayPal Bank 3,$5.65 ,"$79,909.47 "
PayPal Fees,11/2/23,Deposit,86L96832PD468583P,04 PAYPAL GENERAL UNRESTR,PayPal fees,OFFICE/GENERAL ADMINISTRATIVE EXPENSES:PayPal Fees,PayPal Bank 3,$0.69 ,"$79,910.16 "
PayPal Bank 3,11/2/23,Deposit,9NN250816N917460X,04 PAYPAL GENERAL UNRESTR,Subject: Support UkraineTransaction ID: 9NN250816N917460Xhttps://www.paypal.com/activity/payment/9NN250816N917460X,PayPal Bank 3,--,$18.81 ,"$79,928.97 "
Donations directed by individuals,11/2/23,Deposit,9NN250816N917460X,04 PAYPAL GENERAL UNRESTR,Money in to PayPal,Contributed income:Donations directed by individuals,PayPal Bank 3,$20.00 ,"$79,948.97 "
PayPal Fees,11/2/23,Deposit,9NN250816N917460X,04 PAYPAL GENERAL UNRESTR,PayPal fees,OFFICE/GENERAL ADMINISTRATIVE EXPENSES:PayPal Fees,PayPal Bank 3,$1.19 ,"$79,950.16 "
PayPal Bank 3,11/2/23,Deposit,0UN01230N9204791A,04 PAYPAL GENERAL UNRESTR,Subject: GeneralPageTransaction ID: 0UN01230N9204791Ahttps://www.paypal.com/activity/payment/0UN01230N9204791A,PayPal Bank 3,--,"$2,939.81 ","$82,889.97 "
Donations directed by individuals,11/2/23,Deposit,0UN01230N9204791A,04 PAYPAL GENERAL UNRESTR,Support Ukraine - Support Ukraine,Contributed income:Donations directed by individuals,PayPal Bank 3,"$3,000.00 ","$85,889.97 "
PayPal Fees,11/2/23,Deposit,0UN01230N9204791A,04 PAYPAL GENERAL UNRESTR,PayPal fees,OFFICE/GENERAL ADMINISTRATIVE EXPENSES:PayPal Fees,PayPal Bank 3,$60.19 ,"$85,950.16 "
PayPal Bank 3,11/2/23,Deposit,4W099560F3541363G,04 PAYPAL GENERAL UNRESTR,Subject: Support UkraineTransaction ID: 4W099560F3541363Ghttps://www.paypal.com/activity/payment/4W099560F3541363G,PayPal Bank 3,--,$50.47 ,"$86,000.63 "
Donations directed by individuals,11/2/23,Deposit,4W099560F3541363G,04 PAYPAL GENERAL UNRESTR,Money in to PayPal,Contributed income:Donations directed by individuals,PayPal Bank 3,$51.99 ,"$86,052.62 "
PayPal Fees,11/2/23,Deposit,4W099560F3541363G,04 PAYPAL GENERAL UNRESTR,PayPal fees,OFFICE/GENERAL ADMINISTRATIVE EXPENSES:PayPal Fees,PayPal Bank 3,$1.52 ,"$86,054.14 "
PayPal Bank 3,11/2/23,Deposit,9DX77341BW0842841,04 PAYPAL GENERAL UNRESTR,Subject: Support UkraineTransaction ID: 9DX77341BW0842841https://www.paypal.com/activity/payment/9DX77341BW0842841,PayPal Bank 3,--,$50.47 ,"$86,104.61 "
Donations directed by individuals,11/2/23,Deposit,9DX77341BW0842841,04 PAYPAL GENERAL UNRESTR,Money in to PayPal,Contributed income:Donations directed by individuals,PayPal Bank 3,$51.99 ,"$86,156.60 "
PayPal Fees,11/2/23,Deposit,9DX77341BW0842841,04 PAYPAL GENERAL UNRESTR,PayPal fees,OFFICE/GENERAL ADMINISTRATIVE EXPENSES:PayPal Fees,PayPal Bank 3,$1.52 ,"$86,158.12 "
PayPal Bank 3,11/2/23,Deposit,3W016561DL9041847,04 PAYPAL GENERAL UNRESTR,Subject: Support UkraineTransaction ID: 3W016561DL9041847https://www.paypal.com/activity/payment/3W016561DL9041847,PayPal Bank 3,--,$47.76 ,"$86,205.88 "
Donations directed by individuals,11/2/23,Deposit,3W016561DL9041847,04 PAYPAL GENERAL UNRESTR,Money in to PayPal,Contributed income:Donations directed by individuals,PayPal Bank 3,$50.00 ,"$86,255.88 "
PayPal Fees,11/2/23,Deposit,3W016561DL9041847,04 PAYPAL GENERAL UNRESTR,PayPal fees,OFFICE/GENERAL ADMINISTRATIVE EXPENSES:PayPal Fees,PayPal Bank 3,$2.24 ,"$86,258.12 "
PayPal Bank 3,11/2/23,Deposit,8B619661CM855522N,04 PAYPAL GENERAL UNRESTR,Subject: Support UkraineTransaction ID: 8B619661CM855522Nhttps://www.paypal.com/activity/payment/8B619661CM855522N,PayPal Bank 3,--,$25.24 ,"$86,283.36 "
Donations directed by individuals,11/2/23,Deposit,8B619661CM855522N,04 PAYPAL GENERAL UNRESTR,Money in to PayPal,Contributed income:Donations directed by individuals,PayPal Bank 3,$26.25 ,"$86,309.61 "
PayPal Fees,11/2/23,Deposit,8B619661CM855522N,04 PAYPAL GENERAL UNRESTR,PayPal fees,OFFICE/GENERAL ADMINISTRATIVE EXPENSES:PayPal Fees,PayPal Bank 3,$1.01 ,"$86,310.62 "
PayPal Bank 3,11/2/23,Deposit,59G86583R26797307,04 PAYPAL GENERAL UNRESTR,Subject: GeneralPageTransaction ID: 59G86583R26797307https://www.paypal.com/activity/payment/59G86583R26797307,PayPal Bank 3,--,$29.53 ,"$86,340.15 "
Donations directed by individuals,11/2/23,Deposit,59G86583R26797307,04 PAYPAL GENERAL UNRESTR,Support Ukraine - Support Ukraine,Contributed income:Donations directed by individuals,PayPal Bank 3,$31.11 ,"$86,371.26 "
PayPal Fees,11/2/23,Deposit,59G86583R26797307,04 PAYPAL GENERAL UNRESTR,PayPal fees,OFFICE/GENERAL ADMINISTRATIVE EXPENSES:PayPal Fees,PayPal Bank 3,$1.58 ,"$86,372.84 "
PayPal Bank 3,11/2/23,Deposit,54L40010JG777912M,07 1000 DRONES RESTR,Subject: GeneralPageNote: na drony!Transaction ID: 54L40010JG777912Mhttps://www.paypal.com/activity/payment/54L40010JG777912M,PayPal Bank 3,--,$50.00 ,"$86,422.84 "
Donations directed by individuals,11/2/23,Deposit,54L40010JG777912M,07 1000 DRONES RESTR,Support Ukraine - Support Ukraine,Contributed income:Donations directed by individuals,PayPal Bank 3,$51.52 ,"$86,474.36 "
PayPal Fees,11/2/23,Deposit,54L40010JG777912M,07 1000 DRONES RESTR,PayPal fees,OFFICE/GENERAL ADMINISTRATIVE EXPENSES:PayPal Fees,PayPal Bank 3,$1.52 ,"$86,475.88 "
PayPal Bank 3,11/2/23,Deposit,9EU69810C5360492T,04 PAYPAL GENERAL UNRESTR,Subject: GeneralPageTransaction ID: 9EU69810C5360492Thttps://www.paypal.com/activity/payment/9EU69810C5360492T,PayPal Bank 3,--,$50.00 ,"$86,525.88 "
Donations directed by individuals,11/2/23,Deposit,9EU69810C5360492T,04 PAYPAL GENERAL UNRESTR,Support Ukraine - Support Ukraine,Contributed income:Donations directed by individuals,PayPal Bank 3,$51.52 ,"$86,577.40 "
PayPal Fees,11/2/23,Deposit,9EU69810C5360492T,04 PAYPAL GENERAL UNRESTR,PayPal fees,OFFICE/GENERAL ADMINISTRATIVE EXPENSES:PayPal Fees,PayPal Bank 3,$1.52 ,"$86,578.92 "
PayPal Bank 3,11/2/23,Deposit,9YY73441YB023790R,04 PAYPAL GENERAL UNRESTR,Subject: GeneralPageTransaction ID: 9YY73441YB023790Rhttps://www.paypal.com/activity/payment/9YY73441YB023790R,PayPal Bank 3,--,$47.76 ,"$86,626.68 "
Donations directed by individuals,11/2/23,Deposit,9YY73441YB023790R,04 PAYPAL GENERAL UNRESTR,Support Ukraine - Support Ukraine,Contributed income:Donations directed by individuals,PayPal Bank 3,$50.00 ,"$86,676.68 "
PayPal Fees,11/2/23,Deposit,9YY73441YB023790R,04 PAYPAL GENERAL UNRESTR,PayPal fees,OFFICE/GENERAL ADMINISTRATIVE EXPENSES:PayPal Fees,PayPal Bank 3,$2.24 ,"$86,678.92 "
PayPal Bank 3,11/2/23,Deposit,3MH06201AA455492E,04 PAYPAL GENERAL UNRESTR,Subject: GeneralPageTransaction ID: 3MH06201AA455492Ehttps://www.paypal.com/activity/payment/3MH06201AA455492E,PayPal Bank 3,--,$9.16 ,"$86,688.08 "
Donations directed by individuals,11/2/23,Deposit,3MH06201AA455492E,04 PAYPAL GENERAL UNRESTR,Support Ukraine - Support Ukraine,Contributed income:Donations directed by individuals,PayPal Bank 3,$10.00 ,"$86,698.08 "
PayPal Fees,11/2/23,Deposit,3MH06201AA455492E,04 PAYPAL GENERAL UNRESTR,PayPal fees,OFFICE/GENERAL ADMINISTRATIVE EXPENSES:PayPal Fees,PayPal Bank 3,$0.84 ,"$86,698.92 "
PayPal Bank 3,11/2/23,Deposit,72Y31378VM764163U,04 PAYPAL GENERAL UNRESTR,Subject: GeneralPageTransaction ID: 72Y31378VM764163Uhttps://www.paypal.com/activity/payment/72Y31378VM764163U,PayPal Bank 3,--,$98.46 ,"$86,797.38 "
Donations directed by individuals,11/2/23,Deposit,72Y31378VM764163U,04 PAYPAL GENERAL UNRESTR,Support Ukraine - Support Ukraine,Contributed income:Donations directed by individuals,PayPal Bank 3,$102.53 ,"$86,899.91 "
PayPal Fees,11/2/23,Deposit,72Y31378VM764163U,04 PAYPAL GENERAL UNRESTR,PayPal fees,OFFICE/GENERAL ADMINISTRATIVE EXPENSES:PayPal Fees,PayPal Bank 3,$4.07 ,"$86,903.98 "
PayPal Bank 3,11/2/23,Deposit,41K55411DA818151B,04 PAYPAL GENERAL UNRESTR,Subject: GeneralPageNote: A la place d'un cadeau d'anniversaire.   Slava Ukraîni - Herojm slava!Transaction ID: 41K55411DA818151Bhttps://www.paypal.com/activity/payment/41K55411DA818151B,PayPal Bank 3,--,$207.76 ,"$87,111.74 "
Donations directed by individuals,11/2/23,Deposit,41K55411DA818151B,04 PAYPAL GENERAL UNRESTR,Support Ukraine - Support Ukraine,Contributed income:Donations directed by individuals,PayPal Bank 3,$215.78 ,"$87,327.52 "
PayPal Fees,11/2/23,Deposit,41K55411DA818151B,04 PAYPAL GENERAL UNRESTR,PayPal fees,OFFICE/GENERAL ADMINISTRATIVE EXPENSES:PayPal Fees,PayPal Bank 3,$8.02 ,"$87,335.54 "
PayPal Bank 3,11/2/23,Deposit,7LR697392X9348514,04 PAYPAL GENERAL UNRESTR,Subject: GeneralPageTransaction ID: 7LR697392X9348514https://www.paypal.com/activity/payment/7LR697392X9348514,PayPal Bank 3,--,$195.53 ,"$87,531.07 "
Donations directed by individuals,11/2/23,Deposit,7LR697392X9348514,04 PAYPAL GENERAL UNRESTR,Support Ukraine - Support Ukraine,Contributed income:Donations directed by individuals,PayPal Bank 3,$200.00 ,"$87,731.07 "
PayPal Fees,11/2/23,Deposit,7LR697392X9348514,04 PAYPAL GENERAL UNRESTR,PayPal fees,OFFICE/GENERAL ADMINISTRATIVE EXPENSES:PayPal Fees,PayPal Bank 3,$4.47 ,"$87,735.54 "
PayPal Bank 3,11/2/23,Deposit,1BD00464D28063439,04 PAYPAL GENERAL UNRESTR,Subject: GeneralPageNote: Дякую вам рідненькіTransaction ID: 1BD00464D28063439https://www.paypal.com/activity/payment/1BD00464D28063439,PayPal Bank 3,--,$24.61 ,"$87,760.15 "
Donations directed by individuals,11/2/23,Deposit,1BD00464D28063439,04 PAYPAL GENERAL UNRESTR,Support Ukraine - Support Ukraine,Contributed income:Donations directed by individuals,PayPal Bank 3,$26.01 ,"$87,786.16 "
PayPal Fees,11/2/23,Deposit,1BD00464D28063439,04 PAYPAL GENERAL UNRESTR,PayPal fees,OFFICE/GENERAL ADMINISTRATIVE EXPENSES:PayPal Fees,PayPal Bank 3,$1.40 ,"$87,787.56 "
PayPal Bank 3,11/2/23,Deposit,6AM99324L4134762W,07 1000 DRONES RESTR,Subject: 1000DRONESTransaction ID: 6AM99324L4134762Whttps://www.paypal.com/activity/payment/6AM99324L4134762W,PayPal Bank 3,--,$100.00 ,"$87,887.56 "
Donations directed by individuals,11/2/23,Deposit,6AM99324L4134762W,07 1000 DRONES RESTR,1000 DRONES FOR UKRAINE - 1000 DRONES FOR UKRAINE,Contributed income:Donations directed by individuals,PayPal Bank 3,$102.53 ,"$87,990.09 "
PayPal Fees,11/2/23,Deposit,6AM99324L4134762W,07 1000 DRONES RESTR,PayPal fees,OFFICE/GENERAL ADMINISTRATIVE EXPENSES:PayPal Fees,PayPal Bank 3,$2.53 ,"$87,992.62 "
PayPal Bank 3,11/2/23,Deposit,5VM72884G6296400U,04 PAYPAL GENERAL UNRESTR,Subject: GeneralPageTransaction ID: 5VM72884G6296400Uhttps://www.paypal.com/activity/payment/5VM72884G6296400U,PayPal Bank 3,--,$391.55 ,"$88,384.17 "
Donations directed by individuals,11/2/23,Deposit,5VM72884G6296400U,04 PAYPAL GENERAL UNRESTR,Support Ukraine - Support Ukraine,Contributed income:Donations directed by individuals,PayPal Bank 3,$400.00 ,"$88,784.17 "
PayPal Fees,11/2/23,Deposit,5VM72884G6296400U,04 PAYPAL GENERAL UNRESTR,PayPal fees,OFFICE/GENERAL ADMINISTRATIVE EXPENSES:PayPal Fees,PayPal Bank 3,$8.45 ,"$88,792.62 "
PayPal Bank 3,11/2/23,Deposit,8TF957513D036384H,10 Flight to Recovery RESTR,Subject: FlightToRecoveryTransaction ID: 8TF957513D036384Hhttps://www.paypal.com/activity/payment/8TF957513D036384H,PayPal Bank 3,--,$10.00 ,"$88,802.62 "
Donations directed by individuals,11/2/23,Deposit,8TF957513D036384H,10 Flight to Recovery RESTR,Flight to Recovery - Flight to Recovery,Contributed income:Donations directed by individuals,PayPal Bank 3,$10.70 ,"$88,813.32 "
PayPal Fees,11/2/23,Deposit,8TF957513D036384H,10 Flight to Recovery RESTR,PayPal fees,OFFICE/GENERAL ADMINISTRATIVE EXPENSES:PayPal Fees,PayPal Bank 3,$0.70 ,"$88,814.02 "
PayPal Bank 3,11/2/23,Deposit,5FL1289581131674L,04 PAYPAL GENERAL UNRESTR,Subject: Support UkraineTransaction ID: 5FL1289581131674Lhttps://www.paypal.com/activity/payment/5FL1289581131674L,PayPal Bank 3,--,$20.95 ,"$88,834.97 "
Donations directed by individuals,11/2/23,Deposit,5FL1289581131674L,04 PAYPAL GENERAL UNRESTR,Money in to PayPal,Contributed income:Donations directed by individuals,PayPal Bank 3,$22.22 ,"$88,857.19 "
PayPal Fees,11/2/23,Deposit,5FL1289581131674L,04 PAYPAL GENERAL UNRESTR,PayPal fees,OFFICE/GENERAL ADMINISTRATIVE EXPENSES:PayPal Fees,PayPal Bank 3,$1.27 ,"$88,858.46 "
PayPal Bank 3,11/2/23,Deposit,04S77503649846826,04 PAYPAL GENERAL UNRESTR,Subject: Support UkraineTransaction ID: 04S77503649846826https://www.paypal.com/activity/payment/04S77503649846826,PayPal Bank 3,--,$96.02 ,"$88,954.48 "
Donations directed by individuals,11/2/23,Deposit,04S77503649846826,04 PAYPAL GENERAL UNRESTR,Money in to PayPal,Contributed income:Donations directed by individuals,PayPal Bank 3,$100.00 ,"$89,054.48 "
PayPal Fees,11/2/23,Deposit,04S77503649846826,04 PAYPAL GENERAL UNRESTR,PayPal fees,OFFICE/GENERAL ADMINISTRATIVE EXPENSES:PayPal Fees,PayPal Bank 3,$3.98 ,"$89,058.46 "
PayPal Bank 3,11/2/23,Deposit,6EN16584H11935213,04 PAYPAL GENERAL UNRESTR,Subject: GeneralPageTransaction ID: 6EN16584H11935213https://www.paypal.com/activity/payment/6EN16584H11935213,PayPal Bank 3,--,$49.23 ,"$89,107.69 "
Donations directed by individuals,11/2/23,Deposit,6EN16584H11935213,04 PAYPAL GENERAL UNRESTR,Support Ukraine - Support Ukraine,Contributed income:Donations directed by individuals,PayPal Bank 3,$51.52 ,"$89,159.21 "
PayPal Fees,11/2/23,Deposit,6EN16584H11935213,04 PAYPAL GENERAL UNRESTR,PayPal fees,OFFICE/GENERAL ADMINISTRATIVE EXPENSES:PayPal Fees,PayPal Bank 3,$2.29 ,"$89,161.50 "
PayPal Bank 3,11/2/23,Deposit,34N22848125695619,04 PAYPAL GENERAL UNRESTR,Subject: Support UkraineTransaction ID: 34N22848125695619https://www.paypal.com/activity/payment/34N22848125695619,PayPal Bank 3,--,$99.38 ,"$89,260.88 "
Donations directed by individuals,11/2/23,Deposit,34N22848125695619,04 PAYPAL GENERAL UNRESTR,Money in to PayPal,Contributed income:Donations directed by individuals,PayPal Bank 3,$103.48 ,"$89,364.36 "
PayPal Fees,11/2/23,Deposit,34N22848125695619,04 PAYPAL GENERAL UNRESTR,PayPal fees,OFFICE/GENERAL ADMINISTRATIVE EXPENSES:PayPal Fees,PayPal Bank 3,$4.10 ,"$89,368.46 "
PayPal Bank 3,11/2/23,Deposit,5UW14341CU3450645,04 PAYPAL GENERAL UNRESTR,Subject: GeneralPageTransaction ID: 5UW14341CU3450645https://www.paypal.com/activity/payment/5UW14341CU3450645,PayPal Bank 3,--,$18.81 ,"$89,387.27 "
Donations directed by individuals,11/2/23,Deposit,5UW14341CU3450645,04 PAYPAL GENERAL UNRESTR,Support Ukraine - Support Ukraine,Contributed income:Donations directed by individuals,PayPal Bank 3,$20.00 ,"$89,407.27 "
PayPal Fees,11/2/23,Deposit,5UW14341CU3450645,04 PAYPAL GENERAL UNRESTR,PayPal fees,OFFICE/GENERAL ADMINISTRATIVE EXPENSES:PayPal Fees,PayPal Bank 3,$1.19 ,"$89,408.46 "
PayPal Bank 3,11/2/23,Deposit,5BG9426871632820K,08 VICTORY DRONES RESTR,Subject: VICTORY DRONESTransaction ID: 5BG9426871632820Khttps://www.paypal.com/activity/payment/5BG9426871632820K,PayPal Bank 3,--,$2.97 ,"$89,411.43 "
Donations directed by individuals,11/2/23,Deposit,5BG9426871632820K,08 VICTORY DRONES RESTR,Money in to PayPal,Contributed income:Donations directed by individuals,PayPal Bank 3,$3.59 ,"$89,415.02 "
PayPal Fees,11/2/23,Deposit,5BG9426871632820K,08 VICTORY DRONES RESTR,PayPal fees,OFFICE/GENERAL ADMINISTRATIVE EXPENSES:PayPal Fees,PayPal Bank 3,$0.62 ,"$89,415.64 "
PayPal Bank 3,11/2/23,Deposit,7F526915F3033662C,04 PAYPAL GENERAL UNRESTR,Subject: GeneralPageTransaction ID: 7F526915F3033662Chttps://www.paypal.com/activity/payment/7F526915F3033662C,PayPal Bank 3,--,$17.72 ,"$89,433.36 "
Donations directed by individuals,11/2/23,Deposit,7F526915F3033662C,04 PAYPAL GENERAL UNRESTR,Support Ukraine - Support Ukraine,Contributed income:Donations directed by individuals,PayPal Bank 3,$18.87 ,"$89,452.23 "
PayPal Fees,11/2/23,Deposit,7F526915F3033662C,04 PAYPAL GENERAL UNRESTR,PayPal fees,OFFICE/GENERAL ADMINISTRATIVE EXPENSES:PayPal Fees,PayPal Bank 3,$1.15 ,"$89,453.38 "
PayPal Bank 3,11/2/23,Deposit,5HT77327J2234344F,04 PAYPAL GENERAL UNRESTR,Subject: Support UkraineTransaction ID: 5HT77327J2234344Fhttps://www.paypal.com/activity/payment/5HT77327J2234344F,PayPal Bank 3,--,$14.90 ,"$89,468.28 "
Donations directed by individuals,11/2/23,Deposit,5HT77327J2234344F,04 PAYPAL GENERAL UNRESTR,Money in to PayPal,Contributed income:Donations directed by individuals,PayPal Bank 3,$15.95 ,"$89,484.23 "
PayPal Fees,11/2/23,Deposit,5HT77327J2234344F,04 PAYPAL GENERAL UNRESTR,PayPal fees,OFFICE/GENERAL ADMINISTRATIVE EXPENSES:PayPal Fees,PayPal Bank 3,$1.05 ,"$89,485.28 "
PayPal Bank 3,11/2/23,Deposit,13P331347A817623E,07 1000 DRONES RESTR,Subject: GeneralPageNote: Slava Ukraini! We are with you until victory! Please use this money for the drone program.Transaction ID: 13P331347A817623Ehttps://www.paypal.com/activity/payment/13P331347A817623E,PayPal Bank 3,--,$100.00 ,"$89,585.28 "
Donations directed by individuals,11/2/23,Deposit,13P331347A817623E,07 1000 DRONES RESTR,Support Ukraine - Support Ukraine,Contributed income:Donations directed by individuals,PayPal Bank 3,$102.53 ,"$89,687.81 "
PayPal Fees,11/2/23,Deposit,13P331347A817623E,07 1000 DRONES RESTR,PayPal fees,OFFICE/GENERAL ADMINISTRATIVE EXPENSES:PayPal Fees,PayPal Bank 3,$2.53 ,"$89,690.34 "
PayPal Bank 3,11/2/23,Deposit,83U181313P913514C,07 1000 DRONES RESTR,Subject: 1000DRONESTransaction ID: 83U181313P913514Chttps://www.paypal.com/activity/payment/83U181313P913514C,PayPal Bank 3,--,$295.40 ,"$89,985.74 "
Donations directed by individuals,11/2/23,Deposit,83U181313P913514C,07 1000 DRONES RESTR,1000 DRONES FOR UKRAINE - 1000 DRONES FOR UKRAINE,Contributed income:Donations directed by individuals,PayPal Bank 3,$306.59 ,"$90,292.33 "
PayPal Fees,11/2/23,Deposit,83U181313P913514C,07 1000 DRONES RESTR,PayPal fees,OFFICE/GENERAL ADMINISTRATIVE EXPENSES:PayPal Fees,PayPal Bank 3,$11.19 ,"$90,303.52 "
PayPal Bank 3,11/2/23,Deposit,27E10633WY216840D,07 1000 DRONES RESTR,Subject: GeneralPageNote: For dronesTransaction ID: 27E10633WY216840Dhttps://www.paypal.com/activity/payment/27E10633WY216840D,PayPal Bank 3,--,$97.52 ,"$90,401.04 "
Donations directed by individuals,11/2/23,Deposit,27E10633WY216840D,07 1000 DRONES RESTR,Support Ukraine - Support Ukraine,Contributed income:Donations directed by individuals,PayPal Bank 3,$100.00 ,"$90,501.04 "
PayPal Fees,11/2/23,Deposit,27E10633WY216840D,07 1000 DRONES RESTR,PayPal fees,OFFICE/GENERAL ADMINISTRATIVE EXPENSES:PayPal Fees,PayPal Bank 3,$2.48 ,"$90,503.52 "
PayPal Bank 3,11/2/23,Deposit,3F3014658M436335G,04 PAYPAL GENERAL UNRESTR,Subject: GeneralPageTransaction ID: 3F3014658M436335Ghttps://www.paypal.com/activity/payment/3F3014658M436335G,PayPal Bank 3,--,$24.01 ,"$90,527.53 "
Donations directed by individuals,11/2/23,Deposit,3F3014658M436335G,04 PAYPAL GENERAL UNRESTR,Support Ukraine - Support Ukraine,Contributed income:Donations directed by individuals,PayPal Bank 3,$25.00 ,"$90,552.53 "
PayPal Fees,11/2/23,Deposit,3F3014658M436335G,04 PAYPAL GENERAL UNRESTR,PayPal fees,OFFICE/GENERAL ADMINISTRATIVE EXPENSES:PayPal Fees,PayPal Bank 3,$0.99 ,"$90,553.52 "
PayPal Bank 3,11/2/23,Deposit,83M777545L734752K,04 PAYPAL GENERAL UNRESTR,Subject: GeneralPageTransaction ID: 83M777545L734752Khttps://www.paypal.com/activity/payment/83M777545L734752K,PayPal Bank 3,--,$38.11 ,"$90,591.63 "
Donations directed by individuals,11/2/23,Deposit,83M777545L734752K,04 PAYPAL GENERAL UNRESTR,Support Ukraine - Support Ukraine,Contributed income:Donations directed by individuals,PayPal Bank 3,$40.00 ,"$90,631.63 "
PayPal Fees,11/2/23,Deposit,83M777545L734752K,04 PAYPAL GENERAL UNRESTR,PayPal fees,OFFICE/GENERAL ADMINISTRATIVE EXPENSES:PayPal Fees,PayPal Bank 3,$1.89 ,"$90,633.52 "
PayPal Bank 3,11/2/23,Deposit,1SA58753YS304094S,04 PAYPAL GENERAL UNRESTR,Subject: GeneralPageTransaction ID: 1SA58753YS304094Shttps://www.paypal.com/activity/payment/1SA58753YS304094S,PayPal Bank 3,--,$50.00 ,"$90,683.52 "
Donations directed by individuals,11/2/23,Deposit,1SA58753YS304094S,04 PAYPAL GENERAL UNRESTR,Support Ukraine - Support Ukraine,Contributed income:Donations directed by individuals,PayPal Bank 3,$51.52 ,"$90,735.04 "
PayPal Fees,11/2/23,Deposit,1SA58753YS304094S,04 PAYPAL GENERAL UNRESTR,PayPal fees,OFFICE/GENERAL ADMINISTRATIVE EXPENSES:PayPal Fees,PayPal Bank 3,$1.52 ,"$90,736.56 "
PayPal Bank 3,11/2/23,Deposit,0XE44745SH120300R,07 1000 DRONES RESTR,Subject: 1000DRONESTransaction ID: 0XE44745SH120300Rhttps://www.paypal.com/activity/payment/0XE44745SH120300R,PayPal Bank 3,--,$157.55 ,"$90,894.11 "
Donations directed by individuals,11/2/23,Deposit,0XE44745SH120300R,07 1000 DRONES RESTR,1000 DRONES FOR UKRAINE - 1000 DRONES FOR UKRAINE,Contributed income:Donations directed by individuals,PayPal Bank 3,$163.75 ,"$91,057.86 "
PayPal Fees,11/2/23,Deposit,0XE44745SH120300R,07 1000 DRONES RESTR,PayPal fees,OFFICE/GENERAL ADMINISTRATIVE EXPENSES:PayPal Fees,PayPal Bank 3,$6.20 ,"$91,064.06 "
PayPal Bank 3,11/2/23,Deposit,3M341799T8834504Y,07 1000 DRONES RESTR,Subject: 1000 DRONES FOR UKRAINETransaction ID: 3M341799T8834504Yhttps://www.paypal.com/activity/payment/3M341799T8834504Y,PayPal Bank 3,--,$18.81 ,"$91,082.87 "
Donations directed by individuals,11/2/23,Deposit,3M341799T8834504Y,07 1000 DRONES RESTR,Money in to PayPal,Contributed income:Donations directed by individuals,PayPal Bank 3,$20.00 ,"$91,102.87 "
PayPal Fees,11/2/23,Deposit,3M341799T8834504Y,07 1000 DRONES RESTR,PayPal fees,OFFICE/GENERAL ADMINISTRATIVE EXPENSES:PayPal Fees,PayPal Bank 3,$1.19 ,"$91,104.06 "
PayPal Bank 3,11/2/23,Deposit,1HA8496047804583P,04 PAYPAL GENERAL UNRESTR,Subject: GeneralPageTransaction ID: 1HA8496047804583Phttps://www.paypal.com/activity/payment/1HA8496047804583P,PayPal Bank 3,--,$18.81 ,"$91,122.87 "
Donations directed by individuals,11/2/23,Deposit,1HA8496047804583P,04 PAYPAL GENERAL UNRESTR,Support Ukraine - Support Ukraine,Contributed income:Donations directed by individuals,PayPal Bank 3,$20.00 ,"$91,142.87 "
PayPal Fees,11/2/23,Deposit,1HA8496047804583P,04 PAYPAL GENERAL UNRESTR,PayPal fees,OFFICE/GENERAL ADMINISTRATIVE EXPENSES:PayPal Fees,PayPal Bank 3,$1.19 ,"$91,144.06 "
PayPal Bank 3,11/2/23,Deposit,3YH05274LC609050K,04 PAYPAL GENERAL UNRESTR,Subject: GeneralPageTransaction ID: 3YH05274LC609050Khttps://www.paypal.com/activity/payment/3YH05274LC609050K,PayPal Bank 3,--,$38.50 ,"$91,182.56 "
Donations directed by individuals,11/2/23,Deposit,3YH05274LC609050K,04 PAYPAL GENERAL UNRESTR,Support Ukraine - Support Ukraine,Contributed income:Donations directed by individuals,PayPal Bank 3,$40.40 ,"$91,222.96 "
PayPal Fees,11/2/23,Deposit,3YH05274LC609050K,04 PAYPAL GENERAL UNRESTR,PayPal fees,OFFICE/GENERAL ADMINISTRATIVE EXPENSES:PayPal Fees,PayPal Bank 3,$1.90 ,"$91,224.86 "
PayPal Bank 3,11/2/23,Deposit,5SS893741J441774L,04 PAYPAL GENERAL UNRESTR,Subject: Support UkraineTransaction ID: 5SS893741J441774Lhttps://www.paypal.com/activity/payment/5SS893741J441774L,PayPal Bank 3,--,$47.70 ,"$91,272.56 "
Donations directed by individuals,11/2/23,Deposit,5SS893741J441774L,04 PAYPAL GENERAL UNRESTR,Money in to PayPal,Contributed income:Donations directed by individuals,PayPal Bank 3,$49.93 ,"$91,322.49 "
PayPal Fees,11/2/23,Deposit,5SS893741J441774L,04 PAYPAL GENERAL UNRESTR,PayPal fees,OFFICE/GENERAL ADMINISTRATIVE EXPENSES:PayPal Fees,PayPal Bank 3,$2.23 ,"$91,324.72 "
PayPal Bank 3,11/2/23,Deposit,7SD790536E6467917,04 PAYPAL GENERAL UNRESTR,Subject: GeneralPageTransaction ID: 7SD790536E6467917https://www.paypal.com/activity/payment/7SD790536E6467917,PayPal Bank 3,--,$636.57 ,"$91,961.29 "
Donations directed by individuals,11/2/23,Deposit,7SD790536E6467917,04 PAYPAL GENERAL UNRESTR,Support Ukraine - Support Ukraine,Contributed income:Donations directed by individuals,PayPal Bank 3,$650.00 ,"$92,611.29 "
PayPal Fees,11/2/23,Deposit,7SD790536E6467917,04 PAYPAL GENERAL UNRESTR,PayPal fees,OFFICE/GENERAL ADMINISTRATIVE EXPENSES:PayPal Fees,PayPal Bank 3,$13.43 ,"$92,624.72 "
PayPal Bank 3,11/2/23,Deposit,06845088KR850060K,04 PAYPAL GENERAL UNRESTR,Subject: Support UkraineTransaction ID: 06845088KR850060Khttps://www.paypal.com/activity/payment/06845088KR850060K,PayPal Bank 3,--,$19.87 ,"$92,644.59 "
Donations directed by individuals,11/2/23,Deposit,06845088KR850060K,04 PAYPAL GENERAL UNRESTR,Money in to PayPal,Contributed income:Donations directed by individuals,PayPal Bank 3,$21.10 ,"$92,665.69 "
PayPal Fees,11/2/23,Deposit,06845088KR850060K,04 PAYPAL GENERAL UNRESTR,PayPal fees,OFFICE/GENERAL ADMINISTRATIVE EXPENSES:PayPal Fees,PayPal Bank 3,$1.23 ,"$92,666.92 "
PayPal Bank 3,11/2/23,Deposit,4KL71461TP2691905,04 PAYPAL GENERAL UNRESTR,Subject: Support UkraineTransaction ID: 4KL71461TP2691905https://www.paypal.com/activity/payment/4KL71461TP2691905,PayPal Bank 3,--,$9.93 ,"$92,676.85 "
Donations directed by individuals,11/2/23,Deposit,4KL71461TP2691905,04 PAYPAL GENERAL UNRESTR,Money in to PayPal,Contributed income:Donations directed by individuals,PayPal Bank 3,$10.80 ,"$92,687.65 "
PayPal Fees,11/2/23,Deposit,4KL71461TP2691905,04 PAYPAL GENERAL UNRESTR,PayPal fees,OFFICE/GENERAL ADMINISTRATIVE EXPENSES:PayPal Fees,PayPal Bank 3,$0.87 ,"$92,688.52 "
PayPal Bank 3,11/2/23,Deposit,8D209453K5199041L,04 PAYPAL GENERAL UNRESTR,Subject: GeneralPageTransaction ID: 8D209453K5199041Lhttps://www.paypal.com/activity/payment/8D209453K5199041L,PayPal Bank 3,--,$49.23 ,"$92,737.75 "
Donations directed by individuals,11/2/23,Deposit,8D209453K5199041L,04 PAYPAL GENERAL UNRESTR,Support Ukraine - Support Ukraine,Contributed income:Donations directed by individuals,PayPal Bank 3,$51.52 ,"$92,789.27 "
PayPal Fees,11/2/23,Deposit,8D209453K5199041L,04 PAYPAL GENERAL UNRESTR,PayPal fees,OFFICE/GENERAL ADMINISTRATIVE EXPENSES:PayPal Fees,PayPal Bank 3,$2.29 ,"$92,791.56 "
PayPal Bank 3,11/2/23,Deposit,32644378AB678960N,04 PAYPAL GENERAL UNRESTR,Subject: GeneralPageTransaction ID: 32644378AB678960Nhttps://www.paypal.com/activity/payment/32644378AB678960N,PayPal Bank 3,--,$34.46 ,"$92,826.02 "
Donations directed by individuals,11/2/23,Deposit,32644378AB678960N,04 PAYPAL GENERAL UNRESTR,Support Ukraine - Support Ukraine,Contributed income:Donations directed by individuals,PayPal Bank 3,$36.21 ,"$92,862.23 "
PayPal Fees,11/2/23,Deposit,32644378AB678960N,04 PAYPAL GENERAL UNRESTR,PayPal fees,OFFICE/GENERAL ADMINISTRATIVE EXPENSES:PayPal Fees,PayPal Bank 3,$1.75 ,"$92,863.98 "
PayPal Bank 3,11/2/23,Deposit,8AG38644B10040449,04 PAYPAL GENERAL UNRESTR,Subject: Support UkraineTransaction ID: 8AG38644B10040449https://www.paypal.com/activity/payment/8AG38644B10040449,PayPal Bank 3,--,$9.16 ,"$92,873.14 "
Donations directed by individuals,11/2/23,Deposit,8AG38644B10040449,04 PAYPAL GENERAL UNRESTR,Money in to PayPal,Contributed income:Donations directed by individuals,PayPal Bank 3,$10.00 ,"$92,883.14 "
PayPal Fees,11/2/23,Deposit,8AG38644B10040449,04 PAYPAL GENERAL UNRESTR,PayPal fees,OFFICE/GENERAL ADMINISTRATIVE EXPENSES:PayPal Fees,PayPal Bank 3,$0.84 ,"$92,883.98 "
PayPal Bank 3,11/2/23,Deposit,3KS98685AV5365022,04 PAYPAL GENERAL UNRESTR,Subject: Support UkraineTransaction ID: 3KS98685AV5365022https://www.paypal.com/activity/payment/3KS98685AV5365022,PayPal Bank 3,--,$9.16 ,"$92,893.14 "
Donations directed by individuals,11/2/23,Deposit,3KS98685AV5365022,04 PAYPAL GENERAL UNRESTR,Money in to PayPal,Contributed income:Donations directed by individuals,PayPal Bank 3,$10.00 ,"$92,903.14 "
PayPal Fees,11/2/23,Deposit,3KS98685AV5365022,04 PAYPAL GENERAL UNRESTR,PayPal fees,OFFICE/GENERAL ADMINISTRATIVE EXPENSES:PayPal Fees,PayPal Bank 3,$0.84 ,"$92,903.98 "
PayPal Bank 3,11/2/23,Deposit,9LA26910HG593401C,04 PAYPAL GENERAL UNRESTR,Subject: Support UkraineTransaction ID: 9LA26910HG593401Chttps://www.paypal.com/activity/payment/9LA26910HG593401C,PayPal Bank 3,--,$70.08 ,"$92,974.06 "
Donations directed by individuals,11/2/23,Deposit,9LA26910HG593401C,04 PAYPAL GENERAL UNRESTR,Money in to PayPal,Contributed income:Donations directed by individuals,PayPal Bank 3,$72.00 ,"$93,046.06 "
PayPal Fees,11/2/23,Deposit,9LA26910HG593401C,04 PAYPAL GENERAL UNRESTR,PayPal fees,OFFICE/GENERAL ADMINISTRATIVE EXPENSES:PayPal Fees,PayPal Bank 3,$1.92 ,"$93,047.98 "
PayPal Bank 3,11/2/23,Deposit,6C998884V1573704R,04 PAYPAL GENERAL UNRESTR,Subject: GeneralPageTransaction ID: 6C998884V1573704Rhttps://www.paypal.com/activity/payment/6C998884V1573704R,PayPal Bank 3,--,$100.00 ,"$93,147.98 "
Donations directed by individuals,11/2/23,Deposit,6C998884V1573704R,04 PAYPAL GENERAL UNRESTR,Support Ukraine - Support Ukraine,Contributed income:Donations directed by individuals,PayPal Bank 3,$102.53 ,"$93,250.51 "
PayPal Fees,11/2/23,Deposit,6C998884V1573704R,04 PAYPAL GENERAL UNRESTR,PayPal fees,OFFICE/GENERAL ADMINISTRATIVE EXPENSES:PayPal Fees,PayPal Bank 3,$2.53 ,"$93,253.04 "
PayPal Bank 3,11/2/23,Deposit,98D410012M504045G,04 PAYPAL GENERAL UNRESTR,Subject: GeneralPageTransaction ID: 98D410012M504045Ghttps://www.paypal.com/activity/payment/98D410012M504045G,PayPal Bank 3,--,$97.52 ,"$93,350.56 "
Donations directed by individuals,11/2/23,Deposit,98D410012M504045G,04 PAYPAL GENERAL UNRESTR,Support Ukraine - Support Ukraine,Contributed income:Donations directed by individuals,PayPal Bank 3,$100.00 ,"$93,450.56 "
PayPal Fees,11/2/23,Deposit,98D410012M504045G,04 PAYPAL GENERAL UNRESTR,PayPal fees,OFFICE/GENERAL ADMINISTRATIVE EXPENSES:PayPal Fees,PayPal Bank 3,$2.48 ,"$93,453.04 "
PayPal Bank 3,11/2/23,Deposit,3JV59504J14669436,04 PAYPAL GENERAL UNRESTR,Subject: Support UkraineTransaction ID: 3JV59504J14669436https://www.paypal.com/activity/payment/3JV59504J14669436,PayPal Bank 3,--,$23.63 ,"$93,476.67 "
Donations directed by individuals,11/2/23,Deposit,3JV59504J14669436,04 PAYPAL GENERAL UNRESTR,Money in to PayPal,Contributed income:Donations directed by individuals,PayPal Bank 3,$24.99 ,"$93,501.66 "
PayPal Fees,11/2/23,Deposit,3JV59504J14669436,04 PAYPAL GENERAL UNRESTR,PayPal fees,OFFICE/GENERAL ADMINISTRATIVE EXPENSES:PayPal Fees,PayPal Bank 3,$1.36 ,"$93,503.02 "
PayPal Bank 3,11/2/23,Deposit,46S78770H8359904B,04 PAYPAL GENERAL UNRESTR,Subject: Support UkraineTransaction ID: 46S78770H8359904Bhttps://www.paypal.com/activity/payment/46S78770H8359904B,PayPal Bank 3,--,$50.47 ,"$93,553.49 "
Donations directed by individuals,11/2/23,Deposit,46S78770H8359904B,04 PAYPAL GENERAL UNRESTR,Money in to PayPal,Contributed income:Donations directed by individuals,PayPal Bank 3,$51.99 ,"$93,605.48 "
PayPal Fees,11/2/23,Deposit,46S78770H8359904B,04 PAYPAL GENERAL UNRESTR,PayPal fees,OFFICE/GENERAL ADMINISTRATIVE EXPENSES:PayPal Fees,PayPal Bank 3,$1.52 ,"$93,607.00 "
PayPal Bank 3,11/2/23,Deposit,7S091274T51450322,04 PAYPAL GENERAL UNRESTR,Subject: GeneralPageTransaction ID: 7S091274T51450322https://www.paypal.com/activity/payment/7S091274T51450322,PayPal Bank 3,--,$28.46 ,"$93,635.46 "
Donations directed by individuals,11/2/23,Deposit,7S091274T51450322,04 PAYPAL GENERAL UNRESTR,Support Ukraine - Support Ukraine,Contributed income:Donations directed by individuals,PayPal Bank 3,$30.00 ,"$93,665.46 "
PayPal Fees,11/2/23,Deposit,7S091274T51450322,04 PAYPAL GENERAL UNRESTR,PayPal fees,OFFICE/GENERAL ADMINISTRATIVE EXPENSES:PayPal Fees,PayPal Bank 3,$1.54 ,"$93,667.00 "
PayPal Bank 3,11/2/23,Deposit,7K531671X7800044G,04 PAYPAL GENERAL UNRESTR,Subject: Support UkraineTransaction ID: 7K531671X7800044Ghttps://www.paypal.com/activity/payment/7K531671X7800044G,PayPal Bank 3,--,$24.84 ,"$93,691.84 "
Donations directed by individuals,11/2/23,Deposit,7K531671X7800044G,04 PAYPAL GENERAL UNRESTR,Money in to PayPal,Contributed income:Donations directed by individuals,PayPal Bank 3,$26.25 ,"$93,718.09 "
PayPal Fees,11/2/23,Deposit,7K531671X7800044G,04 PAYPAL GENERAL UNRESTR,PayPal fees,OFFICE/GENERAL ADMINISTRATIVE EXPENSES:PayPal Fees,PayPal Bank 3,$1.41 ,"$93,719.50 "
PayPal Bank 3,11/2/23,Deposit,0HS31560MU411664D,04 PAYPAL GENERAL UNRESTR,Subject: GeneralPageTransaction ID: 0HS31560MU411664Dhttps://www.paypal.com/activity/payment/0HS31560MU411664D,PayPal Bank 3,--,$295.40 ,"$94,014.90 "
Donations directed by individuals,11/2/23,Deposit,0HS31560MU411664D,04 PAYPAL GENERAL UNRESTR,Support Ukraine - Support Ukraine,Contributed income:Donations directed by individuals,PayPal Bank 3,$306.59 ,"$94,321.49 "
PayPal Fees,11/2/23,Deposit,0HS31560MU411664D,04 PAYPAL GENERAL UNRESTR,PayPal fees,OFFICE/GENERAL ADMINISTRATIVE EXPENSES:PayPal Fees,PayPal Bank 3,$11.19 ,"$94,332.68 "
PayPal Bank 3,11/2/23,Deposit,8RX38575U7779404T,07 1000 DRONES RESTR,Subject: 1000DRONESTransaction ID: 8RX38575U7779404Thttps://www.paypal.com/activity/payment/8RX38575U7779404T,PayPal Bank 3,--,$96.02 ,"$94,428.70 "
Donations directed by individuals,11/2/23,Deposit,8RX38575U7779404T,07 1000 DRONES RESTR,1000 DRONES FOR UKRAINE - 1000 DRONES FOR UKRAINE,Contributed income:Donations directed by individuals,PayPal Bank 3,$100.00 ,"$94,528.70 "
PayPal Fees,11/2/23,Deposit,8RX38575U7779404T,07 1000 DRONES RESTR,PayPal fees,OFFICE/GENERAL ADMINISTRATIVE EXPENSES:PayPal Fees,PayPal Bank 3,$3.98 ,"$94,532.68 "
PayPal Bank 3,11/2/23,Deposit,75B56241149645710,04 PAYPAL GENERAL UNRESTR,Subject: Support UkraineTransaction ID: 75B56241149645710https://www.paypal.com/activity/payment/75B56241149645710,PayPal Bank 3,--,$19.87 ,"$94,552.55 "
Donations directed by individuals,11/2/23,Deposit,75B56241149645710,04 PAYPAL GENERAL UNRESTR,Money in to PayPal,Contributed income:Donations directed by individuals,PayPal Bank 3,$21.10 ,"$94,573.65 "
PayPal Fees,11/2/23,Deposit,75B56241149645710,04 PAYPAL GENERAL UNRESTR,PayPal fees,OFFICE/GENERAL ADMINISTRATIVE EXPENSES:PayPal Fees,PayPal Bank 3,$1.23 ,"$94,574.88 "
PayPal Bank 3,11/2/23,Deposit,1YS81098026772949,07 1000 DRONES RESTR,Subject: 1000DRONESNote: PersevereTransaction ID: 1YS81098026772949https://www.paypal.com/activity/payment/1YS81098026772949,PayPal Bank 3,--,$196.93 ,"$94,771.81 "
Donations directed by individuals,11/2/23,Deposit,1YS81098026772949,07 1000 DRONES RESTR,1000 DRONES FOR UKRAINE - 1000 DRONES FOR UKRAINE,Contributed income:Donations directed by individuals,PayPal Bank 3,$204.56 ,"$94,976.37 "
PayPal Fees,11/2/23,Deposit,1YS81098026772949,07 1000 DRONES RESTR,PayPal fees,OFFICE/GENERAL ADMINISTRATIVE EXPENSES:PayPal Fees,PayPal Bank 3,$7.63 ,"$94,984.00 "
PayPal Bank 3,11/2/23,Deposit,11405178AS827380H,04 PAYPAL GENERAL UNRESTR,Subject: GeneralPageTransaction ID: 11405178AS827380Hhttps://www.paypal.com/activity/payment/11405178AS827380H,PayPal Bank 3,--,$100.00 ,"$95,084.00 "
Donations directed by individuals,11/2/23,Deposit,11405178AS827380H,04 PAYPAL GENERAL UNRESTR,Support Ukraine - Support Ukraine,Contributed income:Donations directed by individuals,PayPal Bank 3,$102.53 ,"$95,186.53 "
PayPal Fees,11/2/23,Deposit,11405178AS827380H,04 PAYPAL GENERAL UNRESTR,PayPal fees,OFFICE/GENERAL ADMINISTRATIVE EXPENSES:PayPal Fees,PayPal Bank 3,$2.53 ,"$95,189.06 "
PayPal Bank 3,11/2/23,Deposit,9R0615312F741005G,07 1000 DRONES RESTR,Subject: 1000DRONESTransaction ID: 9R0615312F741005Ghttps://www.paypal.com/activity/payment/9R0615312F741005G,PayPal Bank 3,--,$100.00 ,"$95,289.06 "
Donations directed by individuals,11/2/23,Deposit,9R0615312F741005G,07 1000 DRONES RESTR,1000 DRONES FOR UKRAINE - 1000 DRONES FOR UKRAINE,Contributed income:Donations directed by individuals,PayPal Bank 3,$102.53 ,"$95,391.59 "
PayPal Fees,11/2/23,Deposit,9R0615312F741005G,07 1000 DRONES RESTR,PayPal fees,OFFICE/GENERAL ADMINISTRATIVE EXPENSES:PayPal Fees,PayPal Bank 3,$2.53 ,"$95,394.12 "
PayPal Bank 3,11/2/23,Deposit,84A42456N2972372U,04 PAYPAL GENERAL UNRESTR,Subject: Support UkraineTransaction ID: 84A42456N2972372Uhttps://www.paypal.com/activity/payment/84A42456N2972372U,PayPal Bank 3,--,$147.70 ,"$95,541.82 "
Donations directed by individuals,11/2/23,Deposit,84A42456N2972372U,04 PAYPAL GENERAL UNRESTR,Money in to PayPal,Contributed income:Donations directed by individuals,PayPal Bank 3,$153.55 ,"$95,695.37 "
PayPal Fees,11/2/23,Deposit,84A42456N2972372U,04 PAYPAL GENERAL UNRESTR,PayPal fees,OFFICE/GENERAL ADMINISTRATIVE EXPENSES:PayPal Fees,PayPal Bank 3,$5.85 ,"$95,701.22 "
PayPal Bank 3,11/2/23,Deposit,36253296VC918110Y,08 VICTORY DRONES RESTR,Subject: VICTORY DRONESTransaction ID: 36253296VC918110Yhttps://www.paypal.com/activity/payment/36253296VC918110Y,PayPal Bank 3,--,$2.97 ,"$95,704.19 "
Donations directed by individuals,11/2/23,Deposit,36253296VC918110Y,08 VICTORY DRONES RESTR,Money in to PayPal,Contributed income:Donations directed by individuals,PayPal Bank 3,$3.59 ,"$95,707.78 "
PayPal Fees,11/2/23,Deposit,36253296VC918110Y,08 VICTORY DRONES RESTR,PayPal fees,OFFICE/GENERAL ADMINISTRATIVE EXPENSES:PayPal Fees,PayPal Bank 3,$0.62 ,"$95,708.40 "
PayPal Bank 3,11/2/23,Deposit,9C394123XV8991240,04 PAYPAL GENERAL UNRESTR,Subject: GeneralPageTransaction ID: 9C394123XV8991240https://www.paypal.com/activity/payment/9C394123XV8991240,PayPal Bank 3,--,$49.23 ,"$95,757.63 "
Donations directed by individuals,11/2/23,Deposit,9C394123XV8991240,04 PAYPAL GENERAL UNRESTR,Support Ukraine - Support Ukraine,Contributed income:Donations directed by individuals,PayPal Bank 3,$51.52 ,"$95,809.15 "
PayPal Fees,11/2/23,Deposit,9C394123XV8991240,04 PAYPAL GENERAL UNRESTR,PayPal fees,OFFICE/GENERAL ADMINISTRATIVE EXPENSES:PayPal Fees,PayPal Bank 3,$2.29 ,"$95,811.44 "
PayPal Bank 3,11/2/23,Deposit,6W747868VH4692535,08 VICTORY DRONES RESTR,Subject: VictoryDronesTransaction ID: 6W747868VH4692535https://www.paypal.com/activity/payment/6W747868VH4692535,PayPal Bank 3,--,$19.69 ,"$95,831.13 "
Donations directed by individuals,11/2/23,Deposit,6W747868VH4692535,08 VICTORY DRONES RESTR,VICTORY DRONES - VICTORY DRONES,Contributed income:Donations directed by individuals,PayPal Bank 3,$20.91 ,"$95,852.04 "
PayPal Fees,11/2/23,Deposit,6W747868VH4692535,08 VICTORY DRONES RESTR,PayPal fees,OFFICE/GENERAL ADMINISTRATIVE EXPENSES:PayPal Fees,PayPal Bank 3,$1.22 ,"$95,853.26 "
PayPal Bank 3,11/2/23,Deposit,5R3705296L531130Y,04 PAYPAL GENERAL UNRESTR,Subject: Support UkraineTransaction ID: 5R3705296L531130Yhttps://www.paypal.com/activity/payment/5R3705296L531130Y,PayPal Bank 3,--,$298.14 ,"$96,151.40 "
Donations directed by individuals,11/2/23,Deposit,5R3705296L531130Y,04 PAYPAL GENERAL UNRESTR,Money in to PayPal,Contributed income:Donations directed by individuals,PayPal Bank 3,$309.43 ,"$96,460.83 "
PayPal Fees,11/2/23,Deposit,5R3705296L531130Y,04 PAYPAL GENERAL UNRESTR,PayPal fees,OFFICE/GENERAL ADMINISTRATIVE EXPENSES:PayPal Fees,PayPal Bank 3,$11.29 ,"$96,472.12 "
PayPal Bank 3,11/2/23,Deposit,99L85929UL764450D,04 PAYPAL GENERAL UNRESTR,Subject: GeneralPageTransaction ID: 99L85929UL764450Dhttps://www.paypal.com/activity/payment/99L85929UL764450D,PayPal Bank 3,--,$19.69 ,"$96,491.81 "
Donations directed by individuals,11/2/23,Deposit,99L85929UL764450D,04 PAYPAL GENERAL UNRESTR,Support Ukraine - Support Ukraine,Contributed income:Donations directed by individuals,PayPal Bank 3,$20.91 ,"$96,512.72 "
PayPal Fees,11/2/23,Deposit,99L85929UL764450D,04 PAYPAL GENERAL UNRESTR,PayPal fees,OFFICE/GENERAL ADMINISTRATIVE EXPENSES:PayPal Fees,PayPal Bank 3,$1.22 ,"$96,513.94 "
PayPal Bank 3,11/2/23,Deposit,22626981UK710471X,10 Flight to Recovery RESTR,Subject: Flight to RecoveryTransaction ID: 22626981UK710471Xhttps://www.paypal.com/activity/payment/22626981UK710471X,PayPal Bank 3,--,$50.00 ,"$96,563.94 "
Donations directed by individuals,11/2/23,Deposit,22626981UK710471X,10 Flight to Recovery RESTR,Money in to PayPal,Contributed income:Donations directed by individuals,PayPal Bank 3,$51.52 ,"$96,615.46 "
PayPal Fees,11/2/23,Deposit,22626981UK710471X,10 Flight to Recovery RESTR,PayPal fees,OFFICE/GENERAL ADMINISTRATIVE EXPENSES:PayPal Fees,PayPal Bank 3,$1.52 ,"$96,616.98 "
PayPal Bank 3,11/2/23,Deposit,7NW50380PC3874337,04 PAYPAL GENERAL UNRESTR,Subject: GeneralPageTransaction ID: 7NW50380PC3874337https://www.paypal.com/activity/payment/7NW50380PC3874337,PayPal Bank 3,--,$47.76 ,"$96,664.74 "
Donations directed by individuals,11/2/23,Deposit,7NW50380PC3874337,04 PAYPAL GENERAL UNRESTR,Support Ukraine - Support Ukraine,Contributed income:Donations directed by individuals,PayPal Bank 3,$50.00 ,"$96,714.74 "
PayPal Fees,11/2/23,Deposit,7NW50380PC3874337,04 PAYPAL GENERAL UNRESTR,PayPal fees,OFFICE/GENERAL ADMINISTRATIVE EXPENSES:PayPal Fees,PayPal Bank 3,$2.24 ,"$96,716.98 "
PayPal Bank 3,11/2/23,Deposit,70P94210Y0915791P,04 PAYPAL GENERAL UNRESTR,Subject: GeneralPageTransaction ID: 70P94210Y0915791Phttps://www.paypal.com/activity/payment/70P94210Y0915791P,PayPal Bank 3,--,$18.81 ,"$96,735.79 "
Donations directed by individuals,11/2/23,Deposit,70P94210Y0915791P,04 PAYPAL GENERAL UNRESTR,Support Ukraine - Support Ukraine,Contributed income:Donations directed by individuals,PayPal Bank 3,$20.00 ,"$96,755.79 "
PayPal Fees,11/2/23,Deposit,70P94210Y0915791P,04 PAYPAL GENERAL UNRESTR,PayPal fees,OFFICE/GENERAL ADMINISTRATIVE EXPENSES:PayPal Fees,PayPal Bank 3,$1.19 ,"$96,756.98 "
PayPal Bank 3,11/2/23,Deposit,53844687A44085127,07 1000 DRONES RESTR,Subject: 1000DRONESTransaction ID: 53844687A44085127https://www.paypal.com/activity/payment/53844687A44085127,PayPal Bank 3,--,$23.64 ,"$96,780.62 "
Donations directed by individuals,11/2/23,Deposit,53844687A44085127,07 1000 DRONES RESTR,1000 DRONES FOR UKRAINE - 1000 DRONES FOR UKRAINE,Contributed income:Donations directed by individuals,PayPal Bank 3,$25.00 ,"$96,805.62 "
PayPal Fees,11/2/23,Deposit,53844687A44085127,07 1000 DRONES RESTR,PayPal fees,OFFICE/GENERAL ADMINISTRATIVE EXPENSES:PayPal Fees,PayPal Bank 3,$1.36 ,"$96,806.98 "
PayPal Bank 3,11/2/23,Deposit,01713437UM936963Y,04 PAYPAL GENERAL UNRESTR,Subject: GeneralPageTransaction ID: 01713437UM936963Yhttps://www.paypal.com/activity/payment/01713437UM936963Y,PayPal Bank 3,--,$30.00 ,"$96,836.98 "
Donations directed by individuals,11/2/23,Deposit,01713437UM936963Y,04 PAYPAL GENERAL UNRESTR,Support Ukraine - Support Ukraine,Contributed income:Donations directed by individuals,PayPal Bank 3,$31.11 ,"$96,868.09 "
PayPal Fees,11/2/23,Deposit,01713437UM936963Y,04 PAYPAL GENERAL UNRESTR,PayPal fees,OFFICE/GENERAL ADMINISTRATIVE EXPENSES:PayPal Fees,PayPal Bank 3,$1.11 ,"$96,869.20 "
PayPal Bank 3,11/2/23,Deposit,031518192E966164N,04 PAYPAL GENERAL UNRESTR,Subject: GeneralPageTransaction ID: 031518192E966164Nhttps://www.paypal.com/activity/payment/031518192E966164N,PayPal Bank 3,--,$50.00 ,"$96,919.20 "
Donations directed by individuals,11/2/23,Deposit,031518192E966164N,04 PAYPAL GENERAL UNRESTR,Support Ukraine - Support Ukraine,Contributed income:Donations directed by individuals,PayPal Bank 3,$51.52 ,"$96,970.72 "
PayPal Fees,11/2/23,Deposit,031518192E966164N,04 PAYPAL GENERAL UNRESTR,PayPal fees,OFFICE/GENERAL ADMINISTRATIVE EXPENSES:PayPal Fees,PayPal Bank 3,$1.52 ,"$96,972.24 "
PayPal Bank 3,11/2/23,Deposit,1YW15096XL2693809,04 PAYPAL GENERAL UNRESTR,Subject: GeneralPageTransaction ID: 1YW15096XL2693809https://www.paypal.com/activity/payment/1YW15096XL2693809,PayPal Bank 3,--,$196.93 ,"$97,169.17 "
Donations directed by individuals,11/2/23,Deposit,1YW15096XL2693809,04 PAYPAL GENERAL UNRESTR,Support Ukraine - Support Ukraine,Contributed income:Donations directed by individuals,PayPal Bank 3,$204.56 ,"$97,373.73 "
PayPal Fees,11/2/23,Deposit,1YW15096XL2693809,04 PAYPAL GENERAL UNRESTR,PayPal fees,OFFICE/GENERAL ADMINISTRATIVE EXPENSES:PayPal Fees,PayPal Bank 3,$7.63 ,"$97,381.36 "
PayPal Bank 3,11/2/23,Deposit,1WG06791MA036190Y,08 VICTORY DRONES RESTR,Subject: VICTORY DRONESTransaction ID: 1WG06791MA036190Yhttps://www.paypal.com/activity/payment/1WG06791MA036190Y,PayPal Bank 3,--,$100.93 ,"$97,482.29 "
Donations directed by individuals,11/2/23,Deposit,1WG06791MA036190Y,08 VICTORY DRONES RESTR,Money in to PayPal,Contributed income:Donations directed by individuals,PayPal Bank 3,$103.48 ,"$97,585.77 "
PayPal Fees,11/2/23,Deposit,1WG06791MA036190Y,08 VICTORY DRONES RESTR,PayPal fees,OFFICE/GENERAL ADMINISTRATIVE EXPENSES:PayPal Fees,PayPal Bank 3,$2.55 ,"$97,588.32 "
PayPal Bank 3,11/2/23,Deposit,2W906350VU789682A,04 PAYPAL GENERAL UNRESTR,Subject: GeneralPageNote: HB Yulya SaganTransaction ID: 2W906350VU789682Ahttps://www.paypal.com/activity/payment/2W906350VU789682A,PayPal Bank 3,--,$28.91 ,"$97,617.23 "
Donations directed by individuals,11/2/23,Deposit,2W906350VU789682A,04 PAYPAL GENERAL UNRESTR,Support Ukraine - Support Ukraine,Contributed income:Donations directed by individuals,PayPal Bank 3,$30.00 ,"$97,647.23 "
PayPal Fees,11/2/23,Deposit,2W906350VU789682A,04 PAYPAL GENERAL UNRESTR,PayPal fees,OFFICE/GENERAL ADMINISTRATIVE EXPENSES:PayPal Fees,PayPal Bank 3,$1.09 ,"$97,648.32 "
PayPal Bank 3,11/2/23,Deposit,7U661067KJ601931P,04 PAYPAL GENERAL UNRESTR,Transaction ID: 7U661067KJ601931Phttps://www.paypal.com/activity/payment/7U661067KJ601931P,PayPal Bank 3,--,$9.26 ,"$97,657.58 "
Donations directed by individuals,11/2/23,Deposit,7U661067KJ601931P,04 PAYPAL GENERAL UNRESTR,Money in to PayPal,Contributed income:Donations directed by individuals,PayPal Bank 3,$10.10 ,"$97,667.68 "
PayPal Fees,11/2/23,Deposit,7U661067KJ601931P,04 PAYPAL GENERAL UNRESTR,PayPal fees,OFFICE/GENERAL ADMINISTRATIVE EXPENSES:PayPal Fees,PayPal Bank 3,$0.84 ,"$97,668.52 "
PayPal Bank 3,11/2/23,Deposit,4YW63917R52770155,04 PAYPAL GENERAL UNRESTR,Subject: GeneralPageTransaction ID: 4YW63917R52770155https://www.paypal.com/activity/payment/4YW63917R52770155,PayPal Bank 3,--,$49.23 ,"$97,717.75 "
Donations directed by individuals,11/2/23,Deposit,4YW63917R52770155,04 PAYPAL GENERAL UNRESTR,Support Ukraine - Support Ukraine,Contributed income:Donations directed by individuals,PayPal Bank 3,$51.52 ,"$97,769.27 "
PayPal Fees,11/2/23,Deposit,4YW63917R52770155,04 PAYPAL GENERAL UNRESTR,PayPal fees,OFFICE/GENERAL ADMINISTRATIVE EXPENSES:PayPal Fees,PayPal Bank 3,$2.29 ,"$97,771.56 "
PayPal Bank 3,11/2/23,Deposit,15N77228GU3923625,04 PAYPAL GENERAL UNRESTR,Subject: Support UkraineTransaction ID: 15N77228GU3923625https://www.paypal.com/activity/payment/15N77228GU3923625,PayPal Bank 3,--,$24.84 ,"$97,796.40 "
Donations directed by individuals,11/2/23,Deposit,15N77228GU3923625,04 PAYPAL GENERAL UNRESTR,Money in to PayPal,Contributed income:Donations directed by individuals,PayPal Bank 3,$26.25 ,"$97,822.65 "
PayPal Fees,11/2/23,Deposit,15N77228GU3923625,04 PAYPAL GENERAL UNRESTR,PayPal fees,OFFICE/GENERAL ADMINISTRATIVE EXPENSES:PayPal Fees,PayPal Bank 3,$1.41 ,"$97,824.06 "
PayPal Bank 3,11/2/23,Deposit,7YK59961TH5386249,04 PAYPAL GENERAL UNRESTR,Subject: Support UkraineTransaction ID: 7YK59961TH5386249https://www.paypal.com/activity/payment/7YK59961TH5386249,PayPal Bank 3,--,$9.93 ,"$97,833.99 "
Donations directed by individuals,11/2/23,Deposit,7YK59961TH5386249,04 PAYPAL GENERAL UNRESTR,Money in to PayPal,Contributed income:Donations directed by individuals,PayPal Bank 3,$10.80 ,"$97,844.79 "
PayPal Fees,11/2/23,Deposit,7YK59961TH5386249,04 PAYPAL GENERAL UNRESTR,PayPal fees,OFFICE/GENERAL ADMINISTRATIVE EXPENSES:PayPal Fees,PayPal Bank 3,$0.87 ,"$97,845.66 "
PayPal Bank 3,11/2/23,Deposit,85S717470H4882246,04 PAYPAL GENERAL UNRESTR,Subject: Support UkraineTransaction ID: 85S717470H4882246https://www.paypal.com/activity/payment/85S717470H4882246,PayPal Bank 3,--,$4.96 ,"$97,850.62 "
Donations directed by individuals,11/2/23,Deposit,85S717470H4882246,04 PAYPAL GENERAL UNRESTR,Money in to PayPal,Contributed income:Donations directed by individuals,PayPal Bank 3,$5.65 ,"$97,856.27 "
PayPal Fees,11/2/23,Deposit,85S717470H4882246,04 PAYPAL GENERAL UNRESTR,PayPal fees,OFFICE/GENERAL ADMINISTRATIVE EXPENSES:PayPal Fees,PayPal Bank 3,$0.69 ,"$97,856.96 "
PayPal Bank 3,11/2/23,Deposit,99R56875GM1784203,04 PAYPAL GENERAL UNRESTR,Subject: Support UkraineTransaction ID: 99R56875GM1784203https://www.paypal.com/activity/payment/99R56875GM1784203,PayPal Bank 3,--,$149.07 ,"$98,006.03 "
Donations directed by individuals,11/2/23,Deposit,99R56875GM1784203,04 PAYPAL GENERAL UNRESTR,Money in to PayPal,Contributed income:Donations directed by individuals,PayPal Bank 3,$154.97 ,"$98,161.00 "
PayPal Fees,11/2/23,Deposit,99R56875GM1784203,04 PAYPAL GENERAL UNRESTR,PayPal fees,OFFICE/GENERAL ADMINISTRATIVE EXPENSES:PayPal Fees,PayPal Bank 3,$5.90 ,"$98,166.90 "
PayPal Bank 3,11/2/23,Deposit,3L929648J9033535X,04 PAYPAL GENERAL UNRESTR,Subject: Support UkraineTransaction ID: 3L929648J9033535Xhttps://www.paypal.com/activity/payment/3L929648J9033535X,PayPal Bank 3,--,$50.47 ,"$98,217.37 "
Donations directed by individuals,11/2/23,Deposit,3L929648J9033535X,04 PAYPAL GENERAL UNRESTR,Money in to PayPal,Contributed income:Donations directed by individuals,PayPal Bank 3,$51.99 ,"$98,269.36 "
PayPal Fees,11/2/23,Deposit,3L929648J9033535X,04 PAYPAL GENERAL UNRESTR,PayPal fees,OFFICE/GENERAL ADMINISTRATIVE EXPENSES:PayPal Fees,PayPal Bank 3,$1.52 ,"$98,270.88 "
PayPal Bank 3,11/2/23,Deposit,5GK352464J189104X,09 MSU RESTR,Subject: MobileShowersTransaction ID: 5GK352464J189104Xhttps://www.paypal.com/activity/payment/5GK352464J189104X,PayPal Bank 3,--,$23.64 ,"$98,294.52 "
Donations directed by individuals,11/2/23,Deposit,5GK352464J189104X,09 MSU RESTR,Mobile Shower/Laundry Units - Mobile Shower/Laundry Units,Contributed income:Donations directed by individuals,PayPal Bank 3,$25.00 ,"$98,319.52 "
PayPal Fees,11/2/23,Deposit,5GK352464J189104X,09 MSU RESTR,PayPal fees,OFFICE/GENERAL ADMINISTRATIVE EXPENSES:PayPal Fees,PayPal Bank 3,$1.36 ,"$98,320.88 "
PayPal Bank 3,11/2/23,Deposit,1C634948SX448522N,10 Flight to Recovery RESTR,Subject: FlightToRecoveryTransaction ID: 1C634948SX448522Nhttps://www.paypal.com/activity/payment/1C634948SX448522N,PayPal Bank 3,--,$23.64 ,"$98,344.52 "
Donations directed by individuals,11/2/23,Deposit,1C634948SX448522N,10 Flight to Recovery RESTR,Flight to Recovery - Flight to Recovery,Contributed income:Donations directed by individuals,PayPal Bank 3,$25.00 ,"$98,369.52 "
PayPal Fees,11/2/23,Deposit,1C634948SX448522N,10 Flight to Recovery RESTR,PayPal fees,OFFICE/GENERAL ADMINISTRATIVE EXPENSES:PayPal Fees,PayPal Bank 3,$1.36 ,"$98,370.88 "
PayPal Bank 3,11/2/23,Deposit,72K60194K1937301F,07 1000 DRONES RESTR,Subject: 1000DRONESTransaction ID: 72K60194K1937301Fhttps://www.paypal.com/activity/payment/72K60194K1937301F,PayPal Bank 3,--,$18.81 ,"$98,389.69 "
Donations directed by individuals,11/2/23,Deposit,72K60194K1937301F,07 1000 DRONES RESTR,1000 DRONES FOR UKRAINE - 1000 DRONES FOR UKRAINE,Contributed income:Donations directed by individuals,PayPal Bank 3,$20.00 ,"$98,409.69 "
PayPal Fees,11/2/23,Deposit,72K60194K1937301F,07 1000 DRONES RESTR,PayPal fees,OFFICE/GENERAL ADMINISTRATIVE EXPENSES:PayPal Fees,PayPal Bank 3,$1.19 ,"$98,410.88 "
PayPal Bank 3,11/2/23,Deposit,6EH70229TY5439641,04 PAYPAL GENERAL UNRESTR,Subject: GeneralPageTransaction ID: 6EH70229TY5439641https://www.paypal.com/activity/payment/6EH70229TY5439641,PayPal Bank 3,--,$9.84 ,"$98,420.72 "
Donations directed by individuals,11/2/23,Deposit,6EH70229TY5439641,04 PAYPAL GENERAL UNRESTR,Support Ukraine - Support Ukraine,Contributed income:Donations directed by individuals,PayPal Bank 3,$10.70 ,"$98,431.42 "
PayPal Fees,11/2/23,Deposit,6EH70229TY5439641,04 PAYPAL GENERAL UNRESTR,PayPal fees,OFFICE/GENERAL ADMINISTRATIVE EXPENSES:PayPal Fees,PayPal Bank 3,$0.86 ,"$98,432.28 "
PayPal Bank 3,11/2/23,Deposit,3C335750BD6566450,04 PAYPAL GENERAL UNRESTR,Subject: Support UkraineTransaction ID: 3C335750BD6566450https://www.paypal.com/activity/payment/3C335750BD6566450,PayPal Bank 3,--,$99.38 ,"$98,531.66 "
Donations directed by individuals,11/2/23,Deposit,3C335750BD6566450,04 PAYPAL GENERAL UNRESTR,Money in to PayPal,Contributed income:Donations directed by individuals,PayPal Bank 3,$103.48 ,"$98,635.14 "
PayPal Fees,11/2/23,Deposit,3C335750BD6566450,04 PAYPAL GENERAL UNRESTR,PayPal fees,OFFICE/GENERAL ADMINISTRATIVE EXPENSES:PayPal Fees,PayPal Bank 3,$4.10 ,"$98,639.24 "
PayPal Bank 3,11/2/23,Deposit,9DB28584D5741060E,07 1000 DRONES RESTR,Subject: 1000DRONESTransaction ID: 9DB28584D5741060Ehttps://www.paypal.com/activity/payment/9DB28584D5741060E,PayPal Bank 3,--,$73.84 ,"$98,713.08 "
Donations directed by individuals,11/2/23,Deposit,9DB28584D5741060E,07 1000 DRONES RESTR,1000 DRONES FOR UKRAINE - 1000 DRONES FOR UKRAINE,Contributed income:Donations directed by individuals,PayPal Bank 3,$77.02 ,"$98,790.10 "
PayPal Fees,11/2/23,Deposit,9DB28584D5741060E,07 1000 DRONES RESTR,PayPal fees,OFFICE/GENERAL ADMINISTRATIVE EXPENSES:PayPal Fees,PayPal Bank 3,$3.18 ,"$98,793.28 "
PayPal Bank 3,11/2/23,Deposit,8VK47016YK379483K,04 PAYPAL GENERAL UNRESTR,Subject: Support UkraineTransaction ID: 8VK47016YK379483Khttps://www.paypal.com/activity/payment/8VK47016YK379483K,PayPal Bank 3,--,$9.84 ,"$98,803.12 "
Donations directed by individuals,11/2/23,Deposit,8VK47016YK379483K,04 PAYPAL GENERAL UNRESTR,Money in to PayPal,Contributed income:Donations directed by individuals,PayPal Bank 3,$10.70 ,"$98,813.82 "
PayPal Fees,11/2/23,Deposit,8VK47016YK379483K,04 PAYPAL GENERAL UNRESTR,PayPal fees,OFFICE/GENERAL ADMINISTRATIVE EXPENSES:PayPal Fees,PayPal Bank 3,$0.86 ,"$98,814.68 "
PayPal Bank 3,10/31/23,Transfer,--,--,ORIG CO NAME:PAYPAL ORIG ID:PAYPALSD11 DESC DATE:231030 CO ENTRY DESCR:TRANSFER SEC:PPD TRACE#:091000010304157 EED:231031 IND ID: IND NAME:DIGNITAS UKRAINE TRN: XXXXXX4157TC,PayPal Bank 3,CHASE ENDING IN 5315,"($13,800.00)","$85,014.68 "
CHASE ENDING IN 5315,10/31/23,Transfer,--,--,ORIG CO NAME:PAYPAL ORIG ID:PAYPALSD11 DESC DATE:231030 CO ENTRY DESCR:TRANSFER SEC:PPD TRACE#:091000010304157 EED:231031 IND ID: IND NAME:DIGNITAS UKRAINE TRN: XXXXXX4157TC,CHASE ENDING IN 5315,PayPal Bank 3,"$13,800.00 ","$98,814.68 "
FIDELITY INVESTMENTS,10/31/23,Journal Entry,2,--,--,FIDELITY INVESTMENTS,--,$536.35 ,"$99,351.03 "
DIVIDENT RECEIVED FIDELITY,10/31/23,Journal Entry,2,--,--,Investment income:DIVIDENT RECEIVED FIDELITY,--,$536.35 ,"$99,887.38 "
FIDELITY INVESTMENTS,10/31/23,Journal Entry,3,--,--,FIDELITY INVESTMENTS,--,"$1,242.65 ","$101,130.03 "
DIVIDENT RECEIVED FIDELITY,10/31/23,Journal Entry,3,--,--,Investment income:DIVIDENT RECEIVED FIDELITY,--,"$1,242.65 ","$102,372.68 "
In-kind donations,10/31/23,Journal Entry,11,--,A.BOYCHUK AMAZON WISH LIST,Contributed income:In-kind donations,--,$537.07 ,"$102,909.75 "
IN-KIND DONATION DISTRIBUTIONS,10/31/23,Journal Entry,11,--,A.BOYCHUK AMAZON WISH LIST,PROGRAM EXPENSES:IN-KIND DONATION DISTRIBUTIONS,--,$537.07 ,"$103,446.82 "
FIVE % FOR ADMIN EXPENSES,10/31/23,Journal Entry,13,--,--,Contributed income:FIVE % FOR ADMIN EXPENSES,--,"($58,311.00)","$45,135.82 "
FIVE % FOR ADMIN EXPENSES,10/31/23,Journal Entry,13,--,--,Contributed income:FIVE % FOR ADMIN EXPENSES,--,"$58,311.00 ","$103,446.82 "
FIVE % FOR ADMIN EXPENSES,10/31/23,Journal Entry,13,--,--,Contributed income:FIVE % FOR ADMIN EXPENSES,--,($388.85),"$103,057.97 "
FIVE % FOR ADMIN EXPENSES,10/31/23,Journal Entry,13,--,--,Contributed income:FIVE % FOR ADMIN EXPENSES,--,$388.85 ,"$103,446.82 "
FIVE % FOR ADMIN EXPENSES,10/31/23,Journal Entry,13,--,--,Contributed income:FIVE % FOR ADMIN EXPENSES,--,"($3,905.22)","$99,541.60 "
FIVE % FOR ADMIN EXPENSES,10/31/23,Journal Entry,13,--,--,Contributed income:FIVE % FOR ADMIN EXPENSES,--,"$3,905.22 ","$103,446.82 "
FIVE % FOR ADMIN EXPENSES,10/31/23,Journal Entry,13,--,--,Contributed income:FIVE % FOR ADMIN EXPENSES,--,($67.88),"$103,378.94 "
FIVE % FOR ADMIN EXPENSES,10/31/23,Journal Entry,13,--,--,Contributed income:FIVE % FOR ADMIN EXPENSES,--,$67.88 ,"$103,446.82 "
FIVE % FOR ADMIN EXPENSES,10/31/23,Journal Entry,13,--,--,Contributed income:FIVE % FOR ADMIN EXPENSES,--,$0.00 ,"$103,446.82 "
FIVE % FOR ADMIN EXPENSES,10/31/23,Journal Entry,13,--,--,Contributed income:FIVE % FOR ADMIN EXPENSES,--,$0.00 ,"$103,446.82 "
FIVE % FOR ADMIN EXPENSES,10/31/23,Journal Entry,13,--,--,Contributed income:FIVE % FOR ADMIN EXPENSES,--,($681.00),"$102,765.82 "
FIVE % FOR ADMIN EXPENSES,10/31/23,Journal Entry,13,--,--,Contributed income:FIVE % FOR ADMIN EXPENSES,--,$681.00 ,"$103,446.82 "
FIVE % FOR ADMIN EXPENSES,10/31/23,Journal Entry,13,--,--,Contributed income:FIVE % FOR ADMIN EXPENSES,--,"($17,679.00)","$85,767.82 "
FIVE % FOR ADMIN EXPENSES,10/31/23,Journal Entry,13,--,--,Contributed income:FIVE % FOR ADMIN EXPENSES,--,"$17,679.00 ","$103,446.82 "
FIVE % FOR ADMIN EXPENSES,10/31/23,Journal Entry,13,--,--,Contributed income:FIVE % FOR ADMIN EXPENSES,--,($44.00),"$103,402.82 "
FIVE % FOR ADMIN EXPENSES,10/31/23,Journal Entry,13,--,--,Contributed income:FIVE % FOR ADMIN EXPENSES,--,$44.00 ,"$103,446.82 "
FIVE % FOR ADMIN EXPENSES,10/31/23,Journal Entry,13,--,--,Contributed income:FIVE % FOR ADMIN EXPENSES,--,($46.07),"$103,400.75 "
FIVE % FOR ADMIN EXPENSES,10/31/23,Journal Entry,13,--,--,Contributed income:FIVE % FOR ADMIN EXPENSES,--,$46.07 ,"$103,446.82 "
FIVE % FOR ADMIN EXPENSES,10/31/23,Journal Entry,13,--,--,Contributed income:FIVE % FOR ADMIN EXPENSES,--,($41.00),"$103,405.82 "
FIVE % FOR ADMIN EXPENSES,10/31/23,Journal Entry,13,--,--,Contributed income:FIVE % FOR ADMIN EXPENSES,--,$41.00 ,"$103,446.82 "
CHASE ENDING IN 5315,10/25/23,Expense,--,01 ADMINISTRATIVE ACCOUNT,Zelle payment to Dmitri Zakhalyavko XXXXXXX1345,CHASE ENDING IN 5315,MALING AND DELIVERY,($194.00),"$103,252.82 "
MALING AND DELIVERY,10/25/23,Expense,--,01 ADMINISTRATIVE ACCOUNT,Zelle payment to Dmitri Zakhalyavko XXXXXXX1345,OFFICE/GENERAL ADMINISTRATIVE EXPENSES:MALING AND DELIVERY,CHASE ENDING IN 5315,$194.00 ,"$103,446.82 "
CHASE ENDING IN 5315,10/25/23,Expense,--,03 FUNDRASING EVENTS UNRESTR,Zelle payment to Inna Collins JPM99a42sjyi,CHASE ENDING IN 5315,LODGING,"($1,192.29)","$102,254.53 "
LODGING,10/25/23,Expense,--,03 FUNDRASING EVENTS UNRESTR,Zelle payment to Inna Collins JPM99a42sjyi,FUNDRAISING EVENTS:LODGING,CHASE ENDING IN 5315,"$1,192.29 ","$103,446.82 "
CHASE ENDING IN 5315,10/23/23,Expense,--,08 VICTORY DRONES RESTR,ONLINE INTERNATIONAL WIRE TRANSFER A/C: JSC CB PRIVATBANK DNEPROPETROVSK UKRAINE X9094- UA REF: GRANT TRANCHE 1 PER OCT 23 AGREEMENT GIFT OR DONATION TRN: 36138 X3296ES 10/23,CHASE ENDING IN 5315,GRANTS,"($238,000.00)","($134,553.18)"
GRANTS,10/23/23,Expense,--,08 VICTORY DRONES RESTR,ONLINE INTERNATIONAL WIRE TRANSFER A/C: JSC CB PRIVATBANK DNEPROPETROVSK UKRAINE X9094- UA REF: GRANT TRANCHE 1 PER OCT 23 AGREEMENT GIFT OR DONATION TRN: 36138 X3296ES 10/23,PROGRAM EXPENSES:GRANTS,CHASE ENDING IN 5315,"$238,000.00 ","$103,446.82 "
FIDELITY INVESTMENTS,10/21/23,Transfer,--,--,ORIG CO NAME:FID BKG SVC LLC ORIG ID:0368504603 DESC DATE:231023 CO ENTRY DESCR:MONEYLINE SEC:PPD TRACE#:091000017684992 EED:231023 IND ID: IND NAME:DIGNITAS UK RAINE INC TRN: XXXXXX4992 TC,FIDELITY INVESTMENTS,CHASE ENDING IN 5315,"($200,000.00)","($96,553.18)"
CHASE ENDING IN 5315,10/21/23,Transfer,--,--,ORIG CO NAME:FID BKG SVC LLC ORIG ID:0368504603 DESC DATE:231023 CO ENTRY DESCR:MONEYLINE SEC:PPD TRACE#:091000017684992 EED:231023 IND ID: IND NAME:DIGNITAS UK RAINE INC TRN: XXXXXX4992 TC,CHASE ENDING IN 5315,FIDELITY INVESTMENTS,"$200,000.00 ","$103,446.82 "
CHASE ENDING IN 5315,10/19/23,Expense,--,07 1000 DRONES RESTR,"ONLINE DOMESTIC WIRE TRANSFER VIA: AMERANT BANK, N.A./XXXXXXXXX A/C: DRONE NERDS INC FT. LAUDERDALE FL XXXXX US REF: INV. ESTXXXXXXXXX AS OF XX/XX/23 - 50 CP.MA .XXXXXXXX.XX DJI MAVIC X PR O (DJI RC) (NA) IMAD: XXXXMMQFMPXKXXXXXX TRN: XXXXXXXXXXES 10/19",CHASE ENDING IN 5315,DRONE PURCHASES,"($95,000.00)","$8,446.82 "
DRONE PURCHASES,10/19/23,Expense,--,07 1000 DRONES RESTR,"ONLINE DOMESTIC WIRE TRANSFER VIA: AMERANT BANK, N.A./XXXXXXXXX A/C: DRONE NERDS INC FT. LAUDERDALE FL XXXXX US REF: INV. ESTXXXXXXXXX AS OF XX/XX/23 - 50 CP.MA .XXXXXXXX.XX DJI MAVIC X PR O (DJI RC) (NA) IMAD: XXXXMMQFMPXKXXXXXX TRN: XXXXXXXXXXES 10/19",PROGRAM EXPENSES:DRONE PURCHASES,CHASE ENDING IN 5315,"$95,000.00 ","$103,446.82 "
CHASE ENDING IN 5315,10/19/23,Deposit,1,02 GENERAL BANK URESTR,REMOTE ONLINE DEPOSIT # 1,CHASE ENDING IN 5315,Donations directed by individuals,$222.50 ,"$103,669.32 "
Donations directed by individuals,10/19/23,Deposit,1,02 GENERAL BANK URESTR,REMOTE ONLINE DEPOSIT # 1,Contributed income:Donations directed by individuals,CHASE ENDING IN 5315,$222.50 ,"$103,891.82 "
CHASE ENDING IN 5315,10/19/23,Deposit,1,02 GENERAL BANK URESTR,REMOTE ONLINE DEPOSIT # 1,CHASE ENDING IN 5315,Donations directed by individuals,$300.00 ,"$104,191.82 "
Donations directed by individuals,10/19/23,Deposit,1,02 GENERAL BANK URESTR,REMOTE ONLINE DEPOSIT # 1,Contributed income:Donations directed by individuals,CHASE ENDING IN 5315,$300.00 ,"$104,491.82 "
TRANSFERS DIRECTED BY BOARD,10/19/23,Journal Entry,17,--,--,Contributed income:TRANSFERS DIRECTED BY BOARD,--,"($95,000.00)","$9,491.82 "
TRANSFERS DIRECTED BY BOARD,10/19/23,Journal Entry,17,--,--,Contributed income:TRANSFERS DIRECTED BY BOARD,--,"$95,000.00 ","$104,491.82 "
CHASE ENDING IN 5315,10/17/23,Expense,--,08 VICTORY DRONES RESTR,ONLINE INTERNATIONAL WIRE TRANSFER VIA: DEUTSCHE BANK TRUST COMPANY/XXXX A/C: UNIVERSAL BANK JSC KIEV UKRAINE X4114 UA BEN: CO CHARITABLE FOUNDATION DIGNITAS KY IV UA REF: TECHNOLOGY GRANT FROM DIGNITAS UKRAINE INC GIFT OR DONATION SSN: XXXXXXX TRN: XXXXXXXXXXES 10/17,CHASE ENDING IN 5315,GRANTS,"($333,000.00)","($228,508.18)"
GRANTS,10/17/23,Expense,--,08 VICTORY DRONES RESTR,ONLINE INTERNATIONAL WIRE TRANSFER VIA: DEUTSCHE BANK TRUST COMPANY/XXXX A/C: UNIVERSAL BANK JSC KIEV UKRAINE X4114 UA BEN: CO CHARITABLE FOUNDATION DIGNITAS KY IV UA REF: TECHNOLOGY GRANT FROM DIGNITAS UKRAINE INC GIFT OR DONATION SSN: XXXXXXX TRN: XXXXXXXXXXES 10/17,PROGRAM EXPENSES:GRANTS,CHASE ENDING IN 5315,"$333,000.00 ","$104,491.82 "
TRANSFERS DIRECTED BY BOARD,10/17/23,Journal Entry,18,--,--,Contributed income:TRANSFERS DIRECTED BY BOARD,--,"($333,000.00)","($228,508.18)"
TRANSFERS DIRECTED BY BOARD,10/17/23,Journal Entry,18,--,--,Contributed income:TRANSFERS DIRECTED BY BOARD,--,"$333,000.00 ","$104,491.82 "
CHASE ENDING IN 5315,10/15/23,Deposit,--,02 GENERAL BANK URESTR,Zelle payment from OLEKSIY PIKHMANETS XXXXXXX2688,CHASE ENDING IN 5315,Donations directed by individuals,$100.00 ,"$104,591.82 "
Donations directed by individuals,10/15/23,Deposit,--,02 GENERAL BANK URESTR,Zelle payment from OLEKSIY PIKHMANETS XXXXXXX2688,Contributed income:Donations directed by individuals,CHASE ENDING IN 5315,$100.00 ,"$104,691.82 "
CHASE ENDING IN 5315,10/13/23,Expense,--,QuickBooks Payments,ORIG CO NAME:INTUIT * ORIG ID:XXXXXXXXXX DESC DATE:XXXXXX CO ENTRY DESCR:QBooks OnlSEC:CCD TRACE#:XXXXXXXXXXXXXXX EED:XXXXXX IND ID:XXX8632 IND NAME:DIGNITAS UK RAINE INC XXX-XXX-XXXX TRN: XXXXXX8121TC,CHASE ENDING IN 5315,Software & apps,($85.00),"$104,606.82 "
Software & apps,10/13/23,Expense,--,QuickBooks Payments,ORIG CO NAME:INTUIT * ORIG ID:XXXXXXXXXX DESC DATE:XXXXXX CO ENTRY DESCR:QBooks OnlSEC:CCD TRACE#:XXXXXXXXXXXXXXX EED:XXXXXX IND ID:XXX8632 IND NAME:DIGNITAS UK RAINE INC XXX-XXX-XXXX TRN: XXXXXX8121TC,OFFICE/GENERAL ADMINISTRATIVE EXPENSES:Software & apps,CHASE ENDING IN 5315,$85.00 ,"$104,691.82 "
CHASE ENDING IN 5315,10/12/23,Deposit,--,08 VICTORY DRONES RESTR,"FEDWIRE CREDIT VIA: WELLS FARGO BANK, N.A./XXXXXXXXX B/O: SCHWAB CHARITABLE FUND SAN FRANCISCO CA X4105/US/REF: CHASE NYC/CTR/BNF=DIGNITAS UKRAINE INC CRANFORD NJ XXXXX-XXXX US/AC-XX XXXXXXXXXX RFB=XXXXXXXXXXXXX OBI=SC HWAB CHARITABLE FUND VICTORY DRON E S PROJECT BBI=/CHGS/USDX,XX/CHGS/US DX,XX/OCMT/USDX IMAD: XXXXIXBXXXXRXXXXXX TRN: XXXXXX0285FF",CHASE ENDING IN 5315,Donations directed by individuals,"$350,000.00 ","$454,691.82 "
Donations directed by individuals,10/12/23,Deposit,--,08 VICTORY DRONES RESTR,"FEDWIRE CREDIT VIA: WELLS FARGO BANK, N.A./XXXXXXXXX B/O: SCHWAB CHARITABLE FUND SAN FRANCISCO CA X4105/US/REF: CHASE NYC/CTR/BNF=DIGNITAS UKRAINE INC CRANFORD NJ XXXXX-XXXX US/AC-XX XXXXXXXXXX RFB=XXXXXXXXXXXXX OBI=SC HWAB CHARITABLE FUND VICTORY DRON E S PROJECT BBI=/CHGS/USDX,XX/CHGS/US DX,XX/OCMT/USDX IMAD: XXXXIXBXXXXRXXXXXX TRN: XXXXXX0285FF",Contributed income:Donations directed by individuals,CHASE ENDING IN 5315,"$350,000.00 ","$804,691.82 "
CHASE ENDING IN 5315,10/12/23,Transfer,--,--,ORIG CO NAME:FID BKG SVC LLC ORIG ID:XXXXXXXXXX DESC DATE:XXXXXX CO ENTRY DESCR:MONEYLINE SEC:PPD TRACE#:XXXXXXXXXXXXXXX EED:XX1012 IND ID: IND NAME:DIGNITAS UK RAINE INC TRN: XXXXXX9483TC,CHASE ENDING IN 5315,FIDELITY INVESTMENTS,"($200,000.00)","$604,691.82 "
FIDELITY INVESTMENTS,10/12/23,Transfer,--,--,ORIG CO NAME:FID BKG SVC LLC ORIG ID:XXXXXXXXXX DESC DATE:XXXXXX CO ENTRY DESCR:MONEYLINE SEC:PPD TRACE#:XXXXXXXXXXXXXXX EED:XX1012 IND ID: IND NAME:DIGNITAS UK RAINE INC TRN: XXXXXX9483TC,FIDELITY INVESTMENTS,CHASE ENDING IN 5315,"$200,000.00 ","$804,691.82 "
CHASE ENDING IN 5315,10/12/23,Deposit,--,02 GENERAL BANK URESTR,Zelle payment from VIKTORIYA SUKMANOVA BACk4eea03d6,CHASE ENDING IN 5315,Donations directed by individuals,"$3,000.00 ","$807,691.82 "
Donations directed by individuals,10/12/23,Deposit,--,02 GENERAL BANK URESTR,Zelle payment from VIKTORIYA SUKMANOVA BACk4eea03d6,Contributed income:Donations directed by individuals,CHASE ENDING IN 5315,"$3,000.00 ","$810,691.82 "
CHASE ENDING IN 5315,10/10/23,Transfer,--,--,ORIG CO NAME:FID BKG SVC LLC ORIG ID:XXXXXXXXXX DESC DATE:XXXXXX CO ENTRY DESCR:MONEYLINE SEC:PPD TRACE#:XXXXXXXXXXXXXXX EED:XX1010 IND ID: IND NAME:DIGNITAS UK RAINE INC TRN: XXXXXX6952TC,CHASE ENDING IN 5315,FIDELITY INVESTMENTS,"($250,000.00)","$560,691.82 "
FIDELITY INVESTMENTS,10/10/23,Transfer,--,--,ORIG CO NAME:FID BKG SVC LLC ORIG ID:XXXXXXXXXX DESC DATE:XXXXXX CO ENTRY DESCR:MONEYLINE SEC:PPD TRACE#:XXXXXXXXXXXXXXX EED:XX1010 IND ID: IND NAME:DIGNITAS UK RAINE INC TRN: XXXXXX6952TC,FIDELITY INVESTMENTS,CHASE ENDING IN 5315,"$250,000.00 ","$810,691.82 "
PayPal Bank 3,10/9/23,Deposit,49914332AA4286211,04 PAYPAL GENERAL UNRESTR,"Subject: GeneralPage
Transaction ID: 49914332AA4286211
https://www.paypal.com/activity/payment/49914332AA4286211",PayPal Bank 3,--,$50.00 ,"$810,741.82 "
Donations directed by individuals,10/9/23,Deposit,49914332AA4286211,04 PAYPAL GENERAL UNRESTR,Support Ukraine - Support Ukraine,Contributed income:Donations directed by individuals,PayPal Bank 3,$51.52 ,"$810,793.34 "
PayPal Fees,10/9/23,Deposit,49914332AA4286211,04 PAYPAL GENERAL UNRESTR,PayPal fees,OFFICE/GENERAL ADMINISTRATIVE EXPENSES:PayPal Fees,PayPal Bank 3,$1.52 ,"$810,794.86 "
PayPal Bank 3,10/9/23,Deposit,72D21145VH751883H,04 PAYPAL GENERAL UNRESTR,"Subject: GeneralPage
Transaction ID: 72D21145VH751883H
https://www.paypal.com/activity/payment/72D21145VH751883H",PayPal Bank 3,--,$49.23 ,"$810,844.09 "
Donations directed by individuals,10/9/23,Deposit,72D21145VH751883H,04 PAYPAL GENERAL UNRESTR,Support Ukraine - Support Ukraine,Contributed income:Donations directed by individuals,PayPal Bank 3,$51.52 ,"$810,895.61 "
PayPal Fees,10/9/23,Deposit,72D21145VH751883H,04 PAYPAL GENERAL UNRESTR,PayPal fees,OFFICE/GENERAL ADMINISTRATIVE EXPENSES:PayPal Fees,PayPal Bank 3,$2.29 ,"$810,897.90 "
PayPal Bank 3,10/9/23,Deposit,9P883830TX7239227,04 PAYPAL GENERAL UNRESTR,"Subject: Support Ukraine
Transaction ID: 9P883830TX7239227
https://www.paypal.com/activity/payment/9P883830TX7239227",PayPal Bank 3,--,$4.34 ,"$810,902.24 "
Donations directed by individuals,10/9/23,Deposit,9P883830TX7239227,04 PAYPAL GENERAL UNRESTR,Money in to PayPal,Contributed income:Donations directed by individuals,PayPal Bank 3,$5.00 ,"$810,907.24 "
PayPal Fees,10/9/23,Deposit,9P883830TX7239227,04 PAYPAL GENERAL UNRESTR,PayPal fees,OFFICE/GENERAL ADMINISTRATIVE EXPENSES:PayPal Fees,PayPal Bank 3,$0.66 ,"$810,907.90 "
PayPal Bank 3,10/9/23,Deposit,7YF22952RS173584L,04 PAYPAL GENERAL UNRESTR,"Subject: GeneralPage
Transaction ID: 7YF22952RS173584L
https://www.paypal.com/activity/payment/7YF22952RS173584L",PayPal Bank 3,--,$4.34 ,"$810,912.24 "
Donations directed by individuals,10/9/23,Deposit,7YF22952RS173584L,04 PAYPAL GENERAL UNRESTR,Support Ukraine - Support Ukraine,Contributed income:Donations directed by individuals,PayPal Bank 3,$5.00 ,"$810,917.24 "
PayPal Fees,10/9/23,Deposit,7YF22952RS173584L,04 PAYPAL GENERAL UNRESTR,PayPal fees,OFFICE/GENERAL ADMINISTRATIVE EXPENSES:PayPal Fees,PayPal Bank 3,$0.66 ,"$810,917.90 "
PayPal Bank 3,10/9/23,Deposit,3A538931GE813994V,04 PAYPAL GENERAL UNRESTR,"Subject: GeneralPage
Transaction ID: 3A538931GE813994V
https://www.paypal.com/activity/payment/3A538931GE813994V",PayPal Bank 3,--,$50.00 ,"$810,967.90 "
Donations directed by individuals,10/9/23,Deposit,3A538931GE813994V,04 PAYPAL GENERAL UNRESTR,Support Ukraine - Support Ukraine,Contributed income:Donations directed by individuals,PayPal Bank 3,$51.52 ,"$811,019.42 "
PayPal Fees,10/9/23,Deposit,3A538931GE813994V,04 PAYPAL GENERAL UNRESTR,PayPal fees,OFFICE/GENERAL ADMINISTRATIVE EXPENSES:PayPal Fees,PayPal Bank 3,$1.52 ,"$811,020.94 "
PayPal Bank 3,10/6/23,Deposit,13371471XW630393P,04 PAYPAL GENERAL UNRESTR,"Subject: Support Ukraine
Transaction ID: 13371471XW630393P
https://www.paypal.com/activity/payment/13371471XW630393P",PayPal Bank 3,--,$149.07 ,"$811,170.01 "
Donations directed by individuals,10/6/23,Deposit,13371471XW630393P,04 PAYPAL GENERAL UNRESTR,Money in to PayPal,Contributed income:Donations directed by individuals,PayPal Bank 3,$154.97 ,"$811,324.98 "
PayPal Fees,10/6/23,Deposit,13371471XW630393P,04 PAYPAL GENERAL UNRESTR,PayPal fees,OFFICE/GENERAL ADMINISTRATIVE EXPENSES:PayPal Fees,PayPal Bank 3,$5.90 ,"$811,330.88 "
PayPal Bank 3,10/6/23,Deposit,2YB50501K7466601E,04 PAYPAL GENERAL UNRESTR,"Subject: Support Ukraine
Transaction ID: 2YB50501K7466601E
https://www.paypal.com/activity/payment/2YB50501K7466601E",PayPal Bank 3,--,$99.38 ,"$811,430.26 "
Donations directed by individuals,10/6/23,Deposit,2YB50501K7466601E,04 PAYPAL GENERAL UNRESTR,Money in to PayPal,Contributed income:Donations directed by individuals,PayPal Bank 3,$103.48 ,"$811,533.74 "
PayPal Fees,10/6/23,Deposit,2YB50501K7466601E,04 PAYPAL GENERAL UNRESTR,PayPal fees,OFFICE/GENERAL ADMINISTRATIVE EXPENSES:PayPal Fees,PayPal Bank 3,$4.10 ,"$811,537.84 "
PayPal Bank 3,10/6/23,Deposit,8TA99837R83648149,04 PAYPAL GENERAL UNRESTR,"Subject: GeneralPage
Transaction ID: 8TA99837R83648149
https://www.paypal.com/activity/payment/8TA99837R83648149",PayPal Bank 3,--,$96.02 ,"$811,633.86 "
Donations directed by individuals,10/6/23,Deposit,8TA99837R83648149,04 PAYPAL GENERAL UNRESTR,Support Ukraine - Support Ukraine,Contributed income:Donations directed by individuals,PayPal Bank 3,$100.00 ,"$811,733.86 "
PayPal Fees,10/6/23,Deposit,8TA99837R83648149,04 PAYPAL GENERAL UNRESTR,PayPal fees,OFFICE/GENERAL ADMINISTRATIVE EXPENSES:PayPal Fees,PayPal Bank 3,$3.98 ,"$811,737.84 "
PayPal Bank 3,10/6/23,Deposit,3WP790486K383190A,04 PAYPAL GENERAL UNRESTR,"Subject: GeneralPage
Note: Fron Darius, Diana, Ingrid ( Lökholmens camping)
Transaction ID: 3WP790486K383190A
https://www.paypal.com/activity/payment/3WP790486K383190A",PayPal Bank 3,--,$9.16 ,"$811,747.00 "
Donations directed by individuals,10/6/23,Deposit,3WP790486K383190A,04 PAYPAL GENERAL UNRESTR,Support Ukraine - Support Ukraine,Contributed income:Donations directed by individuals,PayPal Bank 3,$10.00 ,"$811,757.00 "
PayPal Fees,10/6/23,Deposit,3WP790486K383190A,04 PAYPAL GENERAL UNRESTR,PayPal fees,OFFICE/GENERAL ADMINISTRATIVE EXPENSES:PayPal Fees,PayPal Bank 3,$0.84 ,"$811,757.84 "
PayPal Bank 3,10/6/23,Deposit,41U5260073657862W,04 PAYPAL GENERAL UNRESTR,"Subject: GeneralPage
Transaction ID: 41U5260073657862W
https://www.paypal.com/activity/payment/41U5260073657862W",PayPal Bank 3,--,$9.84 ,"$811,767.68 "
Donations directed by individuals,10/6/23,Deposit,41U5260073657862W,04 PAYPAL GENERAL UNRESTR,Support Ukraine - Support Ukraine,Contributed income:Donations directed by individuals,PayPal Bank 3,$10.70 ,"$811,778.38 "
PayPal Fees,10/6/23,Deposit,41U5260073657862W,04 PAYPAL GENERAL UNRESTR,PayPal fees,OFFICE/GENERAL ADMINISTRATIVE EXPENSES:PayPal Fees,PayPal Bank 3,$0.86 ,"$811,779.24 "
PayPal Bank 3,10/6/23,Deposit,1WT66652GL233633T,04 PAYPAL GENERAL UNRESTR,"Subject: Support Ukraine
Transaction ID: 1WT66652GL233633T
https://www.paypal.com/activity/payment/1WT66652GL233633T",PayPal Bank 3,--,$195.53 ,"$811,974.77 "
Donations directed by individuals,10/6/23,Deposit,1WT66652GL233633T,04 PAYPAL GENERAL UNRESTR,Money in to PayPal,Contributed income:Donations directed by individuals,PayPal Bank 3,$200.00 ,"$812,174.77 "
PayPal Fees,10/6/23,Deposit,1WT66652GL233633T,04 PAYPAL GENERAL UNRESTR,PayPal fees,OFFICE/GENERAL ADMINISTRATIVE EXPENSES:PayPal Fees,PayPal Bank 3,$4.47 ,"$812,179.24 "
PayPal Bank 3,10/6/23,Deposit,1M5621673X3210631,04 PAYPAL GENERAL UNRESTR,"Subject: GeneralPage
Transaction ID: 1M5621673X3210631
https://www.paypal.com/activity/payment/1M5621673X3210631",PayPal Bank 3,--,$14.76 ,"$812,194.00 "
Donations directed by individuals,10/6/23,Deposit,1M5621673X3210631,04 PAYPAL GENERAL UNRESTR,Support Ukraine - Support Ukraine,Contributed income:Donations directed by individuals,PayPal Bank 3,$15.80 ,"$812,209.80 "
PayPal Fees,10/6/23,Deposit,1M5621673X3210631,04 PAYPAL GENERAL UNRESTR,PayPal fees,OFFICE/GENERAL ADMINISTRATIVE EXPENSES:PayPal Fees,PayPal Bank 3,$1.04 ,"$812,210.84 "
PayPal Bank 3,10/6/23,Deposit,1YB664012B5073058,07 1000 DRONES RESTR,"Subject: 1000 DRONES FOR UKRAINE
Transaction ID: 1YB664012B5073058
https://www.paypal.com/activity/payment/1YB664012B5073058",PayPal Bank 3,--,$24.84 ,"$812,235.68 "
Donations directed by individuals,10/6/23,Deposit,1YB664012B5073058,07 1000 DRONES RESTR,Money in to PayPal,Contributed income:Donations directed by individuals,PayPal Bank 3,$26.25 ,"$812,261.93 "
PayPal Fees,10/6/23,Deposit,1YB664012B5073058,07 1000 DRONES RESTR,PayPal fees,OFFICE/GENERAL ADMINISTRATIVE EXPENSES:PayPal Fees,PayPal Bank 3,$1.41 ,"$812,263.34 "
PayPal Bank 3,10/6/23,Deposit,0G0631147K014701R,04 PAYPAL GENERAL UNRESTR,"Subject: GeneralPage
Transaction ID: 0G0631147K014701R
https://www.paypal.com/activity/payment/0G0631147K014701R",PayPal Bank 3,--,$24.61 ,"$812,287.95 "
Donations directed by individuals,10/6/23,Deposit,0G0631147K014701R,04 PAYPAL GENERAL UNRESTR,Support Ukraine - Support Ukraine,Contributed income:Donations directed by individuals,PayPal Bank 3,$26.01 ,"$812,313.96 "
PayPal Fees,10/6/23,Deposit,0G0631147K014701R,04 PAYPAL GENERAL UNRESTR,PayPal fees,OFFICE/GENERAL ADMINISTRATIVE EXPENSES:PayPal Fees,PayPal Bank 3,$1.40 ,"$812,315.36 "
PayPal Bank 3,10/6/23,Deposit,29B68876P1835363X,04 PAYPAL GENERAL UNRESTR,"Subject: GeneralPage
Transaction ID: 29B68876P1835363X
https://www.paypal.com/activity/payment/29B68876P1835363X",PayPal Bank 3,--,$115.32 ,"$812,430.68 "
Donations directed by individuals,10/6/23,Deposit,29B68876P1835363X,04 PAYPAL GENERAL UNRESTR,Support Ukraine - Support Ukraine,Contributed income:Donations directed by individuals,PayPal Bank 3,$120.00 ,"$812,550.68 "
PayPal Fees,10/6/23,Deposit,29B68876P1835363X,04 PAYPAL GENERAL UNRESTR,PayPal fees,OFFICE/GENERAL ADMINISTRATIVE EXPENSES:PayPal Fees,PayPal Bank 3,$4.68 ,"$812,555.36 "
PayPal Bank 3,10/6/23,Deposit,3VD53658HT7684012,04 PAYPAL GENERAL UNRESTR,"Subject: GeneralPage
Transaction ID: 3VD53658HT7684012
https://www.paypal.com/activity/payment/3VD53658HT7684012",PayPal Bank 3,--,$4.91 ,"$812,560.27 "
Donations directed by individuals,10/6/23,Deposit,3VD53658HT7684012,04 PAYPAL GENERAL UNRESTR,Support Ukraine - Support Ukraine,Contributed income:Donations directed by individuals,PayPal Bank 3,$5.60 ,"$812,565.87 "
PayPal Fees,10/6/23,Deposit,3VD53658HT7684012,04 PAYPAL GENERAL UNRESTR,PayPal fees,OFFICE/GENERAL ADMINISTRATIVE EXPENSES:PayPal Fees,PayPal Bank 3,$0.69 ,"$812,566.56 "
PayPal Bank 3,10/6/23,Deposit,3MF06902BN644390H,10 Flight to Recovery RESTR,"Subject: FlightToRecovery
Note: СЛАВА УКРАЇНІ!
Transaction ID: 3MF06902BN644390H
https://www.paypal.com/activity/payment/3MF06902BN644390H",PayPal Bank 3,--,$20.00 ,"$812,586.56 "
Donations directed by individuals,10/6/23,Deposit,3MF06902BN644390H,10 Flight to Recovery RESTR,Flight to Recovery - Flight to Recovery,Contributed income:Donations directed by individuals,PayPal Bank 3,$20.91 ,"$812,607.47 "
PayPal Fees,10/6/23,Deposit,3MF06902BN644390H,10 Flight to Recovery RESTR,PayPal fees,OFFICE/GENERAL ADMINISTRATIVE EXPENSES:PayPal Fees,PayPal Bank 3,$0.91 ,"$812,608.38 "
PayPal Bank 3,10/6/23,Deposit,64U393605P607673C,09 MSU RESTR,"Subject: MobileShowers
Note: СЛАВА УКРАЇНІ
Transaction ID: 64U393605P607673C
https://www.paypal.com/activity/payment/64U393605P607673C",PayPal Bank 3,--,$20.00 ,"$812,628.38 "
Donations directed by individuals,10/6/23,Deposit,64U393605P607673C,09 MSU RESTR,Mobile Shower/Laundry Units - Mobile Shower/Laundry Units,Contributed income:Donations directed by individuals,PayPal Bank 3,$20.91 ,"$812,649.29 "
PayPal Fees,10/6/23,Deposit,64U393605P607673C,09 MSU RESTR,PayPal fees,OFFICE/GENERAL ADMINISTRATIVE EXPENSES:PayPal Fees,PayPal Bank 3,$0.91 ,"$812,650.20 "
PayPal Bank 3,10/6/23,Deposit,2FS369040T8671054,04 PAYPAL GENERAL UNRESTR,"Subject: GeneralPage
Transaction ID: 2FS369040T8671054
https://www.paypal.com/activity/payment/2FS369040T8671054",PayPal Bank 3,--,$9.84 ,"$812,660.04 "
Donations directed by individuals,10/6/23,Deposit,2FS369040T8671054,04 PAYPAL GENERAL UNRESTR,Support Ukraine - Support Ukraine,Contributed income:Donations directed by individuals,PayPal Bank 3,$10.70 ,"$812,670.74 "
PayPal Fees,10/6/23,Deposit,2FS369040T8671054,04 PAYPAL GENERAL UNRESTR,PayPal fees,OFFICE/GENERAL ADMINISTRATIVE EXPENSES:PayPal Fees,PayPal Bank 3,$0.86 ,"$812,671.60 "
PayPal Bank 3,10/6/23,Deposit,6N5554683N991981B,04 PAYPAL GENERAL UNRESTR,"Subject: GeneralPage
Transaction ID: 6N5554683N991981B
https://www.paypal.com/activity/payment/6N5554683N991981B",PayPal Bank 3,--,$30.00 ,"$812,701.60 "
Donations directed by individuals,10/6/23,Deposit,6N5554683N991981B,04 PAYPAL GENERAL UNRESTR,Support Ukraine - Support Ukraine,Contributed income:Donations directed by individuals,PayPal Bank 3,$31.11 ,"$812,732.71 "
PayPal Fees,10/6/23,Deposit,6N5554683N991981B,04 PAYPAL GENERAL UNRESTR,PayPal fees,OFFICE/GENERAL ADMINISTRATIVE EXPENSES:PayPal Fees,PayPal Bank 3,$1.11 ,"$812,733.82 "
PayPal Bank 3,10/6/23,Deposit,8FK84065J7757604N,08 VICTORY DRONES RESTR,"Subject: VictoryDrones
Transaction ID: 8FK84065J7757604N
https://www.paypal.com/activity/payment/8FK84065J7757604N",PayPal Bank 3,--,$73.36 ,"$812,807.18 "
Donations directed by individuals,10/6/23,Deposit,8FK84065J7757604N,08 VICTORY DRONES RESTR,VICTORY DRONES - VICTORY DRONES,Contributed income:Donations directed by individuals,PayPal Bank 3,$76.52 ,"$812,883.70 "
PayPal Fees,10/6/23,Deposit,8FK84065J7757604N,08 VICTORY DRONES RESTR,PayPal fees,OFFICE/GENERAL ADMINISTRATIVE EXPENSES:PayPal Fees,PayPal Bank 3,$3.16 ,"$812,886.86 "
PayPal Bank 3,10/6/23,Deposit,9079734432947634P,04 PAYPAL GENERAL UNRESTR,"Subject: GeneralPage
Transaction ID: 9079734432947634P
https://www.paypal.com/activity/payment/9079734432947634P",PayPal Bank 3,--,$39.38 ,"$812,926.24 "
Donations directed by individuals,10/6/23,Deposit,9079734432947634P,04 PAYPAL GENERAL UNRESTR,Support Ukraine - Support Ukraine,Contributed income:Donations directed by individuals,PayPal Bank 3,$41.31 ,"$812,967.55 "
PayPal Fees,10/6/23,Deposit,9079734432947634P,04 PAYPAL GENERAL UNRESTR,PayPal fees,OFFICE/GENERAL ADMINISTRATIVE EXPENSES:PayPal Fees,PayPal Bank 3,$1.93 ,"$812,969.48 "
PayPal Bank 3,10/6/23,Deposit,3HF44206FF592251E,04 PAYPAL GENERAL UNRESTR,"Subject: GeneralPage
Transaction ID: 3HF44206FF592251E
https://www.paypal.com/activity/payment/3HF44206FF592251E",PayPal Bank 3,--,$25.00 ,"$812,994.48 "
Donations directed by individuals,10/6/23,Deposit,3HF44206FF592251E,04 PAYPAL GENERAL UNRESTR,Support Ukraine - Support Ukraine,Contributed income:Donations directed by individuals,PayPal Bank 3,$26.01 ,"$813,020.49 "
PayPal Fees,10/6/23,Deposit,3HF44206FF592251E,04 PAYPAL GENERAL UNRESTR,PayPal fees,OFFICE/GENERAL ADMINISTRATIVE EXPENSES:PayPal Fees,PayPal Bank 3,$1.01 ,"$813,021.50 "
PayPal Bank 3,10/6/23,Deposit,0UA81861TJ921284B,04 PAYPAL GENERAL UNRESTR,"Subject: GeneralPage
Transaction ID: 0UA81861TJ921284B
https://www.paypal.com/activity/payment/0UA81861TJ921284B",PayPal Bank 3,--,$25.00 ,"$813,046.50 "
Donations directed by individuals,10/6/23,Deposit,0UA81861TJ921284B,04 PAYPAL GENERAL UNRESTR,Support Ukraine - Support Ukraine,Contributed income:Donations directed by individuals,PayPal Bank 3,$26.01 ,"$813,072.51 "
PayPal Fees,10/6/23,Deposit,0UA81861TJ921284B,04 PAYPAL GENERAL UNRESTR,PayPal fees,OFFICE/GENERAL ADMINISTRATIVE EXPENSES:PayPal Fees,PayPal Bank 3,$1.01 ,"$813,073.52 "
PayPal Bank 3,10/6/23,Deposit,8Y564603EG284122W,04 PAYPAL GENERAL UNRESTR,"Subject: GeneralPage
Transaction ID: 8Y564603EG284122W
https://www.paypal.com/activity/payment/8Y564603EG284122W",PayPal Bank 3,--,$9.84 ,"$813,083.36 "
Donations directed by individuals,10/6/23,Deposit,8Y564603EG284122W,04 PAYPAL GENERAL UNRESTR,Support Ukraine - Support Ukraine,Contributed income:Donations directed by individuals,PayPal Bank 3,$10.70 ,"$813,094.06 "
PayPal Fees,10/6/23,Deposit,8Y564603EG284122W,04 PAYPAL GENERAL UNRESTR,PayPal fees,OFFICE/GENERAL ADMINISTRATIVE EXPENSES:PayPal Fees,PayPal Bank 3,$0.86 ,"$813,094.92 "
PayPal Bank 3,10/6/23,Deposit,70711173HX5878602,07 1000 DRONES RESTR,"Subject: 1000 DRONES FOR UKRAINE
Transaction ID: 70711173HX5878602
https://www.paypal.com/activity/payment/70711173HX5878602",PayPal Bank 3,--,$10.93 ,"$813,105.85 "
Donations directed by individuals,10/6/23,Deposit,70711173HX5878602,07 1000 DRONES RESTR,Money in to PayPal,Contributed income:Donations directed by individuals,PayPal Bank 3,$11.83 ,"$813,117.68 "
PayPal Fees,10/6/23,Deposit,70711173HX5878602,07 1000 DRONES RESTR,PayPal fees,OFFICE/GENERAL ADMINISTRATIVE EXPENSES:PayPal Fees,PayPal Bank 3,$0.90 ,"$813,118.58 "
PayPal Bank 3,10/6/23,Deposit,9HD47019FN445034S,04 PAYPAL GENERAL UNRESTR,"Subject: Support Ukraine
Transaction ID: 9HD47019FN445034S
https://www.paypal.com/activity/payment/9HD47019FN445034S",PayPal Bank 3,--,$11.92 ,"$813,130.50 "
Donations directed by individuals,10/6/23,Deposit,9HD47019FN445034S,04 PAYPAL GENERAL UNRESTR,Money in to PayPal,Contributed income:Donations directed by individuals,PayPal Bank 3,$12.86 ,"$813,143.36 "
PayPal Fees,10/6/23,Deposit,9HD47019FN445034S,04 PAYPAL GENERAL UNRESTR,PayPal fees,OFFICE/GENERAL ADMINISTRATIVE EXPENSES:PayPal Fees,PayPal Bank 3,$0.94 ,"$813,144.30 "
PayPal Bank 3,10/6/23,Deposit,7CG63270BC895810W,04 PAYPAL GENERAL UNRESTR,"Subject: GeneralPage
Transaction ID: 7CG63270BC895810W
https://www.paypal.com/activity/payment/7CG63270BC895810W",PayPal Bank 3,--,$73.84 ,"$813,218.14 "
Donations directed by individuals,10/6/23,Deposit,7CG63270BC895810W,04 PAYPAL GENERAL UNRESTR,Support Ukraine - Support Ukraine,Contributed income:Donations directed by individuals,PayPal Bank 3,$77.02 ,"$813,295.16 "
PayPal Fees,10/6/23,Deposit,7CG63270BC895810W,04 PAYPAL GENERAL UNRESTR,PayPal fees,OFFICE/GENERAL ADMINISTRATIVE EXPENSES:PayPal Fees,PayPal Bank 3,$3.18 ,"$813,298.34 "
PayPal Bank 3,10/6/23,Deposit,60F70806L3230683H,04 PAYPAL GENERAL UNRESTR,"Subject: GeneralPage
Transaction ID: 60F70806L3230683H
https://www.paypal.com/activity/payment/60F70806L3230683H",PayPal Bank 3,--,$24.61 ,"$813,322.95 "
Donations directed by individuals,10/6/23,Deposit,60F70806L3230683H,04 PAYPAL GENERAL UNRESTR,Support Ukraine - Support Ukraine,Contributed income:Donations directed by individuals,PayPal Bank 3,$26.01 ,"$813,348.96 "
PayPal Fees,10/6/23,Deposit,60F70806L3230683H,04 PAYPAL GENERAL UNRESTR,PayPal fees,OFFICE/GENERAL ADMINISTRATIVE EXPENSES:PayPal Fees,PayPal Bank 3,$1.40 ,"$813,350.36 "
PayPal Bank 3,10/6/23,Deposit,0Y979730AK376702X,07 1000 DRONES RESTR,"Subject: 1000DRONES
Transaction ID: 0Y979730AK376702X
https://www.paypal.com/activity/payment/0Y979730AK376702X",PayPal Bank 3,--,$59.08 ,"$813,409.44 "
Donations directed by individuals,10/6/23,Deposit,0Y979730AK376702X,07 1000 DRONES RESTR,1000 DRONES FOR UKRAINE - 1000 DRONES FOR UKRAINE,Contributed income:Donations directed by individuals,PayPal Bank 3,$61.72 ,"$813,471.16 "
PayPal Fees,10/6/23,Deposit,0Y979730AK376702X,07 1000 DRONES RESTR,PayPal fees,OFFICE/GENERAL ADMINISTRATIVE EXPENSES:PayPal Fees,PayPal Bank 3,$2.64 ,"$813,473.80 "
PayPal Bank 3,10/6/23,Deposit,07L17239C11267153,04 PAYPAL GENERAL UNRESTR,"Subject: Support Ukraine
Transaction ID: 07L17239C11267153
https://www.paypal.com/activity/payment/07L17239C11267153",PayPal Bank 3,--,$98.46 ,"$813,572.26 "
Donations directed by individuals,10/6/23,Deposit,07L17239C11267153,04 PAYPAL GENERAL UNRESTR,Money in to PayPal,Contributed income:Donations directed by individuals,PayPal Bank 3,$102.53 ,"$813,674.79 "
PayPal Fees,10/6/23,Deposit,07L17239C11267153,04 PAYPAL GENERAL UNRESTR,PayPal fees,OFFICE/GENERAL ADMINISTRATIVE EXPENSES:PayPal Fees,PayPal Bank 3,$4.07 ,"$813,678.86 "
PayPal Bank 3,10/6/23,Deposit,81K10605TX798593C,04 PAYPAL GENERAL UNRESTR,"Subject: Support Ukraine
Transaction ID: 81K10605TX798593C
https://www.paypal.com/activity/payment/81K10605TX798593C",PayPal Bank 3,--,$50.00 ,"$813,728.86 "
Donations directed by individuals,10/6/23,Deposit,81K10605TX798593C,04 PAYPAL GENERAL UNRESTR,Money in to PayPal,Contributed income:Donations directed by individuals,PayPal Bank 3,$51.52 ,"$813,780.38 "
PayPal Fees,10/6/23,Deposit,81K10605TX798593C,04 PAYPAL GENERAL UNRESTR,PayPal fees,OFFICE/GENERAL ADMINISTRATIVE EXPENSES:PayPal Fees,PayPal Bank 3,$1.52 ,"$813,781.90 "
PayPal Bank 3,10/6/23,Deposit,2JY17594YE816890E,04 PAYPAL GENERAL UNRESTR,"Subject: Support Ukraine
Transaction ID: 2JY17594YE816890E
https://www.paypal.com/activity/payment/2JY17594YE816890E",PayPal Bank 3,--,$29.81 ,"$813,811.71 "
Donations directed by individuals,10/6/23,Deposit,2JY17594YE816890E,04 PAYPAL GENERAL UNRESTR,Money in to PayPal,Contributed income:Donations directed by individuals,PayPal Bank 3,$31.40 ,"$813,843.11 "
PayPal Fees,10/6/23,Deposit,2JY17594YE816890E,04 PAYPAL GENERAL UNRESTR,PayPal fees,OFFICE/GENERAL ADMINISTRATIVE EXPENSES:PayPal Fees,PayPal Bank 3,$1.59 ,"$813,844.70 "
PayPal Bank 3,10/6/23,Deposit,95227448BU160871B,04 PAYPAL GENERAL UNRESTR,"Subject: GeneralPage
Transaction ID: 95227448BU160871B
https://www.paypal.com/activity/payment/95227448BU160871B",PayPal Bank 3,--,$49.23 ,"$813,893.93 "
Donations directed by individuals,10/6/23,Deposit,95227448BU160871B,04 PAYPAL GENERAL UNRESTR,Support Ukraine - Support Ukraine,Contributed income:Donations directed by individuals,PayPal Bank 3,$51.52 ,"$813,945.45 "
PayPal Fees,10/6/23,Deposit,95227448BU160871B,04 PAYPAL GENERAL UNRESTR,PayPal fees,OFFICE/GENERAL ADMINISTRATIVE EXPENSES:PayPal Fees,PayPal Bank 3,$2.29 ,"$813,947.74 "
PayPal Bank 3,10/6/23,Deposit,2HY73635J7523481F,10 Flight to Recovery RESTR,"Subject: Dignitas Ukraine Flight to Recovery
Transaction ID: 2HY73635J7523481F
https://www.paypal.com/activity/payment/2HY73635J7523481F",PayPal Bank 3,--,$99.38 ,"$814,047.12 "
Donations directed by individuals,10/6/23,Deposit,2HY73635J7523481F,10 Flight to Recovery RESTR,Money in to PayPal,Contributed income:Donations directed by individuals,PayPal Bank 3,$103.48 ,"$814,150.60 "
PayPal Fees,10/6/23,Deposit,2HY73635J7523481F,10 Flight to Recovery RESTR,PayPal fees,OFFICE/GENERAL ADMINISTRATIVE EXPENSES:PayPal Fees,PayPal Bank 3,$4.10 ,"$814,154.70 "
PayPal Bank 3,10/6/23,Deposit,8TN91901YV958901S,08 VICTORY DRONES RESTR,"Subject: VICTORY DRONES
Transaction ID: 8TN91901YV958901S
https://www.paypal.com/activity/payment/8TN91901YV958901S",PayPal Bank 3,--,$99.38 ,"$814,254.08 "
Donations directed by individuals,10/6/23,Deposit,8TN91901YV958901S,08 VICTORY DRONES RESTR,Money in to PayPal,Contributed income:Donations directed by individuals,PayPal Bank 3,$103.48 ,"$814,357.56 "
PayPal Fees,10/6/23,Deposit,8TN91901YV958901S,08 VICTORY DRONES RESTR,PayPal fees,OFFICE/GENERAL ADMINISTRATIVE EXPENSES:PayPal Fees,PayPal Bank 3,$4.10 ,"$814,361.66 "
PayPal Bank 3,10/6/23,Deposit,1TL88269D20726502,10 Flight to Recovery RESTR,"Subject: Dignitas Ukraine Flight to Recovery
Transaction ID: 1TL88269D20726502
https://www.paypal.com/activity/payment/1TL88269D20726502",PayPal Bank 3,--,$50.47 ,"$814,412.13 "
Donations directed by individuals,10/6/23,Deposit,1TL88269D20726502,10 Flight to Recovery RESTR,Money in to PayPal,Contributed income:Donations directed by individuals,PayPal Bank 3,$51.99 ,"$814,464.12 "
PayPal Fees,10/6/23,Deposit,1TL88269D20726502,10 Flight to Recovery RESTR,PayPal fees,OFFICE/GENERAL ADMINISTRATIVE EXPENSES:PayPal Fees,PayPal Bank 3,$1.52 ,"$814,465.64 "
PayPal Bank 3,10/6/23,Deposit,7SN816120S185782D,04 PAYPAL GENERAL UNRESTR,"Subject: GeneralPage
Transaction ID: 7SN816120S185782D
https://www.paypal.com/activity/payment/7SN816120S185782D",PayPal Bank 3,--,$9.16 ,"$814,474.80 "
Donations directed by individuals,10/6/23,Deposit,7SN816120S185782D,04 PAYPAL GENERAL UNRESTR,Support Ukraine - Support Ukraine,Contributed income:Donations directed by individuals,PayPal Bank 3,$10.00 ,"$814,484.80 "
PayPal Fees,10/6/23,Deposit,7SN816120S185782D,04 PAYPAL GENERAL UNRESTR,PayPal fees,OFFICE/GENERAL ADMINISTRATIVE EXPENSES:PayPal Fees,PayPal Bank 3,$0.84 ,"$814,485.64 "
PayPal Bank 3,10/6/23,Deposit,5L103940S93154639,07 1000 DRONES RESTR,"Subject: 1000DRONES
Transaction ID: 5L103940S93154639
https://www.paypal.com/activity/payment/5L103940S93154639",PayPal Bank 3,--,$157.55 ,"$814,643.19 "
Donations directed by individuals,10/6/23,Deposit,5L103940S93154639,07 1000 DRONES RESTR,1000 DRONES FOR UKRAINE - 1000 DRONES FOR UKRAINE,Contributed income:Donations directed by individuals,PayPal Bank 3,$163.75 ,"$814,806.94 "
PayPal Fees,10/6/23,Deposit,5L103940S93154639,07 1000 DRONES RESTR,PayPal fees,OFFICE/GENERAL ADMINISTRATIVE EXPENSES:PayPal Fees,PayPal Bank 3,$6.20 ,"$814,813.14 "
PayPal Bank 3,10/6/23,Deposit,0V235272S0047003D,07 1000 DRONES RESTR,"Subject: 1000DRONES
Note: Thank you ALL! Keep up the support!
Transaction ID: 0V235272S0047003D
https://www.paypal.com/activity/payment/0V235272S0047003D",PayPal Bank 3,--,$146.52 ,"$814,959.66 "
Donations directed by individuals,10/6/23,Deposit,0V235272S0047003D,07 1000 DRONES RESTR,1000 DRONES FOR UKRAINE - 1000 DRONES FOR UKRAINE,Contributed income:Donations directed by individuals,PayPal Bank 3,$150.00 ,"$815,109.66 "
PayPal Fees,10/6/23,Deposit,0V235272S0047003D,07 1000 DRONES RESTR,PayPal fees,OFFICE/GENERAL ADMINISTRATIVE EXPENSES:PayPal Fees,PayPal Bank 3,$3.48 ,"$815,113.14 "
PayPal Bank 3,10/6/23,Deposit,49B50059KD722792P,04 PAYPAL GENERAL UNRESTR,Subject: GeneralPageTransaction ID: 49B50059KD722792Phttps://www.paypal.com/activity/payment/49B50059KD722792P,PayPal Bank 3,--,$25.00 ,"$815,138.14 "
Donations directed by individuals,10/6/23,Deposit,49B50059KD722792P,04 PAYPAL GENERAL UNRESTR,Support Ukraine - Support Ukraine,Contributed income:Donations directed by individuals,PayPal Bank 3,$26.01 ,"$815,164.15 "
PayPal Fees,10/6/23,Deposit,49B50059KD722792P,04 PAYPAL GENERAL UNRESTR,PayPal fees,OFFICE/GENERAL ADMINISTRATIVE EXPENSES:PayPal Fees,PayPal Bank 3,$1.01 ,"$815,165.16 "
CHASE ENDING IN 5315,10/6/23,Transfer,--,--,ORIG CO NAME:FID BKG SVC LLC ORIG ID:XXXXXXXXXX DESC DATE:XXXXXX CO ENTRY DESCR:MONEYLINE SEC:PPD TRACE#:XXXXXXXXXXXXXXX EED:XX1006 IND ID: IND NAME:DIGNITAS UK RAINE INC TRN: XXXXXX7570TC,CHASE ENDING IN 5315,FIDELITY INVESTMENTS,"($250,000.00)","$565,165.16 "
FIDELITY INVESTMENTS,10/6/23,Transfer,--,--,ORIG CO NAME:FID BKG SVC LLC ORIG ID:XXXXXXXXXX DESC DATE:XXXXXX CO ENTRY DESCR:MONEYLINE SEC:PPD TRACE#:XXXXXXXXXXXXXXX EED:XX1006 IND ID: IND NAME:DIGNITAS UK RAINE INC TRN: XXXXXX7570TC,FIDELITY INVESTMENTS,CHASE ENDING IN 5315,"$250,000.00 ","$815,165.16 "
CHASE ENDING IN 5315,10/5/23,Deposit,--,02 GENERAL BANK URESTR,Zelle payment from GENNADIY ARNAUTOV TDP0HYMFG136,CHASE ENDING IN 5315,Donations directed by individuals,$25.00 ,"$815,190.16 "
Donations directed by individuals,10/5/23,Deposit,--,02 GENERAL BANK URESTR,Zelle payment from GENNADIY ARNAUTOV TDP0HYMFG136,Contributed income:Donations directed by individuals,CHASE ENDING IN 5315,$25.00 ,"$815,215.16 "
PayPal Bank 3,10/4/23,Deposit,8UB77367SK7916420,04 PAYPAL GENERAL UNRESTR,"Subject: GeneralPage
Transaction ID: 8UB77367SK7916420
https://www.paypal.com/activity/payment/8UB77367SK7916420",PayPal Bank 3,--,$98.46 ,"$815,313.62 "
Donations directed by individuals,10/4/23,Deposit,8UB77367SK7916420,04 PAYPAL GENERAL UNRESTR,Support Ukraine - Support Ukraine,Contributed income:Donations directed by individuals,PayPal Bank 3,$102.53 ,"$815,416.15 "
PayPal Fees,10/4/23,Deposit,8UB77367SK7916420,04 PAYPAL GENERAL UNRESTR,PayPal fees,OFFICE/GENERAL ADMINISTRATIVE EXPENSES:PayPal Fees,PayPal Bank 3,$4.07 ,"$815,420.22 "
PayPal Bank 3,10/4/23,Deposit,2GL82116B84895933,04 PAYPAL GENERAL UNRESTR,"Subject: Support Ukraine
Transaction ID: 2GL82116B84895933
https://www.paypal.com/activity/payment/2GL82116B84895933",PayPal Bank 3,--,$19.87 ,"$815,440.09 "
Donations directed by individuals,10/4/23,Deposit,2GL82116B84895933,04 PAYPAL GENERAL UNRESTR,Money in to PayPal,Contributed income:Donations directed by individuals,PayPal Bank 3,$21.10 ,"$815,461.19 "
PayPal Fees,10/4/23,Deposit,2GL82116B84895933,04 PAYPAL GENERAL UNRESTR,PayPal fees,OFFICE/GENERAL ADMINISTRATIVE EXPENSES:PayPal Fees,PayPal Bank 3,$1.23 ,"$815,462.42 "
PayPal Bank 3,10/4/23,Deposit,1C847891668213910,08 VICTORY DRONES RESTR,"Subject: VICTORY DRONES
Transaction ID: 1C847891668213910
https://www.paypal.com/activity/payment/1C847891668213910",PayPal Bank 3,--,$100.93 ,"$815,563.35 "
Donations directed by individuals,10/4/23,Deposit,1C847891668213910,08 VICTORY DRONES RESTR,Money in to PayPal,Contributed income:Donations directed by individuals,PayPal Bank 3,$103.48 ,"$815,666.83 "
PayPal Fees,10/4/23,Deposit,1C847891668213910,08 VICTORY DRONES RESTR,PayPal fees,OFFICE/GENERAL ADMINISTRATIVE EXPENSES:PayPal Fees,PayPal Bank 3,$2.55 ,"$815,669.38 "
PayPal Bank 3,10/4/23,Deposit,31M82972VY684153P,04 PAYPAL GENERAL UNRESTR,"Subject: Support Ukraine
Transaction ID: 31M82972VY684153P
https://www.paypal.com/activity/payment/31M82972VY684153P",PayPal Bank 3,--,$9.93 ,"$815,679.31 "
Donations directed by individuals,10/4/23,Deposit,31M82972VY684153P,04 PAYPAL GENERAL UNRESTR,Money in to PayPal,Contributed income:Donations directed by individuals,PayPal Bank 3,$10.80 ,"$815,690.11 "
PayPal Fees,10/4/23,Deposit,31M82972VY684153P,04 PAYPAL GENERAL UNRESTR,PayPal fees,OFFICE/GENERAL ADMINISTRATIVE EXPENSES:PayPal Fees,PayPal Bank 3,$0.87 ,"$815,690.98 "
PayPal Bank 3,10/4/23,Deposit,3LG69821WL3915036,04 PAYPAL GENERAL UNRESTR,"Subject: Support Ukraine
Transaction ID: 3LG69821WL3915036
https://www.paypal.com/activity/payment/3LG69821WL3915036",PayPal Bank 3,--,$4.96 ,"$815,695.94 "
Donations directed by individuals,10/4/23,Deposit,3LG69821WL3915036,04 PAYPAL GENERAL UNRESTR,Money in to PayPal,Contributed income:Donations directed by individuals,PayPal Bank 3,$5.65 ,"$815,701.59 "
PayPal Fees,10/4/23,Deposit,3LG69821WL3915036,04 PAYPAL GENERAL UNRESTR,PayPal fees,OFFICE/GENERAL ADMINISTRATIVE EXPENSES:PayPal Fees,PayPal Bank 3,$0.69 ,"$815,702.28 "
PayPal Bank 3,10/4/23,Deposit,22W96765050430402,04 PAYPAL GENERAL UNRESTR,"Subject: Support Ukraine
Transaction ID: 22W96765050430402
https://www.paypal.com/activity/payment/22W96765050430402",PayPal Bank 3,--,$24.84 ,"$815,727.12 "
Donations directed by individuals,10/4/23,Deposit,22W96765050430402,04 PAYPAL GENERAL UNRESTR,Money in to PayPal,Contributed income:Donations directed by individuals,PayPal Bank 3,$26.25 ,"$815,753.37 "
PayPal Fees,10/4/23,Deposit,22W96765050430402,04 PAYPAL GENERAL UNRESTR,PayPal fees,OFFICE/GENERAL ADMINISTRATIVE EXPENSES:PayPal Fees,PayPal Bank 3,$1.41 ,"$815,754.78 "
PayPal Bank 3,10/4/23,Deposit,9YJ688102A636461U,04 PAYPAL GENERAL UNRESTR,"Subject: Support Ukraine
Transaction ID: 9YJ688102A636461U
https://www.paypal.com/activity/payment/9YJ688102A636461U",PayPal Bank 3,--,$50.47 ,"$815,805.25 "
Donations directed by individuals,10/4/23,Deposit,9YJ688102A636461U,04 PAYPAL GENERAL UNRESTR,Money in to PayPal,Contributed income:Donations directed by individuals,PayPal Bank 3,$51.99 ,"$815,857.24 "
PayPal Fees,10/4/23,Deposit,9YJ688102A636461U,04 PAYPAL GENERAL UNRESTR,PayPal fees,OFFICE/GENERAL ADMINISTRATIVE EXPENSES:PayPal Fees,PayPal Bank 3,$1.52 ,"$815,858.76 "
PayPal Bank 3,9/29/23,Transfer,--,--,ORIG CO NAME:PAYPAL ORIG ID:PAYPALSDXX DESC DATE:XXXXXX CO ENTRY DESCR:TRANSFER SEC:PPD TRACE#:XXXXXXXXXXXXXXX EED:XX0929 IND ID: IND NAME:DIGNITAS UKRAINE TRN: XXXXXX0912TC,PayPal Bank 3,CHASE ENDING IN 5315,"($8,000.00)","$807,858.76 "
CHASE ENDING IN 5315,9/29/23,Transfer,--,--,ORIG CO NAME:PAYPAL ORIG ID:PAYPALSDXX DESC DATE:XXXXXX CO ENTRY DESCR:TRANSFER SEC:PPD TRACE#:XXXXXXXXXXXXXXX EED:XX0929 IND ID: IND NAME:DIGNITAS UKRAINE TRN: XXXXXX0912TC,CHASE ENDING IN 5315,PayPal Bank 3,"$8,000.00 ","$815,858.76 "
PayPal Bank 3,9/28/23,Deposit,4FM8074579510841C,07 1000 DRONES RESTR,"Subject: 1000DRONES
Transaction ID: 4FM8074579510841C
https://www.paypal.com/activity/payment/4FM8074579510841C",PayPal Bank 3,--,$97.52 ,"$815,956.28 "
Donations directed by individuals,9/28/23,Deposit,4FM8074579510841C,07 1000 DRONES RESTR,1000 DRONES FOR UKRAINE - 1000 DRONES FOR UKRAINE,Contributed income:Donations directed by individuals,PayPal Bank 3,$100.00 ,"$816,056.28 "
PayPal Fees,9/28/23,Deposit,4FM8074579510841C,07 1000 DRONES RESTR,PayPal fees,OFFICE/GENERAL ADMINISTRATIVE EXPENSES:PayPal Fees,PayPal Bank 3,$2.48 ,"$816,058.76 "
CHASE ENDING IN 5315,9/28/23,Expense,--,02 GENERAL BANK URESTR,"ONLINE INTERNATIONAL WIRE TRANSFER A/C: FOREIGN CUR BUS ACCT BK X COLUMBUS NEWARK DE XXXXXXXXX US ORG: XXXXXXXXXXXXXXXXX DIGNITAS UKRAINE INC BEN:/LVXXPARXX0232 XXXXXXXX SIA RMAUTO REF: CAR FOR DIGNITAS INVOICE PAYMENT/OCMT/EURXXXX,XX/EXCH/X.XXXX/CNTR/XXXX XXXX/ACC/CAR FOR DIGNITAS TRN: XXXXXXXXXXRE 09/28",CHASE ENDING IN 5315,CAR PURCHASES,"($6,474.59)","$809,584.17 "
CAR PURCHASES,9/28/23,Expense,--,02 GENERAL BANK URESTR,"ONLINE INTERNATIONAL WIRE TRANSFER A/C: FOREIGN CUR BUS ACCT BK X COLUMBUS NEWARK DE XXXXXXXXX US ORG: XXXXXXXXXXXXXXXXX DIGNITAS UKRAINE INC BEN:/LVXXPARXX0232 XXXXXXXX SIA RMAUTO REF: CAR FOR DIGNITAS INVOICE PAYMENT/OCMT/EURXXXX,XX/EXCH/X.XXXX/CNTR/XXXX XXXX/ACC/CAR FOR DIGNITAS TRN: XXXXXXXXXXRE 09/28",PROGRAM EXPENSES:CAR PURCHASES,CHASE ENDING IN 5315,"$6,474.59 ","$816,058.76 "
PayPal Bank 3,9/27/23,Deposit,9TM37747X54100303,04 PAYPAL GENERAL UNRESTR,"Subject: GeneralPage
Transaction ID: 9TM37747X54100303
https://www.paypal.com/activity/payment/9TM37747X54100303",PayPal Bank 3,--,$4.91 ,"$816,063.67 "
Donations directed by individuals,9/27/23,Deposit,9TM37747X54100303,04 PAYPAL GENERAL UNRESTR,Support Ukraine - Support Ukraine,Contributed income:Donations directed by individuals,PayPal Bank 3,$5.60 ,"$816,069.27 "
PayPal Fees,9/27/23,Deposit,9TM37747X54100303,04 PAYPAL GENERAL UNRESTR,PayPal fees,OFFICE/GENERAL ADMINISTRATIVE EXPENSES:PayPal Fees,PayPal Bank 3,$0.69 ,"$816,069.96 "
CHASE ENDING IN 5315,9/26/23,Deposit,1,02 GENERAL BANK URESTR,REMOTE ONLINE DEPOSIT # 1,CHASE ENDING IN 5315,Donations directed by individuals,"$1,000.00 ","$817,069.96 "
Donations directed by individuals,9/26/23,Deposit,1,02 GENERAL BANK URESTR,REMOTE ONLINE DEPOSIT # 1,Contributed income:Donations directed by individuals,CHASE ENDING IN 5315,"$1,000.00 ","$818,069.96 "
PayPal Bank 3,9/25/23,Deposit,4XL61521SP408000J,09 MSU RESTR,"Subject: MobileShowers
Transaction ID: 4XL61521SP408000J
https://www.paypal.com/activity/payment/4XL61521SP408000J",PayPal Bank 3,--,$10.00 ,"$818,079.96 "
Donations directed by individuals,9/25/23,Deposit,4XL61521SP408000J,09 MSU RESTR,Mobile Shower/Laundry Units - Mobile Shower/Laundry Units,Contributed income:Donations directed by individuals,PayPal Bank 3,$10.70 ,"$818,090.66 "
PayPal Fees,9/25/23,Deposit,4XL61521SP408000J,09 MSU RESTR,PayPal fees,OFFICE/GENERAL ADMINISTRATIVE EXPENSES:PayPal Fees,PayPal Bank 3,$0.70 ,"$818,091.36 "
CHASE ENDING IN 5315,9/25/23,Deposit,1,02 GENERAL BANK URESTR,REMOTE ONLINE DEPOSIT # 1,CHASE ENDING IN 5315,Donations directed by individuals,"$15,000.00 ","$833,091.36 "
Donations directed by individuals,9/25/23,Deposit,1,02 GENERAL BANK URESTR,REMOTE ONLINE DEPOSIT # 1,Contributed income:Donations directed by individuals,CHASE ENDING IN 5315,"$15,000.00 ","$848,091.36 "
CHASE ENDING IN 5315,9/25/23,Deposit,1,02 GENERAL BANK URESTR,REMOTE ONLINE DEPOSIT # 1,CHASE ENDING IN 5315,Donations directed by individuals,$145.00 ,"$848,236.36 "
Donations directed by individuals,9/25/23,Deposit,1,02 GENERAL BANK URESTR,REMOTE ONLINE DEPOSIT # 1,Contributed income:Donations directed by individuals,CHASE ENDING IN 5315,$145.00 ,"$848,381.36 "
CHASE ENDING IN 5315,9/25/23,Deposit,1,02 GENERAL BANK URESTR,REMOTE ONLINE DEPOSIT # 1,CHASE ENDING IN 5315,Donations directed by individuals,$100.00 ,"$848,481.36 "
Donations directed by individuals,9/25/23,Deposit,1,02 GENERAL BANK URESTR,REMOTE ONLINE DEPOSIT # 1,Contributed income:Donations directed by individuals,CHASE ENDING IN 5315,$100.00 ,"$848,581.36 "
PayPal Bank 3,9/24/23,Deposit,7M796382MN365154A,10 Flight to Recovery RESTR,"Subject: Flight to Recovery
Transaction ID: 7M796382MN365154A
https://www.paypal.com/activity/payment/7M796382MN365154A",PayPal Bank 3,--,$50.00 ,"$848,631.36 "
Donations directed by individuals,9/24/23,Deposit,7M796382MN365154A,10 Flight to Recovery RESTR,Money in to PayPal,Contributed income:Donations directed by individuals,PayPal Bank 3,$51.52 ,"$848,682.88 "
PayPal Fees,9/24/23,Deposit,7M796382MN365154A,10 Flight to Recovery RESTR,PayPal fees,OFFICE/GENERAL ADMINISTRATIVE EXPENSES:PayPal Fees,PayPal Bank 3,$1.52 ,"$848,684.40 "
PayPal Bank 3,9/24/23,Deposit,8NE88802WA9924733,07 1000 DRONES RESTR,"Subject: 1000DRONES
Transaction ID: 8NE88802WA9924733
https://www.paypal.com/activity/payment/8NE88802WA9924733",PayPal Bank 3,--,$97.52 ,"$848,781.92 "
Donations directed by individuals,9/24/23,Deposit,8NE88802WA9924733,07 1000 DRONES RESTR,1000 DRONES FOR UKRAINE - 1000 DRONES FOR UKRAINE,Contributed income:Donations directed by individuals,PayPal Bank 3,$100.00 ,"$848,881.92 "
PayPal Fees,9/24/23,Deposit,8NE88802WA9924733,07 1000 DRONES RESTR,PayPal fees,OFFICE/GENERAL ADMINISTRATIVE EXPENSES:PayPal Fees,PayPal Bank 3,$2.48 ,"$848,884.40 "
PayPal Bank 3,9/24/23,Deposit,1UH573584J5864809,08 VICTORY DRONES RESTR,"Subject: VictoryDrones
Transaction ID: 1UH573584J5864809
https://www.paypal.com/activity/payment/1UH573584J5864809",PayPal Bank 3,--,$100.00 ,"$848,984.40 "
Donations directed by individuals,9/24/23,Deposit,1UH573584J5864809,08 VICTORY DRONES RESTR,VICTORY DRONES - VICTORY DRONES,Contributed income:Donations directed by individuals,PayPal Bank 3,$102.53 ,"$849,086.93 "
PayPal Fees,9/24/23,Deposit,1UH573584J5864809,08 VICTORY DRONES RESTR,PayPal fees,OFFICE/GENERAL ADMINISTRATIVE EXPENSES:PayPal Fees,PayPal Bank 3,$2.53 ,"$849,089.46 "
PayPal Bank 3,9/24/23,Deposit,0A817348YU943472D,07 1000 DRONES RESTR,"Subject: 1000DRONES
Note: Слава Україні !
Transaction ID: 0A817348YU943472D
https://www.paypal.com/activity/payment/0A817348YU943472D",PayPal Bank 3,--,$492.34 ,"$849,581.80 "
Donations directed by individuals,9/24/23,Deposit,0A817348YU943472D,07 1000 DRONES RESTR,1000 DRONES FOR UKRAINE - 1000 DRONES FOR UKRAINE,Contributed income:Donations directed by individuals,PayPal Bank 3,$510.65 ,"$850,092.45 "
PayPal Fees,9/24/23,Deposit,0A817348YU943472D,07 1000 DRONES RESTR,PayPal fees,OFFICE/GENERAL ADMINISTRATIVE EXPENSES:PayPal Fees,PayPal Bank 3,$18.31 ,"$850,110.76 "
PayPal Bank 3,9/24/23,Deposit,3BS11949HT7609146,04 PAYPAL GENERAL UNRESTR,"Subject: GeneralPage
Transaction ID: 3BS11949HT7609146
https://www.paypal.com/activity/payment/3BS11949HT7609146",PayPal Bank 3,--,$300.00 ,"$850,410.76 "
Donations directed by individuals,9/24/23,Deposit,3BS11949HT7609146,04 PAYPAL GENERAL UNRESTR,Support Ukraine - Support Ukraine,Contributed income:Donations directed by individuals,PayPal Bank 3,$306.59 ,"$850,717.35 "
PayPal Fees,9/24/23,Deposit,3BS11949HT7609146,04 PAYPAL GENERAL UNRESTR,PayPal fees,OFFICE/GENERAL ADMINISTRATIVE EXPENSES:PayPal Fees,PayPal Bank 3,$6.59 ,"$850,723.94 "
PayPal Bank 3,9/24/23,Deposit,3KP38498MG0543408,11 VETERANIUS RESTR,"Subject: Veteranius
Transaction ID: 3KP38498MG0543408
https://www.paypal.com/activity/payment/3KP38498MG0543408",PayPal Bank 3,--,$29.53 ,"$850,753.47 "
Donations directed by individuals,9/24/23,Deposit,3KP38498MG0543408,11 VETERANIUS RESTR,Veteranius - helping veterans to learn and gain experience in IT. - Veteranius - helping veterans to learn and gain experience in IT.,Contributed income:Donations directed by individuals,PayPal Bank 3,$31.11 ,"$850,784.58 "
PayPal Fees,9/24/23,Deposit,3KP38498MG0543408,11 VETERANIUS RESTR,PayPal fees,OFFICE/GENERAL ADMINISTRATIVE EXPENSES:PayPal Fees,PayPal Bank 3,$1.58 ,"$850,786.16 "
CHASE ENDING IN 5315,9/24/23,Expense,--,02 GENERAL BANK URESTR,Zelle payment to Gadzhi Kuliev JPM99a2kmzdd,CHASE ENDING IN 5315,TRANSPORTATION AND PARKING,($134.00),"$850,652.16 "
TRANSPORTATION AND PARKING,9/24/23,Expense,--,02 GENERAL BANK URESTR,Zelle payment to Gadzhi Kuliev JPM99a2kmzdd,FUNDRAISING EVENTS:TRANSPORTATION AND PARKING,CHASE ENDING IN 5315,$134.00 ,"$850,786.16 "
CHASE ENDING IN 5315,9/24/23,Expense,--,02 GENERAL BANK URESTR,Zelle payment to Maryna Akatova XXXXXXX1512,CHASE ENDING IN 5315,--,($262.27),"$850,523.89 "
EVENTS PARTICIPATION EXPENSES,9/24/23,Expense,--,02 GENERAL BANK URESTR,Zelle payment to Maryna Akatova XXXXXXX1512,FUNDRAISING EVENTS:EVENTS PARTICIPATION EXPENSES,CHASE ENDING IN 5315,$210.00 ,"$850,733.89 "
SUPPLIES AND MATERIALS,9/24/23,Expense,--,02 GENERAL BANK URESTR,Zelle payment to Maryna Akatova XXXXXXX1512,FUNDRAISING EVENTS:SUPPLIES AND MATERIALS,CHASE ENDING IN 5315,$52.27 ,"$850,786.16 "
CHASE ENDING IN 5315,9/24/23,Expense,--,02 GENERAL BANK URESTR,Zelle payment to Oksana Patrina XXXXXXX9663,CHASE ENDING IN 5315,--,($552.87),"$850,233.29 "
SUPPLIES AND MATERIALS,9/24/23,Expense,--,02 GENERAL BANK URESTR,Serduchka Hat  Zelle payment to Oksana Patrina XXXXXXX9663,FUNDRAISING EVENTS:SUPPLIES AND MATERIALS,CHASE ENDING IN 5315,$502.00 ,"$850,735.29 "
SUPPLIES AND MATERIALS,9/24/23,Expense,--,02 GENERAL BANK URESTR,Flyers Zelle payment to Oksana Patrina XXXXXXX9663,FUNDRAISING EVENTS:SUPPLIES AND MATERIALS,CHASE ENDING IN 5315,$50.87 ,"$850,786.16 "
CHASE ENDING IN 5315,9/24/23,Expense,--,02 GENERAL BANK URESTR,Zelle payment to Oksana Patrina XXXXXXX9494,CHASE ENDING IN 5315,--,($275.24),"$850,510.92 "
SUPPLIES AND MATERIALS,9/24/23,Expense,--,02 GENERAL BANK URESTR,Ukrainian Flags and American Flag Postcards,FUNDRAISING EVENTS:SUPPLIES AND MATERIALS,CHASE ENDING IN 5315,$58.70 ,"$850,569.62 "
Software & apps,9/24/23,Expense,--,02 GENERAL BANK URESTR,Quickbooks June & July 202392,OFFICE/GENERAL ADMINISTRATIVE EXPENSES:Software & apps,CHASE ENDING IN 5315,$92.54 ,"$850,662.16 "
MALING AND DELIVERY,9/24/23,Expense,--,02 GENERAL BANK URESTR,P.O. Box in Brooklyn Zelle payment to Oksana Patrina XXXXXXX9494,OFFICE/GENERAL ADMINISTRATIVE EXPENSES:MALING AND DELIVERY,CHASE ENDING IN 5315,$124.00 ,"$850,786.16 "
CHASE ENDING IN 5315,9/24/23,Expense,--,02 GENERAL BANK URESTR,Zelle payment to Yuliya O'Connell XXXXXXX6718,CHASE ENDING IN 5315,SUPPLIES AND MATERIALS,"($1,316.61)","$849,469.55 "
SUPPLIES AND MATERIALS,9/24/23,Expense,--,02 GENERAL BANK URESTR,Zelle payment to Yuliya O'Connell XXXXXXX6718,FUNDRAISING EVENTS:SUPPLIES AND MATERIALS,CHASE ENDING IN 5315,"$1,316.61 ","$850,786.16 "
PayPal Bank 3,9/23/23,Deposit,3UP18969128368342,04 PAYPAL GENERAL UNRESTR,"Subject: GeneralPage
Transaction ID: 3UP18969128368342
https://www.paypal.com/activity/payment/3UP18969128368342",PayPal Bank 3,--,$25.00 ,"$850,811.16 "
Donations directed by individuals,9/23/23,Deposit,3UP18969128368342,04 PAYPAL GENERAL UNRESTR,Support Ukraine - Support Ukraine,Contributed income:Donations directed by individuals,PayPal Bank 3,$26.25 ,"$850,837.41 "
PayPal Fees,9/23/23,Deposit,3UP18969128368342,04 PAYPAL GENERAL UNRESTR,PayPal fees,OFFICE/GENERAL ADMINISTRATIVE EXPENSES:PayPal Fees,PayPal Bank 3,$1.25 ,"$850,838.66 "
PayPal Bank 3,9/23/23,Deposit,3GN92325HE000703N,08 VICTORY DRONES RESTR,"Subject: VictoryDrones
Transaction ID: 3GN92325HE000703N
https://www.paypal.com/activity/payment/3GN92325HE000703N",PayPal Bank 3,--,$9.84 ,"$850,848.50 "
Donations directed by individuals,9/23/23,Deposit,3GN92325HE000703N,08 VICTORY DRONES RESTR,VICTORY DRONES - VICTORY DRONES,Contributed income:Donations directed by individuals,PayPal Bank 3,$10.80 ,"$850,859.30 "
PayPal Fees,9/23/23,Deposit,3GN92325HE000703N,08 VICTORY DRONES RESTR,PayPal fees,OFFICE/GENERAL ADMINISTRATIVE EXPENSES:PayPal Fees,PayPal Bank 3,$0.96 ,"$850,860.26 "
PayPal Bank 3,9/23/23,Deposit,6WL49013TG5650535,04 PAYPAL GENERAL UNRESTR,"Subject: GeneralPage
Transaction ID: 6WL49013TG5650535
https://www.paypal.com/activity/payment/6WL49013TG5650535",PayPal Bank 3,--,$209.85 ,"$851,070.11 "
Donations directed by individuals,9/23/23,Deposit,6WL49013TG5650535,04 PAYPAL GENERAL UNRESTR,Support Ukraine - Support Ukraine,Contributed income:Donations directed by individuals,PayPal Bank 3,$220.00 ,"$851,290.11 "
PayPal Fees,9/23/23,Deposit,6WL49013TG5650535,04 PAYPAL GENERAL UNRESTR,PayPal fees,OFFICE/GENERAL ADMINISTRATIVE EXPENSES:PayPal Fees,PayPal Bank 3,$10.15 ,"$851,300.26 "
PayPal Bank 3,9/23/23,Deposit,6SJ99472LV630953D,04 PAYPAL GENERAL UNRESTR,"Subject: GeneralPage
Transaction ID: 6SJ99472LV630953D
https://www.paypal.com/activity/payment/6SJ99472LV630953D",PayPal Bank 3,--,$10.00 ,"$851,310.26 "
Donations directed by individuals,9/23/23,Deposit,6SJ99472LV630953D,04 PAYPAL GENERAL UNRESTR,Support Ukraine - Support Ukraine,Contributed income:Donations directed by individuals,PayPal Bank 3,$10.80 ,"$851,321.06 "
PayPal Fees,9/23/23,Deposit,6SJ99472LV630953D,04 PAYPAL GENERAL UNRESTR,PayPal fees,OFFICE/GENERAL ADMINISTRATIVE EXPENSES:PayPal Fees,PayPal Bank 3,$0.80 ,"$851,321.86 "
PayPal Bank 3,9/23/23,Deposit,69D4654124493931E,04 PAYPAL GENERAL UNRESTR,"Subject: GeneralPage
Transaction ID: 69D4654124493931E
https://www.paypal.com/activity/payment/69D4654124493931E",PayPal Bank 3,--,$2.38 ,"$851,324.24 "
Donations directed by individuals,9/23/23,Deposit,69D4654124493931E,04 PAYPAL GENERAL UNRESTR,Support Ukraine - Support Ukraine,Contributed income:Donations directed by individuals,PayPal Bank 3,$3.00 ,"$851,327.24 "
PayPal Fees,9/23/23,Deposit,69D4654124493931E,04 PAYPAL GENERAL UNRESTR,PayPal fees,OFFICE/GENERAL ADMINISTRATIVE EXPENSES:PayPal Fees,PayPal Bank 3,$0.62 ,"$851,327.86 "
PayPal Bank 3,9/23/23,Deposit,46U34802MG248864U,04 PAYPAL GENERAL UNRESTR,"Transaction ID: 46U34802MG248864U
https://www.paypal.com/activity/payment/46U34802MG248864U",PayPal Bank 3,--,$4.78 ,"$851,332.64 "
Donations directed by individuals,9/23/23,Deposit,46U34802MG248864U,04 PAYPAL GENERAL UNRESTR,Money in to PayPal,Contributed income:Donations directed by individuals,PayPal Bank 3,$5.00 ,"$851,337.64 "
PayPal Fees,9/23/23,Deposit,46U34802MG248864U,04 PAYPAL GENERAL UNRESTR,PayPal fees,OFFICE/GENERAL ADMINISTRATIVE EXPENSES:PayPal Fees,PayPal Bank 3,$0.22 ,"$851,337.86 "
PayPal Bank 3,9/23/23,Deposit,3AC82357XC312483A,04 PAYPAL GENERAL UNRESTR,"Subject: GeneralPage
Note: Charitable donation to Ukrainian military
Transaction ID: 3AC82357XC312483A
https://www.paypal.com/activity/payment/3AC82357XC312483A",PayPal Bank 3,--,$147.68 ,"$851,485.54 "
Donations directed by individuals,9/23/23,Deposit,3AC82357XC312483A,04 PAYPAL GENERAL UNRESTR,Support Ukraine - Support Ukraine,Contributed income:Donations directed by individuals,PayPal Bank 3,$154.97 ,"$851,640.51 "
PayPal Fees,9/23/23,Deposit,3AC82357XC312483A,04 PAYPAL GENERAL UNRESTR,PayPal fees,OFFICE/GENERAL ADMINISTRATIVE EXPENSES:PayPal Fees,PayPal Bank 3,$7.29 ,"$851,647.80 "
PayPal Bank 3,9/23/23,Deposit,21B17863Y1597791L,07 1000 DRONES RESTR,"Subject: 1000DRONES
Transaction ID: 21B17863Y1597791L
https://www.paypal.com/activity/payment/21B17863Y1597791L",PayPal Bank 3,--,$100.00 ,"$851,747.80 "
Donations directed by individuals,9/23/23,Deposit,21B17863Y1597791L,07 1000 DRONES RESTR,1000 DRONES FOR UKRAINE - 1000 DRONES FOR UKRAINE,Contributed income:Donations directed by individuals,PayPal Bank 3,$103.48 ,"$851,851.28 "
PayPal Fees,9/23/23,Deposit,21B17863Y1597791L,07 1000 DRONES RESTR,PayPal fees,OFFICE/GENERAL ADMINISTRATIVE EXPENSES:PayPal Fees,PayPal Bank 3,$3.48 ,"$851,854.76 "
PayPal Bank 3,9/23/23,Deposit,8R021585R7699960A,04 PAYPAL GENERAL UNRESTR,"Subject: GeneralPage
Transaction ID: 8R021585R7699960A
https://www.paypal.com/activity/payment/8R021585R7699960A",PayPal Bank 3,--,$14.76 ,"$851,869.52 "
Donations directed by individuals,9/23/23,Deposit,8R021585R7699960A,04 PAYPAL GENERAL UNRESTR,Support Ukraine - Support Ukraine,Contributed income:Donations directed by individuals,PayPal Bank 3,$15.95 ,"$851,885.47 "
PayPal Fees,9/23/23,Deposit,8R021585R7699960A,04 PAYPAL GENERAL UNRESTR,PayPal fees,OFFICE/GENERAL ADMINISTRATIVE EXPENSES:PayPal Fees,PayPal Bank 3,$1.19 ,"$851,886.66 "
PayPal Bank 3,9/23/23,Deposit,7E355680R3840503A,04 PAYPAL GENERAL UNRESTR,"Subject: GeneralPage
Transaction ID: 7E355680R3840503A
https://www.paypal.com/activity/payment/7E355680R3840503A",PayPal Bank 3,--,$70.00 ,"$851,956.66 "
Donations directed by individuals,9/23/23,Deposit,7E355680R3840503A,04 PAYPAL GENERAL UNRESTR,Support Ukraine - Support Ukraine,Contributed income:Donations directed by individuals,PayPal Bank 3,$72.59 ,"$852,029.25 "
PayPal Fees,9/23/23,Deposit,7E355680R3840503A,04 PAYPAL GENERAL UNRESTR,PayPal fees,OFFICE/GENERAL ADMINISTRATIVE EXPENSES:PayPal Fees,PayPal Bank 3,$2.59 ,"$852,031.84 "
PayPal Bank 3,9/23/23,Deposit,1RF75633TC162325B,04 PAYPAL GENERAL UNRESTR,"Subject: GeneralPage
Transaction ID: 1RF75633TC162325B
https://www.paypal.com/activity/payment/1RF75633TC162325B",PayPal Bank 3,--,$25.00 ,"$852,056.84 "
Donations directed by individuals,9/23/23,Deposit,1RF75633TC162325B,04 PAYPAL GENERAL UNRESTR,Support Ukraine - Support Ukraine,Contributed income:Donations directed by individuals,PayPal Bank 3,$26.25 ,"$852,083.09 "
PayPal Fees,9/23/23,Deposit,1RF75633TC162325B,04 PAYPAL GENERAL UNRESTR,PayPal fees,OFFICE/GENERAL ADMINISTRATIVE EXPENSES:PayPal Fees,PayPal Bank 3,$1.25 ,"$852,084.34 "
PayPal Bank 3,9/23/23,Deposit,0FN80305486194315,04 PAYPAL GENERAL UNRESTR,"Subject: GeneralPage
Transaction ID: 0FN80305486194315
https://www.paypal.com/activity/payment/0FN80305486194315",PayPal Bank 3,--,$477.56 ,"$852,561.90 "
Donations directed by individuals,9/23/23,Deposit,0FN80305486194315,04 PAYPAL GENERAL UNRESTR,Support Ukraine - Support Ukraine,Contributed income:Donations directed by individuals,PayPal Bank 3,$500.00 ,"$853,061.90 "
PayPal Fees,9/23/23,Deposit,0FN80305486194315,04 PAYPAL GENERAL UNRESTR,PayPal fees,OFFICE/GENERAL ADMINISTRATIVE EXPENSES:PayPal Fees,PayPal Bank 3,$22.44 ,"$853,084.34 "
PayPal Bank 3,9/23/23,Deposit,55P436038B209180R,04 PAYPAL GENERAL UNRESTR,"Subject: Support Ukraine
Transaction ID: 55P436038B209180R
https://www.paypal.com/activity/payment/55P436038B209180R",PayPal Bank 3,--,$29.53 ,"$853,113.87 "
Donations directed by individuals,9/23/23,Deposit,55P436038B209180R,04 PAYPAL GENERAL UNRESTR,Money in to PayPal,Contributed income:Donations directed by individuals,PayPal Bank 3,$31.40 ,"$853,145.27 "
PayPal Fees,9/23/23,Deposit,55P436038B209180R,04 PAYPAL GENERAL UNRESTR,PayPal fees,OFFICE/GENERAL ADMINISTRATIVE EXPENSES:PayPal Fees,PayPal Bank 3,$1.87 ,"$853,147.14 "
PayPal Bank 3,9/23/23,Deposit,7EJ10983UP137745A,04 PAYPAL GENERAL UNRESTR,"Subject: GeneralPage
Transaction ID: 7EJ10983UP137745A
https://www.paypal.com/activity/payment/7EJ10983UP137745A",PayPal Bank 3,--,$18.63 ,"$853,165.77 "
Donations directed by individuals,9/23/23,Deposit,7EJ10983UP137745A,04 PAYPAL GENERAL UNRESTR,Support Ukraine - Support Ukraine,Contributed income:Donations directed by individuals,PayPal Bank 3,$20.00 ,"$853,185.77 "
PayPal Fees,9/23/23,Deposit,7EJ10983UP137745A,04 PAYPAL GENERAL UNRESTR,PayPal fees,OFFICE/GENERAL ADMINISTRATIVE EXPENSES:PayPal Fees,PayPal Bank 3,$1.37 ,"$853,187.14 "
PayPal Bank 3,9/23/23,Deposit,290889795V280824N,04 PAYPAL GENERAL UNRESTR,"Subject: GeneralPage
Transaction ID: 290889795V280824N
https://www.paypal.com/activity/payment/290889795V280824N",PayPal Bank 3,--,$397.66 ,"$853,584.80 "
Donations directed by individuals,9/23/23,Deposit,290889795V280824N,04 PAYPAL GENERAL UNRESTR,Support Ukraine - Support Ukraine,Contributed income:Donations directed by individuals,PayPal Bank 3,$410.00 ,"$853,994.80 "
PayPal Fees,9/23/23,Deposit,290889795V280824N,04 PAYPAL GENERAL UNRESTR,PayPal fees,OFFICE/GENERAL ADMINISTRATIVE EXPENSES:PayPal Fees,PayPal Bank 3,$12.34 ,"$854,007.14 "
PayPal Bank 3,9/23/23,Deposit,06603290RE9463611,04 PAYPAL GENERAL UNRESTR,"Subject: GeneralPage
Transaction ID: 06603290RE9463611
https://www.paypal.com/activity/payment/06603290RE9463611",PayPal Bank 3,--,$39.37 ,"$854,046.51 "
Donations directed by individuals,9/23/23,Deposit,06603290RE9463611,04 PAYPAL GENERAL UNRESTR,Support Ukraine - Support Ukraine,Contributed income:Donations directed by individuals,PayPal Bank 3,$41.69 ,"$854,088.20 "
PayPal Fees,9/23/23,Deposit,06603290RE9463611,04 PAYPAL GENERAL UNRESTR,PayPal fees,OFFICE/GENERAL ADMINISTRATIVE EXPENSES:PayPal Fees,PayPal Bank 3,$2.32 ,"$854,090.52 "
PayPal Bank 3,9/23/23,Deposit,990951073G3350639,07 1000 DRONES RESTR,"Subject: 1000DRONES
Transaction ID: 990951073G3350639
https://www.paypal.com/activity/payment/990951073G3350639",PayPal Bank 3,--,$50.00 ,"$854,140.52 "
Donations directed by individuals,9/23/23,Deposit,990951073G3350639,07 1000 DRONES RESTR,1000 DRONES FOR UKRAINE - 1000 DRONES FOR UKRAINE,Contributed income:Donations directed by individuals,PayPal Bank 3,$51.99 ,"$854,192.51 "
PayPal Fees,9/23/23,Deposit,990951073G3350639,07 1000 DRONES RESTR,PayPal fees,OFFICE/GENERAL ADMINISTRATIVE EXPENSES:PayPal Fees,PayPal Bank 3,$1.99 ,"$854,194.50 "
PayPal Bank 3,9/23/23,Deposit,2UM61030UF0951632,07 1000 DRONES RESTR,"Subject: 1000DRONES
Transaction ID: 2UM61030UF0951632
https://www.paypal.com/activity/payment/2UM61030UF0951632",PayPal Bank 3,--,$18.63 ,"$854,213.13 "
Donations directed by individuals,9/23/23,Deposit,2UM61030UF0951632,07 1000 DRONES RESTR,1000 DRONES FOR UKRAINE - 1000 DRONES FOR UKRAINE,Contributed income:Donations directed by individuals,PayPal Bank 3,$20.00 ,"$854,233.13 "
PayPal Fees,9/23/23,Deposit,2UM61030UF0951632,07 1000 DRONES RESTR,PayPal fees,OFFICE/GENERAL ADMINISTRATIVE EXPENSES:PayPal Fees,PayPal Bank 3,$1.37 ,"$854,234.50 "
PayPal Bank 3,9/23/23,Deposit,66L69202LD6818352,07 1000 DRONES RESTR,"Subject: GeneralPage
Note: На люті пташки���
Transaction ID: 66L69202LD6818352
https://www.paypal.com/activity/payment/66L69202LD6818352",PayPal Bank 3,--,$95.12 ,"$854,329.62 "
Donations directed by individuals,9/23/23,Deposit,66L69202LD6818352,07 1000 DRONES RESTR,Support Ukraine - Support Ukraine,Contributed income:Donations directed by individuals,PayPal Bank 3,$100.00 ,"$854,429.62 "
PayPal Fees,9/23/23,Deposit,66L69202LD6818352,07 1000 DRONES RESTR,PayPal fees,OFFICE/GENERAL ADMINISTRATIVE EXPENSES:PayPal Fees,PayPal Bank 3,$4.88 ,"$854,434.50 "
PayPal Bank 3,9/23/23,Deposit,3M837784BL983715T,04 PAYPAL GENERAL UNRESTR,"Subject: GeneralPage
Transaction ID: 3M837784BL983715T
https://www.paypal.com/activity/payment/3M837784BL983715T",PayPal Bank 3,--,$18.63 ,"$854,453.13 "
Donations directed by individuals,9/23/23,Deposit,3M837784BL983715T,04 PAYPAL GENERAL UNRESTR,Support Ukraine - Support Ukraine,Contributed income:Donations directed by individuals,PayPal Bank 3,$20.00 ,"$854,473.13 "
PayPal Fees,9/23/23,Deposit,3M837784BL983715T,04 PAYPAL GENERAL UNRESTR,PayPal fees,OFFICE/GENERAL ADMINISTRATIVE EXPENSES:PayPal Fees,PayPal Bank 3,$1.37 ,"$854,474.50 "
PayPal Bank 3,9/23/23,Deposit,13487489GA0073815,10 Flight to Recovery RESTR,"Subject: Dignitas Ukraine Flight to Recovery
Transaction ID: 13487489GA0073815
https://www.paypal.com/activity/payment/13487489GA0073815",PayPal Bank 3,--,$98.45 ,"$854,572.95 "
Donations directed by individuals,9/23/23,Deposit,13487489GA0073815,10 Flight to Recovery RESTR,Money in to PayPal,Contributed income:Donations directed by individuals,PayPal Bank 3,$103.48 ,"$854,676.43 "
PayPal Fees,9/23/23,Deposit,13487489GA0073815,10 Flight to Recovery RESTR,PayPal fees,OFFICE/GENERAL ADMINISTRATIVE EXPENSES:PayPal Fees,PayPal Bank 3,$5.03 ,"$854,681.46 "
PayPal Bank 3,9/23/23,Deposit,0P957377CJ324634M,08 VICTORY DRONES RESTR,"Subject: VICTORY DRONES
Transaction ID: 0P957377CJ324634M
https://www.paypal.com/activity/payment/0P957377CJ324634M",PayPal Bank 3,--,$98.45 ,"$854,779.91 "
Donations directed by individuals,9/23/23,Deposit,0P957377CJ324634M,08 VICTORY DRONES RESTR,Money in to PayPal,Contributed income:Donations directed by individuals,PayPal Bank 3,$103.48 ,"$854,883.39 "
PayPal Fees,9/23/23,Deposit,0P957377CJ324634M,08 VICTORY DRONES RESTR,PayPal fees,OFFICE/GENERAL ADMINISTRATIVE EXPENSES:PayPal Fees,PayPal Bank 3,$5.03 ,"$854,888.42 "
PayPal Bank 3,9/23/23,Deposit,0UD55820KM201731V,04 PAYPAL GENERAL UNRESTR,"Subject: GeneralPage
Transaction ID: 0UD55820KM201731V
https://www.paypal.com/activity/payment/0UD55820KM201731V",PayPal Bank 3,--,$984.54 ,"$855,872.96 "
Donations directed by individuals,9/23/23,Deposit,0UD55820KM201731V,04 PAYPAL GENERAL UNRESTR,Support Ukraine - Support Ukraine,Contributed income:Donations directed by individuals,PayPal Bank 3,"$1,030.26 ","$856,903.22 "
PayPal Fees,9/23/23,Deposit,0UD55820KM201731V,04 PAYPAL GENERAL UNRESTR,PayPal fees,OFFICE/GENERAL ADMINISTRATIVE EXPENSES:PayPal Fees,PayPal Bank 3,$45.72 ,"$856,948.94 "
PayPal Bank 3,9/23/23,Deposit,545273715P3882818,04 PAYPAL GENERAL UNRESTR,"Subject: GeneralPage
Transaction ID: 545273715P3882818
https://www.paypal.com/activity/payment/545273715P3882818",PayPal Bank 3,--,$18.63 ,"$856,967.57 "
Donations directed by individuals,9/23/23,Deposit,545273715P3882818,04 PAYPAL GENERAL UNRESTR,Support Ukraine - Support Ukraine,Contributed income:Donations directed by individuals,PayPal Bank 3,$20.00 ,"$856,987.57 "
PayPal Fees,9/23/23,Deposit,545273715P3882818,04 PAYPAL GENERAL UNRESTR,PayPal fees,OFFICE/GENERAL ADMINISTRATIVE EXPENSES:PayPal Fees,PayPal Bank 3,$1.37 ,"$856,988.94 "
PayPal Bank 3,9/23/23,Deposit,87696919H27814213,09 MSU RESTR,"Subject: Dignitas Ukraine Flight to Recovery
Transaction ID: 87696919H27814213
https://www.paypal.com/activity/payment/87696919H27814213",PayPal Bank 3,--,$50.00 ,"$857,038.94 "
Donations directed by individuals,9/23/23,Deposit,87696919H27814213,09 MSU RESTR,Money in to PayPal,Contributed income:Donations directed by individuals,PayPal Bank 3,$51.99 ,"$857,090.93 "
PayPal Fees,9/23/23,Deposit,87696919H27814213,09 MSU RESTR,PayPal fees,OFFICE/GENERAL ADMINISTRATIVE EXPENSES:PayPal Fees,PayPal Bank 3,$1.99 ,"$857,092.92 "
PayPal Bank 3,9/23/23,Deposit,0PG03801L30768224,08 VICTORY DRONES RESTR,"Subject: VictoryDrones
Transaction ID: 0PG03801L30768224
https://www.paypal.com/activity/payment/0PG03801L30768224",PayPal Bank 3,--,$100.00 ,"$857,192.92 "
Donations directed by individuals,9/23/23,Deposit,0PG03801L30768224,08 VICTORY DRONES RESTR,VICTORY DRONES - VICTORY DRONES,Contributed income:Donations directed by individuals,PayPal Bank 3,$103.48 ,"$857,296.40 "
PayPal Fees,9/23/23,Deposit,0PG03801L30768224,08 VICTORY DRONES RESTR,PayPal fees,OFFICE/GENERAL ADMINISTRATIVE EXPENSES:PayPal Fees,PayPal Bank 3,$3.48 ,"$857,299.88 "
PayPal Bank 3,9/23/23,Deposit,55F66519NV265735R,07 1000 DRONES RESTR,"Subject: 1000DRONES
Transaction ID: 55F66519NV265735R
https://www.paypal.com/activity/payment/55F66519NV265735R",PayPal Bank 3,--,$48.06 ,"$857,347.94 "
Donations directed by individuals,9/23/23,Deposit,55F66519NV265735R,07 1000 DRONES RESTR,1000 DRONES FOR UKRAINE - 1000 DRONES FOR UKRAINE,Contributed income:Donations directed by individuals,PayPal Bank 3,$50.00 ,"$857,397.94 "
PayPal Fees,9/23/23,Deposit,55F66519NV265735R,07 1000 DRONES RESTR,PayPal fees,OFFICE/GENERAL ADMINISTRATIVE EXPENSES:PayPal Fees,PayPal Bank 3,$1.94 ,"$857,399.88 "
PayPal Bank 3,9/23/23,Deposit,2HP01481S8513282K,10 Flight to Recovery RESTR,"Subject: MobileShowers
Transaction ID: 2HP01481S8513282K
https://www.paypal.com/activity/payment/2HP01481S8513282K",PayPal Bank 3,--,$50.00 ,"$857,449.88 "
Donations directed by individuals,9/23/23,Deposit,2HP01481S8513282K,10 Flight to Recovery RESTR,Mobile Shower/Laundry Units - Mobile Shower/Laundry Units,Contributed income:Donations directed by individuals,PayPal Bank 3,$51.99 ,"$857,501.87 "
PayPal Fees,9/23/23,Deposit,2HP01481S8513282K,10 Flight to Recovery RESTR,PayPal fees,OFFICE/GENERAL ADMINISTRATIVE EXPENSES:PayPal Fees,PayPal Bank 3,$1.99 ,"$857,503.86 "
PayPal Bank 3,9/23/23,Deposit,0RB00006G3649351G,11 VETERANIUS RESTR,"Subject: Veteranius
Transaction ID: 0RB00006G3649351G
https://www.paypal.com/activity/payment/0RB00006G3649351G",PayPal Bank 3,--,$51.00 ,"$857,554.86 "
Donations directed by individuals,9/23/23,Deposit,0RB00006G3649351G,11 VETERANIUS RESTR,Veteranius - helping veterans to learn and gain experience in IT. - Veteranius - helping veterans to learn and gain experience in IT.,Contributed income:Donations directed by individuals,PayPal Bank 3,$53.02 ,"$857,607.88 "
PayPal Fees,9/23/23,Deposit,0RB00006G3649351G,11 VETERANIUS RESTR,PayPal fees,OFFICE/GENERAL ADMINISTRATIVE EXPENSES:PayPal Fees,PayPal Bank 3,$2.02 ,"$857,609.90 "
PayPal Bank 3,9/23/23,Deposit,1X56207853018610B,04 PAYPAL GENERAL UNRESTR,"Subject: GeneralPage
Transaction ID: 1X56207853018610B
https://www.paypal.com/activity/payment/1X56207853018610B",PayPal Bank 3,--,$100.00 ,"$857,709.90 "
Donations directed by individuals,9/23/23,Deposit,1X56207853018610B,04 PAYPAL GENERAL UNRESTR,Support Ukraine - Support Ukraine,Contributed income:Donations directed by individuals,PayPal Bank 3,$103.48 ,"$857,813.38 "
PayPal Fees,9/23/23,Deposit,1X56207853018610B,04 PAYPAL GENERAL UNRESTR,PayPal fees,OFFICE/GENERAL ADMINISTRATIVE EXPENSES:PayPal Fees,PayPal Bank 3,$3.48 ,"$857,816.86 "
PayPal Bank 3,9/23/23,Deposit,3YY73431HJ848463Y,04 PAYPAL GENERAL UNRESTR,"Subject: GeneralPage
Transaction ID: 3YY73431HJ848463Y
https://www.paypal.com/activity/payment/3YY73431HJ848463Y",PayPal Bank 3,--,$49.22 ,"$857,866.08 "
Donations directed by individuals,9/23/23,Deposit,3YY73431HJ848463Y,04 PAYPAL GENERAL UNRESTR,Support Ukraine - Support Ukraine,Contributed income:Donations directed by individuals,PayPal Bank 3,$51.99 ,"$857,918.07 "
PayPal Fees,9/23/23,Deposit,3YY73431HJ848463Y,04 PAYPAL GENERAL UNRESTR,PayPal fees,OFFICE/GENERAL ADMINISTRATIVE EXPENSES:PayPal Fees,PayPal Bank 3,$2.77 ,"$857,920.84 "
PayPal Bank 3,9/23/23,Deposit,7338726109854425U,07 1000 DRONES RESTR,"Subject: GeneralPage
Note: Люті пташки�
Transaction ID: 7338726109854425U
https://www.paypal.com/activity/payment/7338726109854425U",PayPal Bank 3,--,$50.00 ,"$857,970.84 "
Donations directed by individuals,9/23/23,Deposit,7338726109854425U,07 1000 DRONES RESTR,Support Ukraine - Support Ukraine,Contributed income:Donations directed by individuals,PayPal Bank 3,$51.99 ,"$858,022.83 "
PayPal Fees,9/23/23,Deposit,7338726109854425U,07 1000 DRONES RESTR,PayPal fees,OFFICE/GENERAL ADMINISTRATIVE EXPENSES:PayPal Fees,PayPal Bank 3,$1.99 ,"$858,024.82 "
PayPal Bank 3,9/23/23,Deposit,4LX9193921784391G,04 PAYPAL GENERAL UNRESTR,"Subject: GeneralPage
Transaction ID: 4LX9193921784391G
https://www.paypal.com/activity/payment/4LX9193921784391G",PayPal Bank 3,--,$18.63 ,"$858,043.45 "
Donations directed by individuals,9/23/23,Deposit,4LX9193921784391G,04 PAYPAL GENERAL UNRESTR,Support Ukraine - Support Ukraine,Contributed income:Donations directed by individuals,PayPal Bank 3,$20.00 ,"$858,063.45 "
PayPal Fees,9/23/23,Deposit,4LX9193921784391G,04 PAYPAL GENERAL UNRESTR,PayPal fees,OFFICE/GENERAL ADMINISTRATIVE EXPENSES:PayPal Fees,PayPal Bank 3,$1.37 ,"$858,064.82 "
PayPal Bank 3,9/23/23,Deposit,7GV826784V6369926,04 PAYPAL GENERAL UNRESTR,"Subject: GeneralPage
Transaction ID: 7GV826784V6369926
https://www.paypal.com/activity/payment/7GV826784V6369926",PayPal Bank 3,--,$34.46 ,"$858,099.28 "
Donations directed by individuals,9/23/23,Deposit,7GV826784V6369926,04 PAYPAL GENERAL UNRESTR,Support Ukraine - Support Ukraine,Contributed income:Donations directed by individuals,PayPal Bank 3,$36.55 ,"$858,135.83 "
PayPal Fees,9/23/23,Deposit,7GV826784V6369926,04 PAYPAL GENERAL UNRESTR,PayPal fees,OFFICE/GENERAL ADMINISTRATIVE EXPENSES:PayPal Fees,PayPal Bank 3,$2.09 ,"$858,137.92 "
PayPal Bank 3,9/23/23,Deposit,1TS73153U1151683N,04 PAYPAL GENERAL UNRESTR,"Subject: GeneralPage
Transaction ID: 1TS73153U1151683N
https://www.paypal.com/activity/payment/1TS73153U1151683N",PayPal Bank 3,--,$19.68 ,"$858,157.60 "
Donations directed by individuals,9/23/23,Deposit,1TS73153U1151683N,04 PAYPAL GENERAL UNRESTR,Support Ukraine - Support Ukraine,Contributed income:Donations directed by individuals,PayPal Bank 3,$21.10 ,"$858,178.70 "
PayPal Fees,9/23/23,Deposit,1TS73153U1151683N,04 PAYPAL GENERAL UNRESTR,PayPal fees,OFFICE/GENERAL ADMINISTRATIVE EXPENSES:PayPal Fees,PayPal Bank 3,$1.42 ,"$858,180.12 "
PayPal Bank 3,9/23/23,Deposit,75624969NP341482Y,04 PAYPAL GENERAL UNRESTR,"Subject: GeneralPage
Transaction ID: 75624969NP341482Y
https://www.paypal.com/activity/payment/75624969NP341482Y",PayPal Bank 3,--,$29.53 ,"$858,209.65 "
Donations directed by individuals,9/23/23,Deposit,75624969NP341482Y,04 PAYPAL GENERAL UNRESTR,Support Ukraine - Support Ukraine,Contributed income:Donations directed by individuals,PayPal Bank 3,$31.40 ,"$858,241.05 "
PayPal Fees,9/23/23,Deposit,75624969NP341482Y,04 PAYPAL GENERAL UNRESTR,PayPal fees,OFFICE/GENERAL ADMINISTRATIVE EXPENSES:PayPal Fees,PayPal Bank 3,$1.87 ,"$858,242.92 "
PayPal Bank 3,9/23/23,Deposit,6LC22109DS786890T,07 1000 DRONES RESTR,"Subject: 1000DRONES
Transaction ID: 6LC22109DS786890T
https://www.paypal.com/activity/payment/6LC22109DS786890T",PayPal Bank 3,--,$98.45 ,"$858,341.37 "
Donations directed by individuals,9/23/23,Deposit,6LC22109DS786890T,07 1000 DRONES RESTR,1000 DRONES FOR UKRAINE - 1000 DRONES FOR UKRAINE,Contributed income:Donations directed by individuals,PayPal Bank 3,$103.48 ,"$858,444.85 "
PayPal Fees,9/23/23,Deposit,6LC22109DS786890T,07 1000 DRONES RESTR,PayPal fees,OFFICE/GENERAL ADMINISTRATIVE EXPENSES:PayPal Fees,PayPal Bank 3,$5.03 ,"$858,449.88 "
PayPal Bank 3,9/23/23,Deposit,8JU1864953532481E,04 PAYPAL GENERAL UNRESTR,"Subject: Support Ukraine
Transaction ID: 8JU1864953532481E
https://www.paypal.com/activity/payment/8JU1864953532481E",PayPal Bank 3,--,$4.29 ,"$858,454.17 "
Donations directed by individuals,9/23/23,Deposit,8JU1864953532481E,04 PAYPAL GENERAL UNRESTR,Money in to PayPal,Contributed income:Donations directed by individuals,PayPal Bank 3,$5.00 ,"$858,459.17 "
PayPal Fees,9/23/23,Deposit,8JU1864953532481E,04 PAYPAL GENERAL UNRESTR,PayPal fees,OFFICE/GENERAL ADMINISTRATIVE EXPENSES:PayPal Fees,PayPal Bank 3,$0.71 ,"$858,459.88 "
PayPal Bank 3,9/23/23,Deposit,3YT156715G838070F,04 PAYPAL GENERAL UNRESTR,"Subject: GeneralPage
Transaction ID: 3YT156715G838070F
https://www.paypal.com/activity/payment/3YT156715G838070F",PayPal Bank 3,--,$96.62 ,"$858,556.50 "
Donations directed by individuals,9/23/23,Deposit,3YT156715G838070F,04 PAYPAL GENERAL UNRESTR,Support Ukraine - Support Ukraine,Contributed income:Donations directed by individuals,PayPal Bank 3,$100.00 ,"$858,656.50 "
PayPal Fees,9/23/23,Deposit,3YT156715G838070F,04 PAYPAL GENERAL UNRESTR,PayPal fees,OFFICE/GENERAL ADMINISTRATIVE EXPENSES:PayPal Fees,PayPal Bank 3,$3.38 ,"$858,659.88 "
PayPal Bank 3,9/23/23,Deposit,2G772791CS9567322,04 PAYPAL GENERAL UNRESTR,"Subject: GeneralPage
Transaction ID: 2G772791CS9567322
https://www.paypal.com/activity/payment/2G772791CS9567322",PayPal Bank 3,--,$29.53 ,"$858,689.41 "
Donations directed by individuals,9/23/23,Deposit,2G772791CS9567322,04 PAYPAL GENERAL UNRESTR,Support Ukraine - Support Ukraine,Contributed income:Donations directed by individuals,PayPal Bank 3,$31.40 ,"$858,720.81 "
PayPal Fees,9/23/23,Deposit,2G772791CS9567322,04 PAYPAL GENERAL UNRESTR,PayPal fees,OFFICE/GENERAL ADMINISTRATIVE EXPENSES:PayPal Fees,PayPal Bank 3,$1.87 ,"$858,722.68 "
PayPal Bank 3,9/23/23,Deposit,2H173609DJ6741336,07 1000 DRONES RESTR,"Subject: 1000DRONES
Transaction ID: 2H173609DJ6741336
https://www.paypal.com/activity/payment/2H173609DJ6741336",PayPal Bank 3,--,$196.91 ,"$858,919.59 "
Donations directed by individuals,9/23/23,Deposit,2H173609DJ6741336,07 1000 DRONES RESTR,1000 DRONES FOR UKRAINE - 1000 DRONES FOR UKRAINE,Contributed income:Donations directed by individuals,PayPal Bank 3,$206.46 ,"$859,126.05 "
PayPal Fees,9/23/23,Deposit,2H173609DJ6741336,07 1000 DRONES RESTR,PayPal fees,OFFICE/GENERAL ADMINISTRATIVE EXPENSES:PayPal Fees,PayPal Bank 3,$9.55 ,"$859,135.60 "
PayPal Bank 3,9/23/23,Deposit,8JJ667856F822760R,04 PAYPAL GENERAL UNRESTR,"Subject: GeneralPage
Transaction ID: 8JJ667856F822760R
https://www.paypal.com/activity/payment/8JJ667856F822760R",PayPal Bank 3,--,$98.45 ,"$859,234.05 "
Donations directed by individuals,9/23/23,Deposit,8JJ667856F822760R,04 PAYPAL GENERAL UNRESTR,Support Ukraine - Support Ukraine,Contributed income:Donations directed by individuals,PayPal Bank 3,$103.48 ,"$859,337.53 "
PayPal Fees,9/23/23,Deposit,8JJ667856F822760R,04 PAYPAL GENERAL UNRESTR,PayPal fees,OFFICE/GENERAL ADMINISTRATIVE EXPENSES:PayPal Fees,PayPal Bank 3,$5.03 ,"$859,342.56 "
PayPal Bank 3,9/23/23,Deposit,4980327441588930X,04 PAYPAL GENERAL UNRESTR,"Subject: GeneralPage
Transaction ID: 4980327441588930X
https://www.paypal.com/activity/payment/4980327441588930X",PayPal Bank 3,--,$492.26 ,"$859,834.82 "
Donations directed by individuals,9/23/23,Deposit,4980327441588930X,04 PAYPAL GENERAL UNRESTR,Support Ukraine - Support Ukraine,Contributed income:Donations directed by individuals,PayPal Bank 3,$515.38 ,"$860,350.20 "
PayPal Fees,9/23/23,Deposit,4980327441588930X,04 PAYPAL GENERAL UNRESTR,PayPal fees,OFFICE/GENERAL ADMINISTRATIVE EXPENSES:PayPal Fees,PayPal Bank 3,$23.12 ,"$860,373.32 "
PayPal Bank 3,9/23/23,Deposit,2N452540WE0710112,04 PAYPAL GENERAL UNRESTR,"Subject: Support Ukraine
Transaction ID: 2N452540WE0710112
https://www.paypal.com/activity/payment/2N452540WE0710112",PayPal Bank 3,--,$68.35 ,"$860,441.67 "
Donations directed by individuals,9/23/23,Deposit,2N452540WE0710112,04 PAYPAL GENERAL UNRESTR,Money in to PayPal,Contributed income:Donations directed by individuals,PayPal Bank 3,$72.00 ,"$860,513.67 "
PayPal Fees,9/23/23,Deposit,2N452540WE0710112,04 PAYPAL GENERAL UNRESTR,PayPal fees,OFFICE/GENERAL ADMINISTRATIVE EXPENSES:PayPal Fees,PayPal Bank 3,$3.65 ,"$860,517.32 "
PayPal Bank 3,9/23/23,Deposit,1MC338694E646300A,04 PAYPAL GENERAL UNRESTR,"Subject: GeneralPage
Transaction ID: 1MC338694E646300A
https://www.paypal.com/activity/payment/1MC338694E646300A",PayPal Bank 3,--,$18.63 ,"$860,535.95 "
Donations directed by individuals,9/23/23,Deposit,1MC338694E646300A,04 PAYPAL GENERAL UNRESTR,Support Ukraine - Support Ukraine,Contributed income:Donations directed by individuals,PayPal Bank 3,$20.00 ,"$860,555.95 "
PayPal Fees,9/23/23,Deposit,1MC338694E646300A,04 PAYPAL GENERAL UNRESTR,PayPal fees,OFFICE/GENERAL ADMINISTRATIVE EXPENSES:PayPal Fees,PayPal Bank 3,$1.37 ,"$860,557.32 "
PayPal Bank 3,9/23/23,Deposit,1FG45592EE1637307,04 PAYPAL GENERAL UNRESTR,"Subject: GeneralPage
Transaction ID: 1FG45592EE1637307
https://www.paypal.com/activity/payment/1FG45592EE1637307",PayPal Bank 3,--,$9.84 ,"$860,567.16 "
Donations directed by individuals,9/23/23,Deposit,1FG45592EE1637307,04 PAYPAL GENERAL UNRESTR,Support Ukraine - Support Ukraine,Contributed income:Donations directed by individuals,PayPal Bank 3,$10.80 ,"$860,577.96 "
PayPal Fees,9/23/23,Deposit,1FG45592EE1637307,04 PAYPAL GENERAL UNRESTR,PayPal fees,OFFICE/GENERAL ADMINISTRATIVE EXPENSES:PayPal Fees,PayPal Bank 3,$0.96 ,"$860,578.92 "
PayPal Bank 3,9/23/23,Deposit,5M354627576369410,04 PAYPAL GENERAL UNRESTR,"Subject: GeneralPage
Transaction ID: 5M354627576369410
https://www.paypal.com/activity/payment/5M354627576369410",PayPal Bank 3,--,$10.00 ,"$860,588.92 "
Donations directed by individuals,9/23/23,Deposit,5M354627576369410,04 PAYPAL GENERAL UNRESTR,Support Ukraine - Support Ukraine,Contributed income:Donations directed by individuals,PayPal Bank 3,$10.80 ,"$860,599.72 "
PayPal Fees,9/23/23,Deposit,5M354627576369410,04 PAYPAL GENERAL UNRESTR,PayPal fees,OFFICE/GENERAL ADMINISTRATIVE EXPENSES:PayPal Fees,PayPal Bank 3,$0.80 ,"$860,600.52 "
PayPal Bank 3,9/23/23,Deposit,27V426915A739560P,04 PAYPAL GENERAL UNRESTR,"Subject: GeneralPage
Transaction ID: 27V426915A739560P
https://www.paypal.com/activity/payment/27V426915A739560P",PayPal Bank 3,--,$18.63 ,"$860,619.15 "
Donations directed by individuals,9/23/23,Deposit,27V426915A739560P,04 PAYPAL GENERAL UNRESTR,Support Ukraine - Support Ukraine,Contributed income:Donations directed by individuals,PayPal Bank 3,$20.00 ,"$860,639.15 "
PayPal Fees,9/23/23,Deposit,27V426915A739560P,04 PAYPAL GENERAL UNRESTR,PayPal fees,OFFICE/GENERAL ADMINISTRATIVE EXPENSES:PayPal Fees,PayPal Bank 3,$1.37 ,"$860,640.52 "
PayPal Bank 3,9/23/23,Deposit,3C618808AR2257040,04 PAYPAL GENERAL UNRESTR,"Subject: GeneralPage
Transaction ID: 3C618808AR2257040
https://www.paypal.com/activity/payment/3C618808AR2257040",PayPal Bank 3,--,$573.17 ,"$861,213.69 "
Donations directed by individuals,9/23/23,Deposit,3C618808AR2257040,04 PAYPAL GENERAL UNRESTR,Support Ukraine - Support Ukraine,Contributed income:Donations directed by individuals,PayPal Bank 3,$600.00 ,"$861,813.69 "
PayPal Fees,9/23/23,Deposit,3C618808AR2257040,04 PAYPAL GENERAL UNRESTR,PayPal fees,OFFICE/GENERAL ADMINISTRATIVE EXPENSES:PayPal Fees,PayPal Bank 3,$26.83 ,"$861,840.52 "
PayPal Bank 3,9/23/23,Deposit,6LA926130F772364F,04 PAYPAL GENERAL UNRESTR,"Subject: Support Ukraine
Transaction ID: 6LA926130F772364F
https://www.paypal.com/activity/payment/6LA926130F772364F",PayPal Bank 3,--,$25.00 ,"$861,865.52 "
Donations directed by individuals,9/23/23,Deposit,6LA926130F772364F,04 PAYPAL GENERAL UNRESTR,Money in to PayPal,Contributed income:Donations directed by individuals,PayPal Bank 3,$26.25 ,"$861,891.77 "
PayPal Fees,9/23/23,Deposit,6LA926130F772364F,04 PAYPAL GENERAL UNRESTR,PayPal fees,OFFICE/GENERAL ADMINISTRATIVE EXPENSES:PayPal Fees,PayPal Bank 3,$1.25 ,"$861,893.02 "
PayPal Bank 3,9/23/23,Deposit,7TC55803EU842452E,04 PAYPAL GENERAL UNRESTR,"Subject: GeneralPage
Transaction ID: 7TC55803EU842452E
https://www.paypal.com/activity/payment/7TC55803EU842452E",PayPal Bank 3,--,$10.00 ,"$861,903.02 "
Donations directed by individuals,9/23/23,Deposit,7TC55803EU842452E,04 PAYPAL GENERAL UNRESTR,Support Ukraine - Support Ukraine,Contributed income:Donations directed by individuals,PayPal Bank 3,$10.80 ,"$861,913.82 "
PayPal Fees,9/23/23,Deposit,7TC55803EU842452E,04 PAYPAL GENERAL UNRESTR,PayPal fees,OFFICE/GENERAL ADMINISTRATIVE EXPENSES:PayPal Fees,PayPal Bank 3,$0.80 ,"$861,914.62 "
PayPal Bank 3,9/23/23,Deposit,87A864119M7028831,09 MSU RESTR,"Subject: MobileShowers
Transaction ID: 87A864119M7028831
https://www.paypal.com/activity/payment/87A864119M7028831",PayPal Bank 3,--,$50.00 ,"$861,964.62 "
Donations directed by individuals,9/23/23,Deposit,87A864119M7028831,09 MSU RESTR,Mobile Shower/Laundry Units - Mobile Shower/Laundry Units,Contributed income:Donations directed by individuals,PayPal Bank 3,$51.99 ,"$862,016.61 "
PayPal Fees,9/23/23,Deposit,87A864119M7028831,09 MSU RESTR,PayPal fees,OFFICE/GENERAL ADMINISTRATIVE EXPENSES:PayPal Fees,PayPal Bank 3,$1.99 ,"$862,018.60 "
PayPal Bank 3,9/23/23,Deposit,41M87093N3869842C,04 PAYPAL GENERAL UNRESTR,"Subject: GeneralPage
Note: Перемоги!
Transaction ID: 41M87093N3869842C
https://www.paypal.com/activity/payment/41M87093N3869842C",PayPal Bank 3,--,$96.62 ,"$862,115.22 "
Donations directed by individuals,9/23/23,Deposit,41M87093N3869842C,04 PAYPAL GENERAL UNRESTR,Support Ukraine - Support Ukraine,Contributed income:Donations directed by individuals,PayPal Bank 3,$100.00 ,"$862,215.22 "
PayPal Fees,9/23/23,Deposit,41M87093N3869842C,04 PAYPAL GENERAL UNRESTR,PayPal fees,OFFICE/GENERAL ADMINISTRATIVE EXPENSES:PayPal Fees,PayPal Bank 3,$3.38 ,"$862,218.60 "
PayPal Bank 3,9/23/23,Deposit,3SP39270C71594228,04 PAYPAL GENERAL UNRESTR,"Subject: GeneralPage
Transaction ID: 3SP39270C71594228
https://www.paypal.com/activity/payment/3SP39270C71594228",PayPal Bank 3,--,$98.45 ,"$862,317.05 "
Donations directed by individuals,9/23/23,Deposit,3SP39270C71594228,04 PAYPAL GENERAL UNRESTR,Support Ukraine - Support Ukraine,Contributed income:Donations directed by individuals,PayPal Bank 3,$103.48 ,"$862,420.53 "
PayPal Fees,9/23/23,Deposit,3SP39270C71594228,04 PAYPAL GENERAL UNRESTR,PayPal fees,OFFICE/GENERAL ADMINISTRATIVE EXPENSES:PayPal Fees,PayPal Bank 3,$5.03 ,"$862,425.56 "
PayPal Bank 3,9/23/23,Deposit,3Y654211L40021317,04 PAYPAL GENERAL UNRESTR,"Subject: GeneralPage
Transaction ID: 3Y654211L40021317
https://www.paypal.com/activity/payment/3Y654211L40021317",PayPal Bank 3,--,$984.54 ,"$863,410.10 "
Donations directed by individuals,9/23/23,Deposit,3Y654211L40021317,04 PAYPAL GENERAL UNRESTR,Support Ukraine - Support Ukraine,Contributed income:Donations directed by individuals,PayPal Bank 3,"$1,030.26 ","$864,440.36 "
PayPal Fees,9/23/23,Deposit,3Y654211L40021317,04 PAYPAL GENERAL UNRESTR,PayPal fees,OFFICE/GENERAL ADMINISTRATIVE EXPENSES:PayPal Fees,PayPal Bank 3,$45.72 ,"$864,486.08 "
PayPal Bank 3,9/23/23,Deposit,15G722802H1349144,04 PAYPAL GENERAL UNRESTR,"Subject: GeneralPage
Transaction ID: 15G722802H1349144
https://www.paypal.com/activity/payment/15G722802H1349144",PayPal Bank 3,--,$47.31 ,"$864,533.39 "
Donations directed by individuals,9/23/23,Deposit,15G722802H1349144,04 PAYPAL GENERAL UNRESTR,Support Ukraine - Support Ukraine,Contributed income:Donations directed by individuals,PayPal Bank 3,$50.00 ,"$864,583.39 "
PayPal Fees,9/23/23,Deposit,15G722802H1349144,04 PAYPAL GENERAL UNRESTR,PayPal fees,OFFICE/GENERAL ADMINISTRATIVE EXPENSES:PayPal Fees,PayPal Bank 3,$2.69 ,"$864,586.08 "
PayPal Bank 3,9/23/23,Deposit,5B9100439A804150B,04 PAYPAL GENERAL UNRESTR,"Subject: GeneralPage
Transaction ID: 5B9100439A804150B
https://www.paypal.com/activity/payment/5B9100439A804150B",PayPal Bank 3,--,$10.03 ,"$864,596.11 "
Donations directed by individuals,9/23/23,Deposit,5B9100439A804150B,04 PAYPAL GENERAL UNRESTR,Support Ukraine - Support Ukraine,Contributed income:Donations directed by individuals,PayPal Bank 3,$11.00 ,"$864,607.11 "
PayPal Fees,9/23/23,Deposit,5B9100439A804150B,04 PAYPAL GENERAL UNRESTR,PayPal fees,OFFICE/GENERAL ADMINISTRATIVE EXPENSES:PayPal Fees,PayPal Bank 3,$0.97 ,"$864,608.08 "
PayPal Bank 3,9/23/23,Deposit,6BG11488WG6022540,04 PAYPAL GENERAL UNRESTR,"Subject: GeneralPage
Transaction ID: 6BG11488WG6022540
https://www.paypal.com/activity/payment/6BG11488WG6022540",PayPal Bank 3,--,$100.00 ,"$864,708.08 "
Donations directed by individuals,9/23/23,Deposit,6BG11488WG6022540,04 PAYPAL GENERAL UNRESTR,Support Ukraine - Support Ukraine,Contributed income:Donations directed by individuals,PayPal Bank 3,$103.48 ,"$864,811.56 "
PayPal Fees,9/23/23,Deposit,6BG11488WG6022540,04 PAYPAL GENERAL UNRESTR,PayPal fees,OFFICE/GENERAL ADMINISTRATIVE EXPENSES:PayPal Fees,PayPal Bank 3,$3.48 ,"$864,815.04 "
PayPal Bank 3,9/23/23,Deposit,05G85339LU7645050,04 PAYPAL GENERAL UNRESTR,"Subject: GeneralPage
Transaction ID: 05G85339LU7645050
https://www.paypal.com/activity/payment/05G85339LU7645050",PayPal Bank 3,--,$9.84 ,"$864,824.88 "
Donations directed by individuals,9/23/23,Deposit,05G85339LU7645050,04 PAYPAL GENERAL UNRESTR,Support Ukraine - Support Ukraine,Contributed income:Donations directed by individuals,PayPal Bank 3,$10.80 ,"$864,835.68 "
PayPal Fees,9/23/23,Deposit,05G85339LU7645050,04 PAYPAL GENERAL UNRESTR,PayPal fees,OFFICE/GENERAL ADMINISTRATIVE EXPENSES:PayPal Fees,PayPal Bank 3,$0.96 ,"$864,836.64 "
PayPal Bank 3,9/23/23,Deposit,9P0181737J220641C,04 PAYPAL GENERAL UNRESTR,"Subject: Support Ukraine
Transaction ID: 9P0181737J220641C
https://www.paypal.com/activity/payment/9P0181737J220641C",PayPal Bank 3,--,$50.00 ,"$864,886.64 "
Donations directed by individuals,9/23/23,Deposit,9P0181737J220641C,04 PAYPAL GENERAL UNRESTR,Money in to PayPal,Contributed income:Donations directed by individuals,PayPal Bank 3,$51.99 ,"$864,938.63 "
PayPal Fees,9/23/23,Deposit,9P0181737J220641C,04 PAYPAL GENERAL UNRESTR,PayPal fees,OFFICE/GENERAL ADMINISTRATIVE EXPENSES:PayPal Fees,PayPal Bank 3,$1.99 ,"$864,940.62 "
PayPal Bank 3,9/23/23,Deposit,9CR412263F573374F,04 PAYPAL GENERAL UNRESTR,"Subject: GeneralPage
Transaction ID: 9CR412263F573374F
https://www.paypal.com/activity/payment/9CR412263F573374F",PayPal Bank 3,--,$47.31 ,"$864,987.93 "
Donations directed by individuals,9/23/23,Deposit,9CR412263F573374F,04 PAYPAL GENERAL UNRESTR,Support Ukraine - Support Ukraine,Contributed income:Donations directed by individuals,PayPal Bank 3,$50.00 ,"$865,037.93 "
PayPal Fees,9/23/23,Deposit,9CR412263F573374F,04 PAYPAL GENERAL UNRESTR,PayPal fees,OFFICE/GENERAL ADMINISTRATIVE EXPENSES:PayPal Fees,PayPal Bank 3,$2.69 ,"$865,040.62 "
PayPal Bank 3,9/23/23,Deposit,2L017920J00394738,08 VICTORY DRONES RESTR,"Subject: VictoryDrones
Transaction ID: 2L017920J00394738
https://www.paypal.com/activity/payment/2L017920J00394738",PayPal Bank 3,--,$196.91 ,"$865,237.53 "
Donations directed by individuals,9/23/23,Deposit,2L017920J00394738,08 VICTORY DRONES RESTR,VICTORY DRONES - VICTORY DRONES,Contributed income:Donations directed by individuals,PayPal Bank 3,$206.46 ,"$865,443.99 "
PayPal Fees,9/23/23,Deposit,2L017920J00394738,08 VICTORY DRONES RESTR,PayPal fees,OFFICE/GENERAL ADMINISTRATIVE EXPENSES:PayPal Fees,PayPal Bank 3,$9.55 ,"$865,453.54 "
PayPal Bank 3,9/23/23,Deposit,6JE19580R09840036,04 PAYPAL GENERAL UNRESTR,"Subject: GeneralPage
Transaction ID: 6JE19580R09840036
https://www.paypal.com/activity/payment/6JE19580R09840036",PayPal Bank 3,--,$100.00 ,"$865,553.54 "
Donations directed by individuals,9/23/23,Deposit,6JE19580R09840036,04 PAYPAL GENERAL UNRESTR,Support Ukraine - Support Ukraine,Contributed income:Donations directed by individuals,PayPal Bank 3,$103.48 ,"$865,657.02 "
PayPal Fees,9/23/23,Deposit,6JE19580R09840036,04 PAYPAL GENERAL UNRESTR,PayPal fees,OFFICE/GENERAL ADMINISTRATIVE EXPENSES:PayPal Fees,PayPal Bank 3,$3.48 ,"$865,660.50 "
PayPal Bank 3,9/23/23,Deposit,6A756323KH1457520,07 1000 DRONES RESTR,"Subject: GeneralPage
Note: Люті пташки
Transaction ID: 6A756323KH1457520
https://www.paypal.com/activity/payment/6A756323KH1457520",PayPal Bank 3,--,$9.84 ,"$865,670.34 "
Donations directed by individuals,9/23/23,Deposit,6A756323KH1457520,07 1000 DRONES RESTR,Support Ukraine - Support Ukraine,Contributed income:Donations directed by individuals,PayPal Bank 3,$10.80 ,"$865,681.14 "
PayPal Fees,9/23/23,Deposit,6A756323KH1457520,07 1000 DRONES RESTR,PayPal fees,OFFICE/GENERAL ADMINISTRATIVE EXPENSES:PayPal Fees,PayPal Bank 3,$0.96 ,"$865,682.10 "
PayPal Bank 3,9/23/23,Deposit,9PE68180J0923350B,04 PAYPAL GENERAL UNRESTR,"Subject: GeneralPage
Transaction ID: 9PE68180J0923350B
https://www.paypal.com/activity/payment/9PE68180J0923350B",PayPal Bank 3,--,$47.31 ,"$865,729.41 "
Donations directed by individuals,9/23/23,Deposit,9PE68180J0923350B,04 PAYPAL GENERAL UNRESTR,Support Ukraine - Support Ukraine,Contributed income:Donations directed by individuals,PayPal Bank 3,$50.00 ,"$865,779.41 "
PayPal Fees,9/23/23,Deposit,9PE68180J0923350B,04 PAYPAL GENERAL UNRESTR,PayPal fees,OFFICE/GENERAL ADMINISTRATIVE EXPENSES:PayPal Fees,PayPal Bank 3,$2.69 ,"$865,782.10 "
PayPal Bank 3,9/23/23,Deposit,37664817VU871930P,04 PAYPAL GENERAL UNRESTR,"Subject: Support Ukraine
Transaction ID: 37664817VU871930P
https://www.paypal.com/activity/payment/37664817VU871930P",PayPal Bank 3,--,$29.53 ,"$865,811.63 "
Donations directed by individuals,9/23/23,Deposit,37664817VU871930P,04 PAYPAL GENERAL UNRESTR,Money in to PayPal,Contributed income:Donations directed by individuals,PayPal Bank 3,$31.40 ,"$865,843.03 "
PayPal Fees,9/23/23,Deposit,37664817VU871930P,04 PAYPAL GENERAL UNRESTR,PayPal fees,OFFICE/GENERAL ADMINISTRATIVE EXPENSES:PayPal Fees,PayPal Bank 3,$1.87 ,"$865,844.90 "
PayPal Bank 3,9/23/23,Deposit,03585559M35562807,04 PAYPAL GENERAL UNRESTR,"Subject: GeneralPage
Transaction ID: 03585559M35562807
https://www.paypal.com/activity/payment/03585559M35562807",PayPal Bank 3,--,$48.06 ,"$865,892.96 "
Donations directed by individuals,9/23/23,Deposit,03585559M35562807,04 PAYPAL GENERAL UNRESTR,Support Ukraine - Support Ukraine,Contributed income:Donations directed by individuals,PayPal Bank 3,$50.00 ,"$865,942.96 "
PayPal Fees,9/23/23,Deposit,03585559M35562807,04 PAYPAL GENERAL UNRESTR,PayPal fees,OFFICE/GENERAL ADMINISTRATIVE EXPENSES:PayPal Fees,PayPal Bank 3,$1.94 ,"$865,944.90 "
PayPal Bank 3,9/23/23,Deposit,9RG15468123476822,04 PAYPAL GENERAL UNRESTR,"Subject: GeneralPage
Transaction ID: 9RG15468123476822
https://www.paypal.com/activity/payment/9RG15468123476822",PayPal Bank 3,--,$47.31 ,"$865,992.21 "
Donations directed by individuals,9/23/23,Deposit,9RG15468123476822,04 PAYPAL GENERAL UNRESTR,Support Ukraine - Support Ukraine,Contributed income:Donations directed by individuals,PayPal Bank 3,$50.00 ,"$866,042.21 "
PayPal Fees,9/23/23,Deposit,9RG15468123476822,04 PAYPAL GENERAL UNRESTR,PayPal fees,OFFICE/GENERAL ADMINISTRATIVE EXPENSES:PayPal Fees,PayPal Bank 3,$2.69 ,"$866,044.90 "
PayPal Bank 3,9/23/23,Deposit,207491312J495750Y,04 PAYPAL GENERAL UNRESTR,"Subject: GeneralPage
Note: Happy birthday, Marianna
Transaction ID: 207491312J495750Y
https://www.paypal.com/activity/payment/207491312J495750Y",PayPal Bank 3,--,$72.00 ,"$866,116.90 "
Donations directed by individuals,9/23/23,Deposit,207491312J495750Y,04 PAYPAL GENERAL UNRESTR,Support Ukraine - Support Ukraine,Contributed income:Donations directed by individuals,PayPal Bank 3,$74.65 ,"$866,191.55 "
PayPal Fees,9/23/23,Deposit,207491312J495750Y,04 PAYPAL GENERAL UNRESTR,PayPal fees,OFFICE/GENERAL ADMINISTRATIVE EXPENSES:PayPal Fees,PayPal Bank 3,$2.65 ,"$866,194.20 "
PayPal Bank 3,9/23/23,Deposit,081662594E7640217,04 PAYPAL GENERAL UNRESTR,"Subject: GeneralPage
Transaction ID: 081662594E7640217
https://www.paypal.com/activity/payment/081662594E7640217",PayPal Bank 3,--,$69.43 ,"$866,263.63 "
Donations directed by individuals,9/23/23,Deposit,081662594E7640217,04 PAYPAL GENERAL UNRESTR,Support Ukraine - Support Ukraine,Contributed income:Donations directed by individuals,PayPal Bank 3,$72.00 ,"$866,335.63 "
PayPal Fees,9/23/23,Deposit,081662594E7640217,04 PAYPAL GENERAL UNRESTR,PayPal fees,OFFICE/GENERAL ADMINISTRATIVE EXPENSES:PayPal Fees,PayPal Bank 3,$2.57 ,"$866,338.20 "
PayPal Bank 3,9/23/23,Deposit,8JW05024CY0969533,04 PAYPAL GENERAL UNRESTR,"Subject: GeneralPage
Note: Jaroslav Brodziuk donation
Transaction ID: 8JW05024CY0969533
https://www.paypal.com/activity/payment/8JW05024CY0969533",PayPal Bank 3,--,$71.22 ,"$866,409.42 "
Donations directed by individuals,9/23/23,Deposit,8JW05024CY0969533,04 PAYPAL GENERAL UNRESTR,Support Ukraine - Support Ukraine,Contributed income:Donations directed by individuals,PayPal Bank 3,$75.00 ,"$866,484.42 "
PayPal Fees,9/23/23,Deposit,8JW05024CY0969533,04 PAYPAL GENERAL UNRESTR,PayPal fees,OFFICE/GENERAL ADMINISTRATIVE EXPENSES:PayPal Fees,PayPal Bank 3,$3.78 ,"$866,488.20 "
PayPal Bank 3,9/23/23,Deposit,4VG38684JT042905G,09 MSU RESTR,"Subject: MobileShowers
Transaction ID: 4VG38684JT042905G
https://www.paypal.com/activity/payment/4VG38684JT042905G",PayPal Bank 3,--,$96.62 ,"$866,584.82 "
Donations directed by individuals,9/23/23,Deposit,4VG38684JT042905G,09 MSU RESTR,Mobile Shower/Laundry Units - Mobile Shower/Laundry Units,Contributed income:Donations directed by individuals,PayPal Bank 3,$100.00 ,"$866,684.82 "
PayPal Fees,9/23/23,Deposit,4VG38684JT042905G,09 MSU RESTR,PayPal fees,OFFICE/GENERAL ADMINISTRATIVE EXPENSES:PayPal Fees,PayPal Bank 3,$3.38 ,"$866,688.20 "
PayPal Bank 3,9/23/23,Deposit,95E83446LB4657205,04 PAYPAL GENERAL UNRESTR,"Subject: GeneralPage
Transaction ID: 95E83446LB4657205
https://www.paypal.com/activity/payment/95E83446LB4657205",PayPal Bank 3,--,$71.95 ,"$866,760.15 "
Donations directed by individuals,9/23/23,Deposit,95E83446LB4657205,04 PAYPAL GENERAL UNRESTR,Support Ukraine - Support Ukraine,Contributed income:Donations directed by individuals,PayPal Bank 3,$75.77 ,"$866,835.92 "
PayPal Fees,9/23/23,Deposit,95E83446LB4657205,04 PAYPAL GENERAL UNRESTR,PayPal fees,OFFICE/GENERAL ADMINISTRATIVE EXPENSES:PayPal Fees,PayPal Bank 3,$3.82 ,"$866,839.74 "
PayPal Bank 3,9/23/23,Deposit,4P268199SN602062L,04 PAYPAL GENERAL UNRESTR,"Subject: GeneralPage
Transaction ID: 4P268199SN602062L
https://www.paypal.com/activity/payment/4P268199SN602062L",PayPal Bank 3,--,$1.45 ,"$866,841.19 "
Donations directed by individuals,9/23/23,Deposit,4P268199SN602062L,04 PAYPAL GENERAL UNRESTR,Support Ukraine - Support Ukraine,Contributed income:Donations directed by individuals,PayPal Bank 3,$2.00 ,"$866,843.19 "
PayPal Fees,9/23/23,Deposit,4P268199SN602062L,04 PAYPAL GENERAL UNRESTR,PayPal fees,OFFICE/GENERAL ADMINISTRATIVE EXPENSES:PayPal Fees,PayPal Bank 3,$0.55 ,"$866,843.74 "
PayPal Bank 3,9/23/23,Deposit,8U86936893088584V,04 PAYPAL GENERAL UNRESTR,"Subject: GeneralPage
Transaction ID: 8U86936893088584V
https://www.paypal.com/activity/payment/8U86936893088584V",PayPal Bank 3,--,$50.00 ,"$866,893.74 "
Donations directed by individuals,9/23/23,Deposit,8U86936893088584V,04 PAYPAL GENERAL UNRESTR,Support Ukraine - Support Ukraine,Contributed income:Donations directed by individuals,PayPal Bank 3,$51.99 ,"$866,945.73 "
PayPal Fees,9/23/23,Deposit,8U86936893088584V,04 PAYPAL GENERAL UNRESTR,PayPal fees,OFFICE/GENERAL ADMINISTRATIVE EXPENSES:PayPal Fees,PayPal Bank 3,$1.99 ,"$866,947.72 "
PayPal Bank 3,9/23/23,Deposit,0N969317AG0359824,04 PAYPAL GENERAL UNRESTR,"Subject: GeneralPage
Transaction ID: 0N969317AG0359824
https://www.paypal.com/activity/payment/0N969317AG0359824",PayPal Bank 3,--,$9.07 ,"$866,956.79 "
Donations directed by individuals,9/23/23,Deposit,0N969317AG0359824,04 PAYPAL GENERAL UNRESTR,Support Ukraine - Support Ukraine,Contributed income:Donations directed by individuals,PayPal Bank 3,$10.00 ,"$866,966.79 "
PayPal Fees,9/23/23,Deposit,0N969317AG0359824,04 PAYPAL GENERAL UNRESTR,PayPal fees,OFFICE/GENERAL ADMINISTRATIVE EXPENSES:PayPal Fees,PayPal Bank 3,$0.93 ,"$866,967.72 "
PayPal Bank 3,9/23/23,Deposit,7WF56029GM4070053,04 PAYPAL GENERAL UNRESTR,"Subject: GeneralPage
Transaction ID: 7WF56029GM4070053
https://www.paypal.com/activity/payment/7WF56029GM4070053",PayPal Bank 3,--,$13.85 ,"$866,981.57 "
Donations directed by individuals,9/23/23,Deposit,7WF56029GM4070053,04 PAYPAL GENERAL UNRESTR,Support Ukraine - Support Ukraine,Contributed income:Donations directed by individuals,PayPal Bank 3,$15.00 ,"$866,996.57 "
PayPal Fees,9/23/23,Deposit,7WF56029GM4070053,04 PAYPAL GENERAL UNRESTR,PayPal fees,OFFICE/GENERAL ADMINISTRATIVE EXPENSES:PayPal Fees,PayPal Bank 3,$1.15 ,"$866,997.72 "
PayPal Bank 3,9/23/23,Deposit,50N321989A458870D,04 PAYPAL GENERAL UNRESTR,"Subject: Support Ukraine
Transaction ID: 50N321989A458870D
https://www.paypal.com/activity/payment/50N321989A458870D",PayPal Bank 3,--,$23.41 ,"$867,021.13 "
Donations directed by individuals,9/23/23,Deposit,50N321989A458870D,04 PAYPAL GENERAL UNRESTR,Money in to PayPal,Contributed income:Donations directed by individuals,PayPal Bank 3,$25.00 ,"$867,046.13 "
PayPal Fees,9/23/23,Deposit,50N321989A458870D,04 PAYPAL GENERAL UNRESTR,PayPal fees,OFFICE/GENERAL ADMINISTRATIVE EXPENSES:PayPal Fees,PayPal Bank 3,$1.59 ,"$867,047.72 "
PayPal Bank 3,9/23/23,Deposit,5C760368MC3329939,04 PAYPAL GENERAL UNRESTR,"Subject: Support Ukraine
Transaction ID: 5C760368MC3329939
https://www.paypal.com/activity/payment/5C760368MC3329939",PayPal Bank 3,--,$4.91 ,"$867,052.63 "
Donations directed by individuals,9/23/23,Deposit,5C760368MC3329939,04 PAYPAL GENERAL UNRESTR,Money in to PayPal,Contributed income:Donations directed by individuals,PayPal Bank 3,$5.65 ,"$867,058.28 "
PayPal Fees,9/23/23,Deposit,5C760368MC3329939,04 PAYPAL GENERAL UNRESTR,PayPal fees,OFFICE/GENERAL ADMINISTRATIVE EXPENSES:PayPal Fees,PayPal Bank 3,$0.74 ,"$867,059.02 "
PayPal Bank 3,9/23/23,Deposit,5R662146GU666393B,04 PAYPAL GENERAL UNRESTR,"Subject: Support Ukraine
Transaction ID: 5R662146GU666393B
https://www.paypal.com/activity/payment/5R662146GU666393B",PayPal Bank 3,--,$47.31 ,"$867,106.33 "
Donations directed by individuals,9/23/23,Deposit,5R662146GU666393B,04 PAYPAL GENERAL UNRESTR,Money in to PayPal,Contributed income:Donations directed by individuals,PayPal Bank 3,$50.00 ,"$867,156.33 "
PayPal Fees,9/23/23,Deposit,5R662146GU666393B,04 PAYPAL GENERAL UNRESTR,PayPal fees,OFFICE/GENERAL ADMINISTRATIVE EXPENSES:PayPal Fees,PayPal Bank 3,$2.69 ,"$867,159.02 "
PayPal Bank 3,9/23/23,Deposit,09J897853W000315S,04 PAYPAL GENERAL UNRESTR,"Subject: Support Ukraine
Transaction ID: 09J897853W000315S
https://www.paypal.com/activity/payment/09J897853W000315S",PayPal Bank 3,--,$18.63 ,"$867,177.65 "
Donations directed by individuals,9/23/23,Deposit,09J897853W000315S,04 PAYPAL GENERAL UNRESTR,Money in to PayPal,Contributed income:Donations directed by individuals,PayPal Bank 3,$20.00 ,"$867,197.65 "
PayPal Fees,9/23/23,Deposit,09J897853W000315S,04 PAYPAL GENERAL UNRESTR,PayPal fees,OFFICE/GENERAL ADMINISTRATIVE EXPENSES:PayPal Fees,PayPal Bank 3,$1.37 ,"$867,199.02 "
PayPal Bank 3,9/23/23,Deposit,5U8073034S135061Y,04 PAYPAL GENERAL UNRESTR,"Subject: GeneralPage
Note: Happy Birthday Inna Tuka! From, Natalia Lekh
Transaction ID: 5U8073034S135061Y
https://www.paypal.com/activity/payment/5U8073034S135061Y",PayPal Bank 3,--,$49.22 ,"$867,248.24 "
Donations directed by individuals,9/23/23,Deposit,5U8073034S135061Y,04 PAYPAL GENERAL UNRESTR,Support Ukraine - Support Ukraine,Contributed income:Donations directed by individuals,PayPal Bank 3,$51.99 ,"$867,300.23 "
PayPal Fees,9/23/23,Deposit,5U8073034S135061Y,04 PAYPAL GENERAL UNRESTR,PayPal fees,OFFICE/GENERAL ADMINISTRATIVE EXPENSES:PayPal Fees,PayPal Bank 3,$2.77 ,"$867,303.00 "
PayPal Bank 3,9/23/23,Deposit,4TH11042B5439180G,04 PAYPAL GENERAL UNRESTR,"Subject: GeneralPage
Transaction ID: 4TH11042B5439180G
https://www.paypal.com/activity/payment/4TH11042B5439180G",PayPal Bank 3,--,$9.07 ,"$867,312.07 "
Donations directed by individuals,9/23/23,Deposit,4TH11042B5439180G,04 PAYPAL GENERAL UNRESTR,Support Ukraine - Support Ukraine,Contributed income:Donations directed by individuals,PayPal Bank 3,$10.00 ,"$867,322.07 "
PayPal Fees,9/23/23,Deposit,4TH11042B5439180G,04 PAYPAL GENERAL UNRESTR,PayPal fees,OFFICE/GENERAL ADMINISTRATIVE EXPENSES:PayPal Fees,PayPal Bank 3,$0.93 ,"$867,323.00 "
PayPal Bank 3,9/23/23,Deposit,2UC04447XP4002048,04 PAYPAL GENERAL UNRESTR,"Subject: GeneralPage
Transaction ID: 2UC04447XP4002048
https://www.paypal.com/activity/payment/2UC04447XP4002048",PayPal Bank 3,--,$48.06 ,"$867,371.06 "
Donations directed by individuals,9/23/23,Deposit,2UC04447XP4002048,04 PAYPAL GENERAL UNRESTR,Support Ukraine - Support Ukraine,Contributed income:Donations directed by individuals,PayPal Bank 3,$50.00 ,"$867,421.06 "
PayPal Fees,9/23/23,Deposit,2UC04447XP4002048,04 PAYPAL GENERAL UNRESTR,PayPal fees,OFFICE/GENERAL ADMINISTRATIVE EXPENSES:PayPal Fees,PayPal Bank 3,$1.94 ,"$867,423.00 "
PayPal Bank 3,9/23/23,Deposit,2SE78293DW442571W,04 PAYPAL GENERAL UNRESTR,"Subject: Support Ukraine
Transaction ID: 2SE78293DW442571W
https://www.paypal.com/activity/payment/2SE78293DW442571W",PayPal Bank 3,--,$100.00 ,"$867,523.00 "
Donations directed by individuals,9/23/23,Deposit,2SE78293DW442571W,04 PAYPAL GENERAL UNRESTR,Money in to PayPal,Contributed income:Donations directed by individuals,PayPal Bank 3,$103.48 ,"$867,626.48 "
PayPal Fees,9/23/23,Deposit,2SE78293DW442571W,04 PAYPAL GENERAL UNRESTR,PayPal fees,OFFICE/GENERAL ADMINISTRATIVE EXPENSES:PayPal Fees,PayPal Bank 3,$3.48 ,"$867,629.96 "
PayPal Bank 3,9/23/23,Deposit,6GW48357TF3167051,04 PAYPAL GENERAL UNRESTR,"Subject: GeneralPage
Note: Слава Україні ��
Transaction ID: 6GW48357TF3167051
https://www.paypal.com/activity/payment/6GW48357TF3167051",PayPal Bank 3,--,$14.76 ,"$867,644.72 "
Donations directed by individuals,9/23/23,Deposit,6GW48357TF3167051,04 PAYPAL GENERAL UNRESTR,Support Ukraine - Support Ukraine,Contributed income:Donations directed by individuals,PayPal Bank 3,$15.95 ,"$867,660.67 "
PayPal Fees,9/23/23,Deposit,6GW48357TF3167051,04 PAYPAL GENERAL UNRESTR,PayPal fees,OFFICE/GENERAL ADMINISTRATIVE EXPENSES:PayPal Fees,PayPal Bank 3,$1.19 ,"$867,661.86 "
PayPal Bank 3,9/23/23,Deposit,19W44458UA0082448,08 VICTORY DRONES RESTR,"Subject: VictoryDrones
Transaction ID: 19W44458UA0082448
https://www.paypal.com/activity/payment/19W44458UA0082448",PayPal Bank 3,--,$290.84 ,"$867,952.70 "
Donations directed by individuals,9/23/23,Deposit,19W44458UA0082448,08 VICTORY DRONES RESTR,VICTORY DRONES - VICTORY DRONES,Contributed income:Donations directed by individuals,PayPal Bank 3,$300.00 ,"$868,252.70 "
PayPal Fees,9/23/23,Deposit,19W44458UA0082448,08 VICTORY DRONES RESTR,PayPal fees,OFFICE/GENERAL ADMINISTRATIVE EXPENSES:PayPal Fees,PayPal Bank 3,$9.16 ,"$868,261.86 "
PayPal Bank 3,9/23/23,Deposit,63X69138KA049252M,04 PAYPAL GENERAL UNRESTR,"Subject: GeneralPage
Transaction ID: 63X69138KA049252M
https://www.paypal.com/activity/payment/63X69138KA049252M",PayPal Bank 3,--,$47.31 ,"$868,309.17 "
Donations directed by individuals,9/23/23,Deposit,63X69138KA049252M,04 PAYPAL GENERAL UNRESTR,Support Ukraine - Support Ukraine,Contributed income:Donations directed by individuals,PayPal Bank 3,$50.00 ,"$868,359.17 "
PayPal Fees,9/23/23,Deposit,63X69138KA049252M,04 PAYPAL GENERAL UNRESTR,PayPal fees,OFFICE/GENERAL ADMINISTRATIVE EXPENSES:PayPal Fees,PayPal Bank 3,$2.69 ,"$868,361.86 "
PayPal Bank 3,9/23/23,Deposit,9D33126395002631C,08 VICTORY DRONES RESTR,"Subject: VictoryDrones
Transaction ID: 9D33126395002631C
https://www.paypal.com/activity/payment/9D33126395002631C",PayPal Bank 3,--,$47.31 ,"$868,409.17 "
Donations directed by individuals,9/23/23,Deposit,9D33126395002631C,08 VICTORY DRONES RESTR,VICTORY DRONES - VICTORY DRONES,Contributed income:Donations directed by individuals,PayPal Bank 3,$50.00 ,"$868,459.17 "
PayPal Fees,9/23/23,Deposit,9D33126395002631C,08 VICTORY DRONES RESTR,PayPal fees,OFFICE/GENERAL ADMINISTRATIVE EXPENSES:PayPal Fees,PayPal Bank 3,$2.69 ,"$868,461.86 "
PayPal Bank 3,9/23/23,Deposit,3WL35463L54124920,07 1000 DRONES RESTR,"Subject: 1000DRONES
Transaction ID: 3WL35463L54124920
https://www.paypal.com/activity/payment/3WL35463L54124920",PayPal Bank 3,--,$98.45 ,"$868,560.31 "
Donations directed by individuals,9/23/23,Deposit,3WL35463L54124920,07 1000 DRONES RESTR,1000 DRONES FOR UKRAINE - 1000 DRONES FOR UKRAINE,Contributed income:Donations directed by individuals,PayPal Bank 3,$103.48 ,"$868,663.79 "
PayPal Fees,9/23/23,Deposit,3WL35463L54124920,07 1000 DRONES RESTR,PayPal fees,OFFICE/GENERAL ADMINISTRATIVE EXPENSES:PayPal Fees,PayPal Bank 3,$5.03 ,"$868,668.82 "
PayPal Bank 3,9/23/23,Deposit,9TC921050Y485921X,04 PAYPAL GENERAL UNRESTR,"Subject: GeneralPage
Transaction ID: 9TC921050Y485921X
https://www.paypal.com/activity/payment/9TC921050Y485921X",PayPal Bank 3,--,$118.14 ,"$868,786.96 "
Donations directed by individuals,9/23/23,Deposit,9TC921050Y485921X,04 PAYPAL GENERAL UNRESTR,Support Ukraine - Support Ukraine,Contributed income:Donations directed by individuals,PayPal Bank 3,$124.08 ,"$868,911.04 "
PayPal Fees,9/23/23,Deposit,9TC921050Y485921X,04 PAYPAL GENERAL UNRESTR,PayPal fees,OFFICE/GENERAL ADMINISTRATIVE EXPENSES:PayPal Fees,PayPal Bank 3,$5.94 ,"$868,916.98 "
PayPal Bank 3,9/23/23,Deposit,3AA88442BG777454U,04 PAYPAL GENERAL UNRESTR,"Subject: Support Ukraine
Transaction ID: 3AA88442BG777454U
https://www.paypal.com/activity/payment/3AA88442BG777454U",PayPal Bank 3,--,$50.00 ,"$868,966.98 "
Donations directed by individuals,9/23/23,Deposit,3AA88442BG777454U,04 PAYPAL GENERAL UNRESTR,Money in to PayPal,Contributed income:Donations directed by individuals,PayPal Bank 3,$51.99 ,"$869,018.97 "
PayPal Fees,9/23/23,Deposit,3AA88442BG777454U,04 PAYPAL GENERAL UNRESTR,PayPal fees,OFFICE/GENERAL ADMINISTRATIVE EXPENSES:PayPal Fees,PayPal Bank 3,$1.99 ,"$869,020.96 "
PayPal Bank 3,9/23/23,Deposit,2FD93918MS2779318,04 PAYPAL GENERAL UNRESTR,"Subject: GeneralPage
Transaction ID: 2FD93918MS2779318
https://www.paypal.com/activity/payment/2FD93918MS2779318",PayPal Bank 3,--,$100.00 ,"$869,120.96 "
Donations directed by individuals,9/23/23,Deposit,2FD93918MS2779318,04 PAYPAL GENERAL UNRESTR,Support Ukraine - Support Ukraine,Contributed income:Donations directed by individuals,PayPal Bank 3,$103.48 ,"$869,224.44 "
PayPal Fees,9/23/23,Deposit,2FD93918MS2779318,04 PAYPAL GENERAL UNRESTR,PayPal fees,OFFICE/GENERAL ADMINISTRATIVE EXPENSES:PayPal Fees,PayPal Bank 3,$3.48 ,"$869,227.92 "
PayPal Bank 3,9/23/23,Deposit,7W707089VE5282218,04 PAYPAL GENERAL UNRESTR,"Subject: GeneralPage
Transaction ID: 7W707089VE5282218
https://www.paypal.com/activity/payment/7W707089VE5282218",PayPal Bank 3,--,$1.96 ,"$869,229.88 "
Donations directed by individuals,9/23/23,Deposit,7W707089VE5282218,04 PAYPAL GENERAL UNRESTR,Support Ukraine - Support Ukraine,Contributed income:Donations directed by individuals,PayPal Bank 3,$2.56 ,"$869,232.44 "
PayPal Fees,9/23/23,Deposit,7W707089VE5282218,04 PAYPAL GENERAL UNRESTR,PayPal fees,OFFICE/GENERAL ADMINISTRATIVE EXPENSES:PayPal Fees,PayPal Bank 3,$0.60 ,"$869,233.04 "
PayPal Bank 3,9/23/23,Deposit,665936122T2080605,04 PAYPAL GENERAL UNRESTR,"Subject: Support Ukraine
Transaction ID: 665936122T2080605
https://www.paypal.com/activity/payment/665936122T2080605",PayPal Bank 3,--,$25.00 ,"$869,258.04 "
Donations directed by individuals,9/23/23,Deposit,665936122T2080605,04 PAYPAL GENERAL UNRESTR,Money in to PayPal,Contributed income:Donations directed by individuals,PayPal Bank 3,$26.25 ,"$869,284.29 "
PayPal Fees,9/23/23,Deposit,665936122T2080605,04 PAYPAL GENERAL UNRESTR,PayPal fees,OFFICE/GENERAL ADMINISTRATIVE EXPENSES:PayPal Fees,PayPal Bank 3,$1.25 ,"$869,285.54 "
PayPal Bank 3,9/23/23,Deposit,44C66672X45984817,04 PAYPAL GENERAL UNRESTR,"Subject: Support Ukraine
Transaction ID: 44C66672X45984817
https://www.paypal.com/activity/payment/44C66672X45984817",PayPal Bank 3,--,$47.31 ,"$869,332.85 "
Donations directed by individuals,9/23/23,Deposit,44C66672X45984817,04 PAYPAL GENERAL UNRESTR,Money in to PayPal,Contributed income:Donations directed by individuals,PayPal Bank 3,$50.00 ,"$869,382.85 "
PayPal Fees,9/23/23,Deposit,44C66672X45984817,04 PAYPAL GENERAL UNRESTR,PayPal fees,OFFICE/GENERAL ADMINISTRATIVE EXPENSES:PayPal Fees,PayPal Bank 3,$2.69 ,"$869,385.54 "
PayPal Bank 3,9/23/23,Deposit,0EG06841430515333,04 PAYPAL GENERAL UNRESTR,"Subject: Support Ukraine
Transaction ID: 0EG06841430515333
https://www.paypal.com/activity/payment/0EG06841430515333",PayPal Bank 3,--,$50.00 ,"$869,435.54 "
Donations directed by individuals,9/23/23,Deposit,0EG06841430515333,04 PAYPAL GENERAL UNRESTR,Money in to PayPal,Contributed income:Donations directed by individuals,PayPal Bank 3,$51.99 ,"$869,487.53 "
PayPal Fees,9/23/23,Deposit,0EG06841430515333,04 PAYPAL GENERAL UNRESTR,PayPal fees,OFFICE/GENERAL ADMINISTRATIVE EXPENSES:PayPal Fees,PayPal Bank 3,$1.99 ,"$869,489.52 "
PayPal Bank 3,9/23/23,Deposit,7NV05535BS2112334,04 PAYPAL GENERAL UNRESTR,"Subject: GeneralPage
Transaction ID: 7NV05535BS2112334
https://www.paypal.com/activity/payment/7NV05535BS2112334",PayPal Bank 3,--,$118.14 ,"$869,607.66 "
Donations directed by individuals,9/23/23,Deposit,7NV05535BS2112334,04 PAYPAL GENERAL UNRESTR,Support Ukraine - Support Ukraine,Contributed income:Donations directed by individuals,PayPal Bank 3,$124.08 ,"$869,731.74 "
PayPal Fees,9/23/23,Deposit,7NV05535BS2112334,04 PAYPAL GENERAL UNRESTR,PayPal fees,OFFICE/GENERAL ADMINISTRATIVE EXPENSES:PayPal Fees,PayPal Bank 3,$5.94 ,"$869,737.68 "
PayPal Bank 3,9/23/23,Deposit,1TK47758J95155925,04 PAYPAL GENERAL UNRESTR,"Subject: GeneralPage
Transaction ID: 1TK47758J95155925
https://www.paypal.com/activity/payment/1TK47758J95155925",PayPal Bank 3,--,$23.79 ,"$869,761.47 "
Donations directed by individuals,9/23/23,Deposit,1TK47758J95155925,04 PAYPAL GENERAL UNRESTR,Support Ukraine - Support Ukraine,Contributed income:Donations directed by individuals,PayPal Bank 3,$25.00 ,"$869,786.47 "
PayPal Fees,9/23/23,Deposit,1TK47758J95155925,04 PAYPAL GENERAL UNRESTR,PayPal fees,OFFICE/GENERAL ADMINISTRATIVE EXPENSES:PayPal Fees,PayPal Bank 3,$1.21 ,"$869,787.68 "
PayPal Bank 3,9/23/23,Deposit,5J440345H84215503,08 VICTORY DRONES RESTR,"Subject: VictoryDrones
Transaction ID: 5J440345H84215503
https://www.paypal.com/activity/payment/5J440345H84215503",PayPal Bank 3,--,$9.07 ,"$869,796.75 "
Donations directed by individuals,9/23/23,Deposit,5J440345H84215503,08 VICTORY DRONES RESTR,VICTORY DRONES - VICTORY DRONES,Contributed income:Donations directed by individuals,PayPal Bank 3,$10.00 ,"$869,806.75 "
PayPal Fees,9/23/23,Deposit,5J440345H84215503,08 VICTORY DRONES RESTR,PayPal fees,OFFICE/GENERAL ADMINISTRATIVE EXPENSES:PayPal Fees,PayPal Bank 3,$0.93 ,"$869,807.68 "
PayPal Bank 3,9/23/23,Deposit,55G66731BS528610X,04 PAYPAL GENERAL UNRESTR,"Subject: GeneralPage
Transaction ID: 55G66731BS528610X
https://www.paypal.com/activity/payment/55G66731BS528610X",PayPal Bank 3,--,$14.76 ,"$869,822.44 "
Donations directed by individuals,9/23/23,Deposit,55G66731BS528610X,04 PAYPAL GENERAL UNRESTR,Support Ukraine - Support Ukraine,Contributed income:Donations directed by individuals,PayPal Bank 3,$15.95 ,"$869,838.39 "
PayPal Fees,9/23/23,Deposit,55G66731BS528610X,04 PAYPAL GENERAL UNRESTR,PayPal fees,OFFICE/GENERAL ADMINISTRATIVE EXPENSES:PayPal Fees,PayPal Bank 3,$1.19 ,"$869,839.58 "
PayPal Bank 3,9/23/23,Deposit,0MN46735DC497164D,04 PAYPAL GENERAL UNRESTR,"Subject: GeneralPage
Transaction ID: 0MN46735DC497164D
https://www.paypal.com/activity/payment/0MN46735DC497164D",PayPal Bank 3,--,$200.00 ,"$870,039.58 "
Donations directed by individuals,9/23/23,Deposit,0MN46735DC497164D,04 PAYPAL GENERAL UNRESTR,Support Ukraine - Support Ukraine,Contributed income:Donations directed by individuals,PayPal Bank 3,$206.46 ,"$870,246.04 "
PayPal Fees,9/23/23,Deposit,0MN46735DC497164D,04 PAYPAL GENERAL UNRESTR,PayPal fees,OFFICE/GENERAL ADMINISTRATIVE EXPENSES:PayPal Fees,PayPal Bank 3,$6.46 ,"$870,252.50 "
PayPal Bank 3,9/23/23,Deposit,3M97511137419480A,04 PAYPAL GENERAL UNRESTR,"Subject: GeneralPage
Transaction ID: 3M97511137419480A
https://www.paypal.com/activity/payment/3M97511137419480A",PayPal Bank 3,--,$10.00 ,"$870,262.50 "
Donations directed by individuals,9/23/23,Deposit,3M97511137419480A,04 PAYPAL GENERAL UNRESTR,Support Ukraine - Support Ukraine,Contributed income:Donations directed by individuals,PayPal Bank 3,$10.80 ,"$870,273.30 "
PayPal Fees,9/23/23,Deposit,3M97511137419480A,04 PAYPAL GENERAL UNRESTR,PayPal fees,OFFICE/GENERAL ADMINISTRATIVE EXPENSES:PayPal Fees,PayPal Bank 3,$0.80 ,"$870,274.10 "
PayPal Bank 3,9/23/23,Deposit,9DC61277CU1149933,04 PAYPAL GENERAL UNRESTR,"Subject: GeneralPage
Transaction ID: 9DC61277CU1149933
https://www.paypal.com/activity/payment/9DC61277CU1149933",PayPal Bank 3,--,$668.78 ,"$870,942.88 "
Donations directed by individuals,9/23/23,Deposit,9DC61277CU1149933,04 PAYPAL GENERAL UNRESTR,Support Ukraine - Support Ukraine,Contributed income:Donations directed by individuals,PayPal Bank 3,$700.00 ,"$871,642.88 "
PayPal Fees,9/23/23,Deposit,9DC61277CU1149933,04 PAYPAL GENERAL UNRESTR,PayPal fees,OFFICE/GENERAL ADMINISTRATIVE EXPENSES:PayPal Fees,PayPal Bank 3,$31.22 ,"$871,674.10 "
PayPal Bank 3,9/23/23,Deposit,84G567561B1885244,10 Flight to Recovery RESTR,"Subject: FlightToRecovery
Note: Slava Ukraini, slava Geroyam!
Transaction ID: 84G567561B1885244
https://www.paypal.com/activity/payment/84G567561B1885244",PayPal Bank 3,--,$29.53 ,"$871,703.63 "
Donations directed by individuals,9/23/23,Deposit,84G567561B1885244,10 Flight to Recovery RESTR,Dignitas Ukraine Flight to Recovery - Dignitas Ukraine Flight to Recovery,Contributed income:Donations directed by individuals,PayPal Bank 3,$31.40 ,"$871,735.03 "
PayPal Fees,9/23/23,Deposit,84G567561B1885244,10 Flight to Recovery RESTR,PayPal fees,OFFICE/GENERAL ADMINISTRATIVE EXPENSES:PayPal Fees,PayPal Bank 3,$1.87 ,"$871,736.90 "
PayPal Bank 3,9/23/23,Deposit,7AR37534EM879264J,04 PAYPAL GENERAL UNRESTR,"Subject: GeneralPage
Transaction ID: 7AR37534EM879264J
https://www.paypal.com/activity/payment/7AR37534EM879264J",PayPal Bank 3,--,$100.00 ,"$871,836.90 "
Donations directed by individuals,9/23/23,Deposit,7AR37534EM879264J,04 PAYPAL GENERAL UNRESTR,Support Ukraine - Support Ukraine,Contributed income:Donations directed by individuals,PayPal Bank 3,$103.48 ,"$871,940.38 "
PayPal Fees,9/23/23,Deposit,7AR37534EM879264J,04 PAYPAL GENERAL UNRESTR,PayPal fees,OFFICE/GENERAL ADMINISTRATIVE EXPENSES:PayPal Fees,PayPal Bank 3,$3.48 ,"$871,943.86 "
PayPal Bank 3,9/23/23,Deposit,0TN73263CH345653C,04 PAYPAL GENERAL UNRESTR,"Subject: GeneralPage
Transaction ID: 0TN73263CH345653C
https://www.paypal.com/activity/payment/0TN73263CH345653C",PayPal Bank 3,--,$21.85 ,"$871,965.71 "
Donations directed by individuals,9/23/23,Deposit,0TN73263CH345653C,04 PAYPAL GENERAL UNRESTR,Support Ukraine - Support Ukraine,Contributed income:Donations directed by individuals,PayPal Bank 3,$23.00 ,"$871,988.71 "
PayPal Fees,9/23/23,Deposit,0TN73263CH345653C,04 PAYPAL GENERAL UNRESTR,PayPal fees,OFFICE/GENERAL ADMINISTRATIVE EXPENSES:PayPal Fees,PayPal Bank 3,$1.15 ,"$871,989.86 "
PayPal Bank 3,9/23/23,Deposit,8NV05107CS904944H,04 PAYPAL GENERAL UNRESTR,"Subject: GeneralPage
Transaction ID: 8NV05107CS904944H
https://www.paypal.com/activity/payment/8NV05107CS904944H",PayPal Bank 3,--,$50.00 ,"$872,039.86 "
Donations directed by individuals,9/23/23,Deposit,8NV05107CS904944H,04 PAYPAL GENERAL UNRESTR,Support Ukraine - Support Ukraine,Contributed income:Donations directed by individuals,PayPal Bank 3,$51.99 ,"$872,091.85 "
PayPal Fees,9/23/23,Deposit,8NV05107CS904944H,04 PAYPAL GENERAL UNRESTR,PayPal fees,OFFICE/GENERAL ADMINISTRATIVE EXPENSES:PayPal Fees,PayPal Bank 3,$1.99 ,"$872,093.84 "
PayPal Bank 3,9/23/23,Deposit,67H711754F231324B,09 MSU RESTR,"Subject: MobileShowers
Note: For mobile showers
Transaction ID: 67H711754F231324B
https://www.paypal.com/activity/payment/67H711754F231324B",PayPal Bank 3,--,$48.06 ,"$872,141.90 "
Donations directed by individuals,9/23/23,Deposit,67H711754F231324B,09 MSU RESTR,Mobile Shower/Laundry Units - Mobile Shower/Laundry Units,Contributed income:Donations directed by individuals,PayPal Bank 3,$50.00 ,"$872,191.90 "
PayPal Fees,9/23/23,Deposit,67H711754F231324B,09 MSU RESTR,PayPal fees,OFFICE/GENERAL ADMINISTRATIVE EXPENSES:PayPal Fees,PayPal Bank 3,$1.94 ,"$872,193.84 "
PayPal Bank 3,9/23/23,Deposit,38D17421C6583532P,04 PAYPAL GENERAL UNRESTR,"Subject: GeneralPage
Transaction ID: 38D17421C6583532P
https://www.paypal.com/activity/payment/38D17421C6583532P",PayPal Bank 3,--,$19.68 ,"$872,213.52 "
Donations directed by individuals,9/23/23,Deposit,38D17421C6583532P,04 PAYPAL GENERAL UNRESTR,Support Ukraine - Support Ukraine,Contributed income:Donations directed by individuals,PayPal Bank 3,$21.10 ,"$872,234.62 "
PayPal Fees,9/23/23,Deposit,38D17421C6583532P,04 PAYPAL GENERAL UNRESTR,PayPal fees,OFFICE/GENERAL ADMINISTRATIVE EXPENSES:PayPal Fees,PayPal Bank 3,$1.42 ,"$872,236.04 "
PayPal Bank 3,9/23/23,Deposit,0E07667699921560N,04 PAYPAL GENERAL UNRESTR,"Subject: GeneralPage
Transaction ID: 0E07667699921560N
https://www.paypal.com/activity/payment/0E07667699921560N",PayPal Bank 3,--,$45.00 ,"$872,281.04 "
Donations directed by individuals,9/23/23,Deposit,0E07667699921560N,04 PAYPAL GENERAL UNRESTR,Support Ukraine - Support Ukraine,Contributed income:Donations directed by individuals,PayPal Bank 3,$46.84 ,"$872,327.88 "
PayPal Fees,9/23/23,Deposit,0E07667699921560N,04 PAYPAL GENERAL UNRESTR,PayPal fees,OFFICE/GENERAL ADMINISTRATIVE EXPENSES:PayPal Fees,PayPal Bank 3,$1.84 ,"$872,329.72 "
PayPal Bank 3,9/23/23,Deposit,7CH95711MB5522415,07 1000 DRONES RESTR,"Subject: 1000DRONES
Transaction ID: 7CH95711MB5522415
https://www.paypal.com/activity/payment/7CH95711MB5522415",PayPal Bank 3,--,$98.45 ,"$872,428.17 "
Donations directed by individuals,9/23/23,Deposit,7CH95711MB5522415,07 1000 DRONES RESTR,1000 DRONES FOR UKRAINE - 1000 DRONES FOR UKRAINE,Contributed income:Donations directed by individuals,PayPal Bank 3,$103.48 ,"$872,531.65 "
PayPal Fees,9/23/23,Deposit,7CH95711MB5522415,07 1000 DRONES RESTR,PayPal fees,OFFICE/GENERAL ADMINISTRATIVE EXPENSES:PayPal Fees,PayPal Bank 3,$5.03 ,"$872,536.68 "
PayPal Bank 3,9/23/23,Deposit,9SB27171CE0989104,04 PAYPAL GENERAL UNRESTR,"Subject: GeneralPage
Transaction ID: 9SB27171CE0989104
https://www.paypal.com/activity/payment/9SB27171CE0989104",PayPal Bank 3,--,$19.68 ,"$872,556.36 "
Donations directed by individuals,9/23/23,Deposit,9SB27171CE0989104,04 PAYPAL GENERAL UNRESTR,Support Ukraine - Support Ukraine,Contributed income:Donations directed by individuals,PayPal Bank 3,$21.10 ,"$872,577.46 "
PayPal Fees,9/23/23,Deposit,9SB27171CE0989104,04 PAYPAL GENERAL UNRESTR,PayPal fees,OFFICE/GENERAL ADMINISTRATIVE EXPENSES:PayPal Fees,PayPal Bank 3,$1.42 ,"$872,578.88 "
PayPal Bank 3,9/23/23,Deposit,6EG27504D5378110H,04 PAYPAL GENERAL UNRESTR,"Subject: Support Ukraine
Transaction ID: 6EG27504D5378110H
https://www.paypal.com/activity/payment/6EG27504D5378110H",PayPal Bank 3,--,$98.45 ,"$872,677.33 "
Donations directed by individuals,9/23/23,Deposit,6EG27504D5378110H,04 PAYPAL GENERAL UNRESTR,Money in to PayPal,Contributed income:Donations directed by individuals,PayPal Bank 3,$103.48 ,"$872,780.81 "
PayPal Fees,9/23/23,Deposit,6EG27504D5378110H,04 PAYPAL GENERAL UNRESTR,PayPal fees,OFFICE/GENERAL ADMINISTRATIVE EXPENSES:PayPal Fees,PayPal Bank 3,$5.03 ,"$872,785.84 "
PayPal Bank 3,9/23/23,Deposit,74N40597CA078781W,04 PAYPAL GENERAL UNRESTR,"Subject: Support Ukraine
Transaction ID: 74N40597CA078781W
https://www.paypal.com/activity/payment/74N40597CA078781W",PayPal Bank 3,--,$20.75 ,"$872,806.59 "
Donations directed by individuals,9/23/23,Deposit,74N40597CA078781W,04 PAYPAL GENERAL UNRESTR,Money in to PayPal,Contributed income:Donations directed by individuals,PayPal Bank 3,$22.22 ,"$872,828.81 "
PayPal Fees,9/23/23,Deposit,74N40597CA078781W,04 PAYPAL GENERAL UNRESTR,PayPal fees,OFFICE/GENERAL ADMINISTRATIVE EXPENSES:PayPal Fees,PayPal Bank 3,$1.47 ,"$872,830.28 "
PayPal Bank 3,9/23/23,Deposit,9YF7297233882512E,07 1000 DRONES RESTR,"Subject: FlightToRecovery
Transaction ID: 9YF7297233882512E
https://www.paypal.com/activity/payment/9YF7297233882512E",PayPal Bank 3,--,$295.36 ,"$873,125.64 "
Donations directed by individuals,9/23/23,Deposit,9YF7297233882512E,07 1000 DRONES RESTR,Dignitas Ukraine Flight to Recovery - Dignitas Ukraine Flight to Recovery,Contributed income:Donations directed by individuals,PayPal Bank 3,$309.43 ,"$873,435.07 "
PayPal Fees,9/23/23,Deposit,9YF7297233882512E,07 1000 DRONES RESTR,PayPal fees,OFFICE/GENERAL ADMINISTRATIVE EXPENSES:PayPal Fees,PayPal Bank 3,$14.07 ,"$873,449.14 "
PayPal Bank 3,9/23/23,Deposit,26B35556SE0695930,10 Flight to Recovery RESTR,"Subject: 1000DRONES
Transaction ID: 26B35556SE0695930
https://www.paypal.com/activity/payment/26B35556SE0695930",PayPal Bank 3,--,$295.36 ,"$873,744.50 "
Donations directed by individuals,9/23/23,Deposit,26B35556SE0695930,10 Flight to Recovery RESTR,1000 DRONES FOR UKRAINE - 1000 DRONES FOR UKRAINE,Contributed income:Donations directed by individuals,PayPal Bank 3,$309.43 ,"$874,053.93 "
PayPal Fees,9/23/23,Deposit,26B35556SE0695930,10 Flight to Recovery RESTR,PayPal fees,OFFICE/GENERAL ADMINISTRATIVE EXPENSES:PayPal Fees,PayPal Bank 3,$14.07 ,"$874,068.00 "
PayPal Bank 3,9/23/23,Deposit,4K651821WW903705U,04 PAYPAL GENERAL UNRESTR,"Subject: GeneralPage
Note: Slava Ukraine!
Transaction ID: 4K651821WW903705U
https://www.paypal.com/activity/payment/4K651821WW903705U",PayPal Bank 3,--,$300.00 ,"$874,368.00 "
Donations directed by individuals,9/23/23,Deposit,4K651821WW903705U,04 PAYPAL GENERAL UNRESTR,Support Ukraine - Support Ukraine,Contributed income:Donations directed by individuals,PayPal Bank 3,$309.43 ,"$874,677.43 "
PayPal Fees,9/23/23,Deposit,4K651821WW903705U,04 PAYPAL GENERAL UNRESTR,PayPal fees,OFFICE/GENERAL ADMINISTRATIVE EXPENSES:PayPal Fees,PayPal Bank 3,$9.43 ,"$874,686.86 "
PayPal Bank 3,9/23/23,Deposit,0X237622YS963911F,07 1000 DRONES RESTR,"Subject: 1000DRONES
Transaction ID: 0X237622YS963911F
https://www.paypal.com/activity/payment/0X237622YS963911F",PayPal Bank 3,--,$5.00 ,"$874,691.86 "
Donations directed by individuals,9/23/23,Deposit,0X237622YS963911F,07 1000 DRONES RESTR,1000 DRONES FOR UKRAINE - 1000 DRONES FOR UKRAINE,Contributed income:Donations directed by individuals,PayPal Bank 3,$5.65 ,"$874,697.51 "
PayPal Fees,9/23/23,Deposit,0X237622YS963911F,07 1000 DRONES RESTR,PayPal fees,OFFICE/GENERAL ADMINISTRATIVE EXPENSES:PayPal Fees,PayPal Bank 3,$0.65 ,"$874,698.16 "
PayPal Bank 3,9/23/23,Deposit,1XN54743KS274452V,04 PAYPAL GENERAL UNRESTR,"Subject: GeneralPage
Transaction ID: 1XN54743KS274452V
https://www.paypal.com/activity/payment/1XN54743KS274452V",PayPal Bank 3,--,$98.45 ,"$874,796.61 "
Donations directed by individuals,9/23/23,Deposit,1XN54743KS274452V,04 PAYPAL GENERAL UNRESTR,Support Ukraine - Support Ukraine,Contributed income:Donations directed by individuals,PayPal Bank 3,$103.48 ,"$874,900.09 "
PayPal Fees,9/23/23,Deposit,1XN54743KS274452V,04 PAYPAL GENERAL UNRESTR,PayPal fees,OFFICE/GENERAL ADMINISTRATIVE EXPENSES:PayPal Fees,PayPal Bank 3,$5.03 ,"$874,905.12 "
PayPal Bank 3,9/23/23,Deposit,5YK56674N92542915,07 1000 DRONES RESTR,"Subject: 1000DRONES
Transaction ID: 5YK56674N92542915
https://www.paypal.com/activity/payment/5YK56674N92542915",PayPal Bank 3,--,$2.94 ,"$874,908.06 "
Donations directed by individuals,9/23/23,Deposit,5YK56674N92542915,07 1000 DRONES RESTR,1000 DRONES FOR UKRAINE - 1000 DRONES FOR UKRAINE,Contributed income:Donations directed by individuals,PayPal Bank 3,$3.59 ,"$874,911.65 "
PayPal Fees,9/23/23,Deposit,5YK56674N92542915,07 1000 DRONES RESTR,PayPal fees,OFFICE/GENERAL ADMINISTRATIVE EXPENSES:PayPal Fees,PayPal Bank 3,$0.65 ,"$874,912.30 "
PayPal Bank 3,9/23/23,Deposit,8S807441T9763502Y,08 VICTORY DRONES RESTR,"Subject: VICTORY DRONES
Transaction ID: 8S807441T9763502Y
https://www.paypal.com/activity/payment/8S807441T9763502Y",PayPal Bank 3,--,$2.94 ,"$874,915.24 "
Donations directed by individuals,9/23/23,Deposit,8S807441T9763502Y,08 VICTORY DRONES RESTR,Money in to PayPal,Contributed income:Donations directed by individuals,PayPal Bank 3,$3.59 ,"$874,918.83 "
PayPal Fees,9/23/23,Deposit,8S807441T9763502Y,08 VICTORY DRONES RESTR,PayPal fees,OFFICE/GENERAL ADMINISTRATIVE EXPENSES:PayPal Fees,PayPal Bank 3,$0.65 ,"$874,919.48 "
PayPal Bank 3,9/23/23,Deposit,02333359GX721791V,07 1000 DRONES RESTR,"Subject: 1000DRONES
Transaction ID: 02333359GX721791V
https://www.paypal.com/activity/payment/02333359GX721791V",PayPal Bank 3,--,$100.00 ,"$875,019.48 "
Donations directed by individuals,9/23/23,Deposit,02333359GX721791V,07 1000 DRONES RESTR,1000 DRONES FOR UKRAINE - 1000 DRONES FOR UKRAINE,Contributed income:Donations directed by individuals,PayPal Bank 3,$103.48 ,"$875,122.96 "
PayPal Fees,9/23/23,Deposit,02333359GX721791V,07 1000 DRONES RESTR,PayPal fees,OFFICE/GENERAL ADMINISTRATIVE EXPENSES:PayPal Fees,PayPal Bank 3,$3.48 ,"$875,126.44 "
PayPal Bank 3,9/23/23,Deposit,2Y2197616V9901540,04 PAYPAL GENERAL UNRESTR,"Subject: Support Ukraine
Transaction ID: 2Y2197616V9901540
https://www.paypal.com/activity/payment/2Y2197616V9901540",PayPal Bank 3,--,$98.45 ,"$875,224.89 "
Donations directed by individuals,9/23/23,Deposit,2Y2197616V9901540,04 PAYPAL GENERAL UNRESTR,Money in to PayPal,Contributed income:Donations directed by individuals,PayPal Bank 3,$103.48 ,"$875,328.37 "
PayPal Fees,9/23/23,Deposit,2Y2197616V9901540,04 PAYPAL GENERAL UNRESTR,PayPal fees,OFFICE/GENERAL ADMINISTRATIVE EXPENSES:PayPal Fees,PayPal Bank 3,$5.03 ,"$875,333.40 "
PayPal Bank 3,9/23/23,Deposit,07E60294H34378218,04 PAYPAL GENERAL UNRESTR,"Subject: Support Ukraine
Transaction ID: 07E60294H34378218
https://www.paypal.com/activity/payment/07E60294H34378218",PayPal Bank 3,--,$14.76 ,"$875,348.16 "
Donations directed by individuals,9/23/23,Deposit,07E60294H34378218,04 PAYPAL GENERAL UNRESTR,Money in to PayPal,Contributed income:Donations directed by individuals,PayPal Bank 3,$15.95 ,"$875,364.11 "
PayPal Fees,9/23/23,Deposit,07E60294H34378218,04 PAYPAL GENERAL UNRESTR,PayPal fees,OFFICE/GENERAL ADMINISTRATIVE EXPENSES:PayPal Fees,PayPal Bank 3,$1.19 ,"$875,365.30 "
PayPal Bank 3,9/23/23,Deposit,4SL68460G36896927,04 PAYPAL GENERAL UNRESTR,"Subject: GeneralPage
Transaction ID: 4SL68460G36896927
https://www.paypal.com/activity/payment/4SL68460G36896927",PayPal Bank 3,--,$9.84 ,"$875,375.14 "
Donations directed by individuals,9/23/23,Deposit,4SL68460G36896927,04 PAYPAL GENERAL UNRESTR,Support Ukraine - Support Ukraine,Contributed income:Donations directed by individuals,PayPal Bank 3,$10.80 ,"$875,385.94 "
PayPal Fees,9/23/23,Deposit,4SL68460G36896927,04 PAYPAL GENERAL UNRESTR,PayPal fees,OFFICE/GENERAL ADMINISTRATIVE EXPENSES:PayPal Fees,PayPal Bank 3,$0.96 ,"$875,386.90 "
PayPal Bank 3,9/23/23,Deposit,8DC64498GD116361B,04 PAYPAL GENERAL UNRESTR,"Subject: GeneralPage
Transaction ID: 8DC64498GD116361B
https://www.paypal.com/activity/payment/8DC64498GD116361B",PayPal Bank 3,--,$290.84 ,"$875,677.74 "
Donations directed by individuals,9/23/23,Deposit,8DC64498GD116361B,04 PAYPAL GENERAL UNRESTR,Support Ukraine - Support Ukraine,Contributed income:Donations directed by individuals,PayPal Bank 3,$300.00 ,"$875,977.74 "
PayPal Fees,9/23/23,Deposit,8DC64498GD116361B,04 PAYPAL GENERAL UNRESTR,PayPal fees,OFFICE/GENERAL ADMINISTRATIVE EXPENSES:PayPal Fees,PayPal Bank 3,$9.16 ,"$875,986.90 "
PayPal Bank 3,9/23/23,Deposit,5YH51490YR095101K,04 PAYPAL GENERAL UNRESTR,"Subject: GeneralPage
Transaction ID: 5YH51490YR095101K
https://www.paypal.com/activity/payment/5YH51490YR095101K",PayPal Bank 3,--,$100.00 ,"$876,086.90 "
Donations directed by individuals,9/23/23,Deposit,5YH51490YR095101K,04 PAYPAL GENERAL UNRESTR,Support Ukraine - Support Ukraine,Contributed income:Donations directed by individuals,PayPal Bank 3,$103.48 ,"$876,190.38 "
PayPal Fees,9/23/23,Deposit,5YH51490YR095101K,04 PAYPAL GENERAL UNRESTR,PayPal fees,OFFICE/GENERAL ADMINISTRATIVE EXPENSES:PayPal Fees,PayPal Bank 3,$3.48 ,"$876,193.86 "
PayPal Bank 3,9/23/23,Deposit,6PE84191X58083244,04 PAYPAL GENERAL UNRESTR,"Subject: Support Ukraine
Transaction ID: 6PE84191X58083244
https://www.paypal.com/activity/payment/6PE84191X58083244",PayPal Bank 3,--,$47.25 ,"$876,241.11 "
Donations directed by individuals,9/23/23,Deposit,6PE84191X58083244,04 PAYPAL GENERAL UNRESTR,Money in to PayPal,Contributed income:Donations directed by individuals,PayPal Bank 3,$49.93 ,"$876,291.04 "
PayPal Fees,9/23/23,Deposit,6PE84191X58083244,04 PAYPAL GENERAL UNRESTR,PayPal fees,OFFICE/GENERAL ADMINISTRATIVE EXPENSES:PayPal Fees,PayPal Bank 3,$2.68 ,"$876,293.72 "
PayPal Bank 3,9/23/23,Deposit,5XJ54888PE177950V,07 1000 DRONES RESTR,"Subject: 1000 DRONES FOR UKRAINE
Transaction ID: 5XJ54888PE177950V
https://www.paypal.com/activity/payment/5XJ54888PE177950V",PayPal Bank 3,--,$18.63 ,"$876,312.35 "
Donations directed by individuals,9/23/23,Deposit,5XJ54888PE177950V,07 1000 DRONES RESTR,Money in to PayPal,Contributed income:Donations directed by individuals,PayPal Bank 3,$20.00 ,"$876,332.35 "
PayPal Fees,9/23/23,Deposit,5XJ54888PE177950V,07 1000 DRONES RESTR,PayPal fees,OFFICE/GENERAL ADMINISTRATIVE EXPENSES:PayPal Fees,PayPal Bank 3,$1.37 ,"$876,333.72 "
PayPal Bank 3,9/23/23,Deposit,6PH31114W0689862R,04 PAYPAL GENERAL UNRESTR,"Subject: GeneralPage
Transaction ID: 6PH31114W0689862R
https://www.paypal.com/activity/payment/6PH31114W0689862R",PayPal Bank 3,--,$19.68 ,"$876,353.40 "
Donations directed by individuals,9/23/23,Deposit,6PH31114W0689862R,04 PAYPAL GENERAL UNRESTR,Support Ukraine - Support Ukraine,Contributed income:Donations directed by individuals,PayPal Bank 3,$21.10 ,"$876,374.50 "
PayPal Fees,9/23/23,Deposit,6PH31114W0689862R,04 PAYPAL GENERAL UNRESTR,PayPal fees,OFFICE/GENERAL ADMINISTRATIVE EXPENSES:PayPal Fees,PayPal Bank 3,$1.42 ,"$876,375.92 "
PayPal Bank 3,9/23/23,Deposit,37C00519VP726131D,04 PAYPAL GENERAL UNRESTR,"Subject: Support Ukraine
Transaction ID: 37C00519VP726131D
https://www.paypal.com/activity/payment/37C00519VP726131D",PayPal Bank 3,--,$9.84 ,"$876,385.76 "
Donations directed by individuals,9/23/23,Deposit,37C00519VP726131D,04 PAYPAL GENERAL UNRESTR,Money in to PayPal,Contributed income:Donations directed by individuals,PayPal Bank 3,$10.80 ,"$876,396.56 "
PayPal Fees,9/23/23,Deposit,37C00519VP726131D,04 PAYPAL GENERAL UNRESTR,PayPal fees,OFFICE/GENERAL ADMINISTRATIVE EXPENSES:PayPal Fees,PayPal Bank 3,$0.96 ,"$876,397.52 "
PayPal Bank 3,9/23/23,Deposit,0AR583669N117912H,04 PAYPAL GENERAL UNRESTR,"Subject: GeneralPage
Transaction ID: 0AR583669N117912H
https://www.paypal.com/activity/payment/0AR583669N117912H",PayPal Bank 3,--,$18.63 ,"$876,416.15 "
Donations directed by individuals,9/23/23,Deposit,0AR583669N117912H,04 PAYPAL GENERAL UNRESTR,Support Ukraine - Support Ukraine,Contributed income:Donations directed by individuals,PayPal Bank 3,$20.00 ,"$876,436.15 "
PayPal Fees,9/23/23,Deposit,0AR583669N117912H,04 PAYPAL GENERAL UNRESTR,PayPal fees,OFFICE/GENERAL ADMINISTRATIVE EXPENSES:PayPal Fees,PayPal Bank 3,$1.37 ,"$876,437.52 "
PayPal Bank 3,9/23/23,Deposit,0EP803740P980024N,04 PAYPAL GENERAL UNRESTR,"Subject: GeneralPage
Transaction ID: 0EP803740P980024N
https://www.paypal.com/activity/payment/0EP803740P980024N",PayPal Bank 3,--,$95.12 ,"$876,532.64 "
Donations directed by individuals,9/23/23,Deposit,0EP803740P980024N,04 PAYPAL GENERAL UNRESTR,Support Ukraine - Support Ukraine,Contributed income:Donations directed by individuals,PayPal Bank 3,$100.00 ,"$876,632.64 "
PayPal Fees,9/23/23,Deposit,0EP803740P980024N,04 PAYPAL GENERAL UNRESTR,PayPal fees,OFFICE/GENERAL ADMINISTRATIVE EXPENSES:PayPal Fees,PayPal Bank 3,$4.88 ,"$876,637.52 "
PayPal Bank 3,9/23/23,Deposit,9A624234D1132170G,04 PAYPAL GENERAL UNRESTR,"Subject: GeneralPage
Transaction ID: 9A624234D1132170G
https://www.paypal.com/activity/payment/9A624234D1132170G",PayPal Bank 3,--,$20.00 ,"$876,657.52 "
Donations directed by individuals,9/23/23,Deposit,9A624234D1132170G,04 PAYPAL GENERAL UNRESTR,Support Ukraine - Support Ukraine,Contributed income:Donations directed by individuals,PayPal Bank 3,$21.10 ,"$876,678.62 "
PayPal Fees,9/23/23,Deposit,9A624234D1132170G,04 PAYPAL GENERAL UNRESTR,PayPal fees,OFFICE/GENERAL ADMINISTRATIVE EXPENSES:PayPal Fees,PayPal Bank 3,$1.10 ,"$876,679.72 "
PayPal Bank 3,9/23/23,Deposit,3EW68326M7285463T,04 PAYPAL GENERAL UNRESTR,"Subject: GeneralPage
Transaction ID: 3EW68326M7285463T
https://www.paypal.com/activity/payment/3EW68326M7285463T",PayPal Bank 3,--,$9.84 ,"$876,689.56 "
Donations directed by individuals,9/23/23,Deposit,3EW68326M7285463T,04 PAYPAL GENERAL UNRESTR,Support Ukraine - Support Ukraine,Contributed income:Donations directed by individuals,PayPal Bank 3,$10.80 ,"$876,700.36 "
PayPal Fees,9/23/23,Deposit,3EW68326M7285463T,04 PAYPAL GENERAL UNRESTR,PayPal fees,OFFICE/GENERAL ADMINISTRATIVE EXPENSES:PayPal Fees,PayPal Bank 3,$0.96 ,"$876,701.32 "
PayPal Bank 3,9/23/23,Deposit,9BG3278120805054E,04 PAYPAL GENERAL UNRESTR,"Subject: GeneralPage
Transaction ID: 9BG3278120805054E
https://www.paypal.com/activity/payment/9BG3278120805054E",PayPal Bank 3,--,$98.45 ,"$876,799.77 "
Donations directed by individuals,9/23/23,Deposit,9BG3278120805054E,04 PAYPAL GENERAL UNRESTR,Support Ukraine - Support Ukraine,Contributed income:Donations directed by individuals,PayPal Bank 3,$103.48 ,"$876,903.25 "
PayPal Fees,9/23/23,Deposit,9BG3278120805054E,04 PAYPAL GENERAL UNRESTR,PayPal fees,OFFICE/GENERAL ADMINISTRATIVE EXPENSES:PayPal Fees,PayPal Bank 3,$5.03 ,"$876,908.28 "
PayPal Bank 3,9/23/23,Deposit,5KD90779WN431614W,04 PAYPAL GENERAL UNRESTR,"Subject: GeneralPage
Transaction ID: 5KD90779WN431614W
https://www.paypal.com/activity/payment/5KD90779WN431614W",PayPal Bank 3,--,$29.53 ,"$876,937.81 "
Donations directed by individuals,9/23/23,Deposit,5KD90779WN431614W,04 PAYPAL GENERAL UNRESTR,Support Ukraine - Support Ukraine,Contributed income:Donations directed by individuals,PayPal Bank 3,$31.40 ,"$876,969.21 "
PayPal Fees,9/23/23,Deposit,5KD90779WN431614W,04 PAYPAL GENERAL UNRESTR,PayPal fees,OFFICE/GENERAL ADMINISTRATIVE EXPENSES:PayPal Fees,PayPal Bank 3,$1.87 ,"$876,971.08 "
PayPal Bank 3,9/23/23,Deposit,7S413017L0658415N,04 PAYPAL GENERAL UNRESTR,"Subject: GeneralPage
Transaction ID: 7S413017L0658415N
https://www.paypal.com/activity/payment/7S413017L0658415N",PayPal Bank 3,--,$23.41 ,"$876,994.49 "
Donations directed by individuals,9/23/23,Deposit,7S413017L0658415N,04 PAYPAL GENERAL UNRESTR,Support Ukraine - Support Ukraine,Contributed income:Donations directed by individuals,PayPal Bank 3,$25.00 ,"$877,019.49 "
PayPal Fees,9/23/23,Deposit,7S413017L0658415N,04 PAYPAL GENERAL UNRESTR,PayPal fees,OFFICE/GENERAL ADMINISTRATIVE EXPENSES:PayPal Fees,PayPal Bank 3,$1.59 ,"$877,021.08 "
PayPal Bank 3,9/23/23,Deposit,10493917CT989150R,04 PAYPAL GENERAL UNRESTR,"Subject: GeneralPage
Transaction ID: 10493917CT989150R
https://www.paypal.com/activity/payment/10493917CT989150R",PayPal Bank 3,--,$98.45 ,"$877,119.53 "
Donations directed by individuals,9/23/23,Deposit,10493917CT989150R,04 PAYPAL GENERAL UNRESTR,Support Ukraine - Support Ukraine,Contributed income:Donations directed by individuals,PayPal Bank 3,$103.48 ,"$877,223.01 "
PayPal Fees,9/23/23,Deposit,10493917CT989150R,04 PAYPAL GENERAL UNRESTR,PayPal fees,OFFICE/GENERAL ADMINISTRATIVE EXPENSES:PayPal Fees,PayPal Bank 3,$5.03 ,"$877,228.04 "
PayPal Bank 3,9/23/23,Deposit,1Y165680C37142420,04 PAYPAL GENERAL UNRESTR,"Subject: GeneralPage
Transaction ID: 1Y165680C37142420
https://www.paypal.com/activity/payment/1Y165680C37142420",PayPal Bank 3,--,$19.68 ,"$877,247.72 "
Donations directed by individuals,9/23/23,Deposit,1Y165680C37142420,04 PAYPAL GENERAL UNRESTR,Support Ukraine - Support Ukraine,Contributed income:Donations directed by individuals,PayPal Bank 3,$21.10 ,"$877,268.82 "
PayPal Fees,9/23/23,Deposit,1Y165680C37142420,04 PAYPAL GENERAL UNRESTR,PayPal fees,OFFICE/GENERAL ADMINISTRATIVE EXPENSES:PayPal Fees,PayPal Bank 3,$1.42 ,"$877,270.24 "
PayPal Bank 3,9/23/23,Deposit,03X78893E2039615P,07 1000 DRONES RESTR,"Subject: 1000DRONES
Transaction ID: 03X78893E2039615P
https://www.paypal.com/activity/payment/03X78893E2039615P",PayPal Bank 3,--,$200.00 ,"$877,470.24 "
Donations directed by individuals,9/23/23,Deposit,03X78893E2039615P,07 1000 DRONES RESTR,1000 DRONES FOR UKRAINE - 1000 DRONES FOR UKRAINE,Contributed income:Donations directed by individuals,PayPal Bank 3,$206.46 ,"$877,676.70 "
PayPal Fees,9/23/23,Deposit,03X78893E2039615P,07 1000 DRONES RESTR,PayPal fees,OFFICE/GENERAL ADMINISTRATIVE EXPENSES:PayPal Fees,PayPal Bank 3,$6.46 ,"$877,683.16 "
PayPal Bank 3,9/23/23,Deposit,74T870496J466915S,04 PAYPAL GENERAL UNRESTR,"Subject: Support Ukraine
Transaction ID: 74T870496J466915S
https://www.paypal.com/activity/payment/74T870496J466915S",PayPal Bank 3,--,$19.68 ,"$877,702.84 "
Donations directed by individuals,9/23/23,Deposit,74T870496J466915S,04 PAYPAL GENERAL UNRESTR,Money in to PayPal,Contributed income:Donations directed by individuals,PayPal Bank 3,$21.10 ,"$877,723.94 "
PayPal Fees,9/23/23,Deposit,74T870496J466915S,04 PAYPAL GENERAL UNRESTR,PayPal fees,OFFICE/GENERAL ADMINISTRATIVE EXPENSES:PayPal Fees,PayPal Bank 3,$1.42 ,"$877,725.36 "
PayPal Bank 3,9/23/23,Deposit,4D024371EE604424D,04 PAYPAL GENERAL UNRESTR,"Subject: GeneralPage
Transaction ID: 4D024371EE604424D
https://www.paypal.com/activity/payment/4D024371EE604424D",PayPal Bank 3,--,$50.00 ,"$877,775.36 "
Donations directed by individuals,9/23/23,Deposit,4D024371EE604424D,04 PAYPAL GENERAL UNRESTR,Support Ukraine - Support Ukraine,Contributed income:Donations directed by individuals,PayPal Bank 3,$51.99 ,"$877,827.35 "
PayPal Fees,9/23/23,Deposit,4D024371EE604424D,04 PAYPAL GENERAL UNRESTR,PayPal fees,OFFICE/GENERAL ADMINISTRATIVE EXPENSES:PayPal Fees,PayPal Bank 3,$1.99 ,"$877,829.34 "
PayPal Bank 3,9/23/23,Deposit,5UP96113GW272314S,04 PAYPAL GENERAL UNRESTR,"Subject: GeneralPage
Transaction ID: 5UP96113GW272314S
https://www.paypal.com/activity/payment/5UP96113GW272314S",PayPal Bank 3,--,$96.62 ,"$877,925.96 "
Donations directed by individuals,9/23/23,Deposit,5UP96113GW272314S,04 PAYPAL GENERAL UNRESTR,Support Ukraine - Support Ukraine,Contributed income:Donations directed by individuals,PayPal Bank 3,$100.00 ,"$878,025.96 "
PayPal Fees,9/23/23,Deposit,5UP96113GW272314S,04 PAYPAL GENERAL UNRESTR,PayPal fees,OFFICE/GENERAL ADMINISTRATIVE EXPENSES:PayPal Fees,PayPal Bank 3,$3.38 ,"$878,029.34 "
PayPal Bank 3,9/23/23,Deposit,2YJ551927C9037054,04 PAYPAL GENERAL UNRESTR,"Subject: GeneralPage
Transaction ID: 2YJ551927C9037054
https://www.paypal.com/activity/payment/2YJ551927C9037054",PayPal Bank 3,--,$150.00 ,"$878,179.34 "
Donations directed by individuals,9/23/23,Deposit,2YJ551927C9037054,04 PAYPAL GENERAL UNRESTR,Support Ukraine - Support Ukraine,Contributed income:Donations directed by individuals,PayPal Bank 3,$154.97 ,"$878,334.31 "
PayPal Fees,9/23/23,Deposit,2YJ551927C9037054,04 PAYPAL GENERAL UNRESTR,PayPal fees,OFFICE/GENERAL ADMINISTRATIVE EXPENSES:PayPal Fees,PayPal Bank 3,$4.97 ,"$878,339.28 "
PayPal Bank 3,9/23/23,Deposit,3GT23301W2746432R,04 PAYPAL GENERAL UNRESTR,"Transaction ID: 3GT23301W2746432R
https://www.paypal.com/activity/payment/3GT23301W2746432R",PayPal Bank 3,--,$95.51 ,"$878,434.79 "
Donations directed by individuals,9/23/23,Deposit,3GT23301W2746432R,04 PAYPAL GENERAL UNRESTR,Money in to PayPal,Contributed income:Donations directed by individuals,PayPal Bank 3,$100.00 ,"$878,534.79 "
PayPal Fees,9/23/23,Deposit,3GT23301W2746432R,04 PAYPAL GENERAL UNRESTR,PayPal fees,OFFICE/GENERAL ADMINISTRATIVE EXPENSES:PayPal Fees,PayPal Bank 3,$4.49 ,"$878,539.28 "
PayPal Bank 3,9/23/23,Deposit,6ML112189R870751M,04 PAYPAL GENERAL UNRESTR,"Subject: GeneralPage
Transaction ID: 6ML112189R870751M
https://www.paypal.com/activity/payment/6ML112189R870751M",PayPal Bank 3,--,$11.81 ,"$878,551.09 "
Donations directed by individuals,9/23/23,Deposit,6ML112189R870751M,04 PAYPAL GENERAL UNRESTR,Support Ukraine - Support Ukraine,Contributed income:Donations directed by individuals,PayPal Bank 3,$12.86 ,"$878,563.95 "
PayPal Fees,9/23/23,Deposit,6ML112189R870751M,04 PAYPAL GENERAL UNRESTR,PayPal fees,OFFICE/GENERAL ADMINISTRATIVE EXPENSES:PayPal Fees,PayPal Bank 3,$1.05 ,"$878,565.00 "
PayPal Bank 3,9/23/23,Deposit,3V7230392X1018248,04 PAYPAL GENERAL UNRESTR,"Subject: GeneralPage
Transaction ID: 3V7230392X1018248
https://www.paypal.com/activity/payment/3V7230392X1018248",PayPal Bank 3,--,$29.53 ,"$878,594.53 "
Donations directed by individuals,9/23/23,Deposit,3V7230392X1018248,04 PAYPAL GENERAL UNRESTR,Support Ukraine - Support Ukraine,Contributed income:Donations directed by individuals,PayPal Bank 3,$31.40 ,"$878,625.93 "
PayPal Fees,9/23/23,Deposit,3V7230392X1018248,04 PAYPAL GENERAL UNRESTR,PayPal fees,OFFICE/GENERAL ADMINISTRATIVE EXPENSES:PayPal Fees,PayPal Bank 3,$1.87 ,"$878,627.80 "
PayPal Bank 3,9/23/23,Deposit,83D054725J665890F,04 PAYPAL GENERAL UNRESTR,"Subject: Support Ukraine
Transaction ID: 83D054725J665890F
https://www.paypal.com/activity/payment/83D054725J665890F",PayPal Bank 3,--,$9.07 ,"$878,636.87 "
Donations directed by individuals,9/23/23,Deposit,83D054725J665890F,04 PAYPAL GENERAL UNRESTR,Money in to PayPal,Contributed income:Donations directed by individuals,PayPal Bank 3,$10.00 ,"$878,646.87 "
PayPal Fees,9/23/23,Deposit,83D054725J665890F,04 PAYPAL GENERAL UNRESTR,PayPal fees,OFFICE/GENERAL ADMINISTRATIVE EXPENSES:PayPal Fees,PayPal Bank 3,$0.93 ,"$878,647.80 "
PayPal Bank 3,9/23/23,Deposit,0EJ573644J657291S,04 PAYPAL GENERAL UNRESTR,"Subject: Support Ukraine
Transaction ID: 0EJ573644J657291S
https://www.paypal.com/activity/payment/0EJ573644J657291S",PayPal Bank 3,--,$9.07 ,"$878,656.87 "
Donations directed by individuals,9/23/23,Deposit,0EJ573644J657291S,04 PAYPAL GENERAL UNRESTR,Money in to PayPal,Contributed income:Donations directed by individuals,PayPal Bank 3,$10.00 ,"$878,666.87 "
PayPal Fees,9/23/23,Deposit,0EJ573644J657291S,04 PAYPAL GENERAL UNRESTR,PayPal fees,OFFICE/GENERAL ADMINISTRATIVE EXPENSES:PayPal Fees,PayPal Bank 3,$0.93 ,"$878,667.80 "
PayPal Bank 3,9/23/23,Deposit,3MM72063Y7312125Y,04 PAYPAL GENERAL UNRESTR,"Subject: GeneralPage
Transaction ID: 3MM72063Y7312125Y
https://www.paypal.com/activity/payment/3MM72063Y7312125Y",PayPal Bank 3,--,$50.00 ,"$878,717.80 "
Donations directed by individuals,9/23/23,Deposit,3MM72063Y7312125Y,04 PAYPAL GENERAL UNRESTR,Support Ukraine - Support Ukraine,Contributed income:Donations directed by individuals,PayPal Bank 3,$51.99 ,"$878,769.79 "
PayPal Fees,9/23/23,Deposit,3MM72063Y7312125Y,04 PAYPAL GENERAL UNRESTR,PayPal fees,OFFICE/GENERAL ADMINISTRATIVE EXPENSES:PayPal Fees,PayPal Bank 3,$1.99 ,"$878,771.78 "
PayPal Bank 3,9/23/23,Deposit,6XC226380D552160B,04 PAYPAL GENERAL UNRESTR,"Subject: GeneralPage
Transaction ID: 6XC226380D552160B
https://www.paypal.com/activity/payment/6XC226380D552160B",PayPal Bank 3,--,$43.49 ,"$878,815.27 "
Donations directed by individuals,9/23/23,Deposit,6XC226380D552160B,04 PAYPAL GENERAL UNRESTR,Support Ukraine - Support Ukraine,Contributed income:Donations directed by individuals,PayPal Bank 3,$46.00 ,"$878,861.27 "
PayPal Fees,9/23/23,Deposit,6XC226380D552160B,04 PAYPAL GENERAL UNRESTR,PayPal fees,OFFICE/GENERAL ADMINISTRATIVE EXPENSES:PayPal Fees,PayPal Bank 3,$2.51 ,"$878,863.78 "
PayPal Bank 3,9/23/23,Deposit,83428782YL157182J,08 VICTORY DRONES RESTR,"Subject: VictoryDrones
Transaction ID: 83428782YL157182J
https://www.paypal.com/activity/payment/83428782YL157182J",PayPal Bank 3,--,$147.68 ,"$879,011.46 "
Donations directed by individuals,9/23/23,Deposit,83428782YL157182J,08 VICTORY DRONES RESTR,VICTORY DRONES - VICTORY DRONES,Contributed income:Donations directed by individuals,PayPal Bank 3,$154.97 ,"$879,166.43 "
PayPal Fees,9/23/23,Deposit,83428782YL157182J,08 VICTORY DRONES RESTR,PayPal fees,OFFICE/GENERAL ADMINISTRATIVE EXPENSES:PayPal Fees,PayPal Bank 3,$7.29 ,"$879,173.72 "
PayPal Bank 3,9/23/23,Deposit,2JM39382SK070930A,04 PAYPAL GENERAL UNRESTR,"Subject: Support Ukraine
Transaction ID: 2JM39382SK070930A
https://www.paypal.com/activity/payment/2JM39382SK070930A",PayPal Bank 3,--,$24.61 ,"$879,198.33 "
Donations directed by individuals,9/23/23,Deposit,2JM39382SK070930A,04 PAYPAL GENERAL UNRESTR,Money in to PayPal,Contributed income:Donations directed by individuals,PayPal Bank 3,$26.25 ,"$879,224.58 "
PayPal Fees,9/23/23,Deposit,2JM39382SK070930A,04 PAYPAL GENERAL UNRESTR,PayPal fees,OFFICE/GENERAL ADMINISTRATIVE EXPENSES:PayPal Fees,PayPal Bank 3,$1.64 ,"$879,226.22 "
PayPal Bank 3,9/23/23,Deposit,03378647UA515902H,04 PAYPAL GENERAL UNRESTR,"Subject: Support Ukraine
Transaction ID: 03378647UA515902H
https://www.paypal.com/activity/payment/03378647UA515902H",PayPal Bank 3,--,$50.00 ,"$879,276.22 "
Donations directed by individuals,9/23/23,Deposit,03378647UA515902H,04 PAYPAL GENERAL UNRESTR,Money in to PayPal,Contributed income:Donations directed by individuals,PayPal Bank 3,$51.99 ,"$879,328.21 "
PayPal Fees,9/23/23,Deposit,03378647UA515902H,04 PAYPAL GENERAL UNRESTR,PayPal fees,OFFICE/GENERAL ADMINISTRATIVE EXPENSES:PayPal Fees,PayPal Bank 3,$1.99 ,"$879,330.20 "
PayPal Bank 3,9/23/23,Deposit,0XL750071R888983N,04 PAYPAL GENERAL UNRESTR,"Subject: GeneralPage
Transaction ID: 0XL750071R888983N
https://www.paypal.com/activity/payment/0XL750071R888983N",PayPal Bank 3,--,$98.45 ,"$879,428.65 "
Donations directed by individuals,9/23/23,Deposit,0XL750071R888983N,04 PAYPAL GENERAL UNRESTR,Support Ukraine - Support Ukraine,Contributed income:Donations directed by individuals,PayPal Bank 3,$103.48 ,"$879,532.13 "
PayPal Fees,9/23/23,Deposit,0XL750071R888983N,04 PAYPAL GENERAL UNRESTR,PayPal fees,OFFICE/GENERAL ADMINISTRATIVE EXPENSES:PayPal Fees,PayPal Bank 3,$5.03 ,"$879,537.16 "
PayPal Bank 3,9/23/23,Deposit,0R7292846G9332029,04 PAYPAL GENERAL UNRESTR,"Subject: GeneralPage
Transaction ID: 0R7292846G9332029
https://www.paypal.com/activity/payment/0R7292846G9332029",PayPal Bank 3,--,$56.88 ,"$879,594.04 "
Donations directed by individuals,9/23/23,Deposit,0R7292846G9332029,04 PAYPAL GENERAL UNRESTR,Support Ukraine - Support Ukraine,Contributed income:Donations directed by individuals,PayPal Bank 3,$60.00 ,"$879,654.04 "
PayPal Fees,9/23/23,Deposit,0R7292846G9332029,04 PAYPAL GENERAL UNRESTR,PayPal fees,OFFICE/GENERAL ADMINISTRATIVE EXPENSES:PayPal Fees,PayPal Bank 3,$3.12 ,"$879,657.16 "
PayPal Bank 3,9/23/23,Deposit,7E931665A03787010,07 1000 DRONES RESTR,"Subject: 1000DRONES
Transaction ID: 7E931665A03787010
https://www.paypal.com/activity/payment/7E931665A03787010",PayPal Bank 3,--,$18.63 ,"$879,675.79 "
Donations directed by individuals,9/23/23,Deposit,7E931665A03787010,07 1000 DRONES RESTR,1000 DRONES FOR UKRAINE - 1000 DRONES FOR UKRAINE,Contributed income:Donations directed by individuals,PayPal Bank 3,$20.00 ,"$879,695.79 "
PayPal Fees,9/23/23,Deposit,7E931665A03787010,07 1000 DRONES RESTR,PayPal fees,OFFICE/GENERAL ADMINISTRATIVE EXPENSES:PayPal Fees,PayPal Bank 3,$1.37 ,"$879,697.16 "
PayPal Bank 3,9/23/23,Deposit,0ME91647AV943362U,07 1000 DRONES RESTR,"Subject: 1000DRONES
Transaction ID: 0ME91647AV943362U
https://www.paypal.com/activity/payment/0ME91647AV943362U",PayPal Bank 3,--,$196.91 ,"$879,894.07 "
Donations directed by individuals,9/23/23,Deposit,0ME91647AV943362U,07 1000 DRONES RESTR,1000 DRONES FOR UKRAINE - 1000 DRONES FOR UKRAINE,Contributed income:Donations directed by individuals,PayPal Bank 3,$206.46 ,"$880,100.53 "
PayPal Fees,9/23/23,Deposit,0ME91647AV943362U,07 1000 DRONES RESTR,PayPal fees,OFFICE/GENERAL ADMINISTRATIVE EXPENSES:PayPal Fees,PayPal Bank 3,$9.55 ,"$880,110.08 "
PayPal Bank 3,9/23/23,Deposit,6W579787CF1457611,08 VICTORY DRONES RESTR,"Subject: VictoryDrones
Transaction ID: 6W579787CF1457611
https://www.paypal.com/activity/payment/6W579787CF1457611",PayPal Bank 3,--,$50.00 ,"$880,160.08 "
Donations directed by individuals,9/23/23,Deposit,6W579787CF1457611,08 VICTORY DRONES RESTR,VICTORY DRONES - VICTORY DRONES,Contributed income:Donations directed by individuals,PayPal Bank 3,$51.99 ,"$880,212.07 "
PayPal Fees,9/23/23,Deposit,6W579787CF1457611,08 VICTORY DRONES RESTR,PayPal fees,OFFICE/GENERAL ADMINISTRATIVE EXPENSES:PayPal Fees,PayPal Bank 3,$1.99 ,"$880,214.06 "
PayPal Bank 3,9/23/23,Deposit,50B1273184218024T,07 1000 DRONES RESTR,"Subject: 1000DRONES
Transaction ID: 50B1273184218024T
https://www.paypal.com/activity/payment/50B1273184218024T",PayPal Bank 3,--,$78.76 ,"$880,292.82 "
Donations directed by individuals,9/23/23,Deposit,50B1273184218024T,07 1000 DRONES RESTR,1000 DRONES FOR UKRAINE - 1000 DRONES FOR UKRAINE,Contributed income:Donations directed by individuals,PayPal Bank 3,$82.89 ,"$880,375.71 "
PayPal Fees,9/23/23,Deposit,50B1273184218024T,07 1000 DRONES RESTR,PayPal fees,OFFICE/GENERAL ADMINISTRATIVE EXPENSES:PayPal Fees,PayPal Bank 3,$4.13 ,"$880,379.84 "
PayPal Bank 3,9/23/23,Deposit,8ET648336P1787717,04 PAYPAL GENERAL UNRESTR,"Subject: GeneralPage
Transaction ID: 8ET648336P1787717
https://www.paypal.com/activity/payment/8ET648336P1787717",PayPal Bank 3,--,$96.62 ,"$880,476.46 "
Donations directed by individuals,9/23/23,Deposit,8ET648336P1787717,04 PAYPAL GENERAL UNRESTR,Support Ukraine - Support Ukraine,Contributed income:Donations directed by individuals,PayPal Bank 3,$100.00 ,"$880,576.46 "
PayPal Fees,9/23/23,Deposit,8ET648336P1787717,04 PAYPAL GENERAL UNRESTR,PayPal fees,OFFICE/GENERAL ADMINISTRATIVE EXPENSES:PayPal Fees,PayPal Bank 3,$3.38 ,"$880,579.84 "
PayPal Bank 3,9/23/23,Deposit,4WG825122K733550U,07 1000 DRONES RESTR,"Subject: 1000DRONES
Transaction ID: 4WG825122K733550U
https://www.paypal.com/activity/payment/4WG825122K733550U",PayPal Bank 3,--,$4.91 ,"$880,584.75 "
Donations directed by individuals,9/23/23,Deposit,4WG825122K733550U,07 1000 DRONES RESTR,1000 DRONES FOR UKRAINE - 1000 DRONES FOR UKRAINE,Contributed income:Donations directed by individuals,PayPal Bank 3,$5.65 ,"$880,590.40 "
PayPal Fees,9/23/23,Deposit,4WG825122K733550U,07 1000 DRONES RESTR,PayPal fees,OFFICE/GENERAL ADMINISTRATIVE EXPENSES:PayPal Fees,PayPal Bank 3,$0.74 ,"$880,591.14 "
PayPal Bank 3,9/23/23,Deposit,37T968166T150770Y,04 PAYPAL GENERAL UNRESTR,"Subject: Support Ukraine
Transaction ID: 37T968166T150770Y
https://www.paypal.com/activity/payment/37T968166T150770Y",PayPal Bank 3,--,$19.68 ,"$880,610.82 "
Donations directed by individuals,9/23/23,Deposit,37T968166T150770Y,04 PAYPAL GENERAL UNRESTR,Money in to PayPal,Contributed income:Donations directed by individuals,PayPal Bank 3,$21.10 ,"$880,631.92 "
PayPal Fees,9/23/23,Deposit,37T968166T150770Y,04 PAYPAL GENERAL UNRESTR,PayPal fees,OFFICE/GENERAL ADMINISTRATIVE EXPENSES:PayPal Fees,PayPal Bank 3,$1.42 ,"$880,633.34 "
PayPal Bank 3,9/23/23,Deposit,1AM88865PM313052T,07 1000 DRONES RESTR,"Subject: 1000DRONES
Transaction ID: 1AM88865PM313052T
https://www.paypal.com/activity/payment/1AM88865PM313052T",PayPal Bank 3,--,$300.00 ,"$880,933.34 "
Donations directed by individuals,9/23/23,Deposit,1AM88865PM313052T,07 1000 DRONES RESTR,1000 DRONES FOR UKRAINE - 1000 DRONES FOR UKRAINE,Contributed income:Donations directed by individuals,PayPal Bank 3,$309.43 ,"$881,242.77 "
PayPal Fees,9/23/23,Deposit,1AM88865PM313052T,07 1000 DRONES RESTR,PayPal fees,OFFICE/GENERAL ADMINISTRATIVE EXPENSES:PayPal Fees,PayPal Bank 3,$9.43 ,"$881,252.20 "
PayPal Bank 3,9/23/23,Deposit,7GM91182T20560145,04 PAYPAL GENERAL UNRESTR,"Subject: GeneralPage
Transaction ID: 7GM91182T20560145
https://www.paypal.com/activity/payment/7GM91182T20560145",PayPal Bank 3,--,$179.26 ,"$881,431.46 "
Donations directed by individuals,9/23/23,Deposit,7GM91182T20560145,04 PAYPAL GENERAL UNRESTR,Support Ukraine - Support Ukraine,Contributed income:Donations directed by individuals,PayPal Bank 3,$188.00 ,"$881,619.46 "
PayPal Fees,9/23/23,Deposit,7GM91182T20560145,04 PAYPAL GENERAL UNRESTR,PayPal fees,OFFICE/GENERAL ADMINISTRATIVE EXPENSES:PayPal Fees,PayPal Bank 3,$8.74 ,"$881,628.20 "
PayPal Bank 3,9/23/23,Deposit,814797513S731722X,04 PAYPAL GENERAL UNRESTR,"Subject: GeneralPage
Transaction ID: 814797513S731722X
https://www.paypal.com/activity/payment/814797513S731722X",PayPal Bank 3,--,$56.88 ,"$881,685.08 "
Donations directed by individuals,9/23/23,Deposit,814797513S731722X,04 PAYPAL GENERAL UNRESTR,Support Ukraine - Support Ukraine,Contributed income:Donations directed by individuals,PayPal Bank 3,$60.00 ,"$881,745.08 "
PayPal Fees,9/23/23,Deposit,814797513S731722X,04 PAYPAL GENERAL UNRESTR,PayPal fees,OFFICE/GENERAL ADMINISTRATIVE EXPENSES:PayPal Fees,PayPal Bank 3,$3.12 ,"$881,748.20 "
PayPal Bank 3,9/23/23,Deposit,1J090000TJ948193J,07 1000 DRONES RESTR,"Subject: 1000DRONES
Transaction ID: 1J090000TJ948193J
https://www.paypal.com/activity/payment/1J090000TJ948193J",PayPal Bank 3,--,$500.00 ,"$882,248.20 "
Donations directed by individuals,9/23/23,Deposit,1J090000TJ948193J,07 1000 DRONES RESTR,1000 DRONES FOR UKRAINE - 1000 DRONES FOR UKRAINE,Contributed income:Donations directed by individuals,PayPal Bank 3,$515.38 ,"$882,763.58 "
PayPal Fees,9/23/23,Deposit,1J090000TJ948193J,07 1000 DRONES RESTR,PayPal fees,OFFICE/GENERAL ADMINISTRATIVE EXPENSES:PayPal Fees,PayPal Bank 3,$15.38 ,"$882,778.96 "
PayPal Bank 3,9/23/23,Deposit,55M356677A734003E,04 PAYPAL GENERAL UNRESTR,"Subject: GeneralPage
Transaction ID: 55M356677A734003E
https://www.paypal.com/activity/payment/55M356677A734003E",PayPal Bank 3,--,$4.29 ,"$882,783.25 "
Donations directed by individuals,9/23/23,Deposit,55M356677A734003E,04 PAYPAL GENERAL UNRESTR,Support Ukraine - Support Ukraine,Contributed income:Donations directed by individuals,PayPal Bank 3,$5.00 ,"$882,788.25 "
PayPal Fees,9/23/23,Deposit,55M356677A734003E,04 PAYPAL GENERAL UNRESTR,PayPal fees,OFFICE/GENERAL ADMINISTRATIVE EXPENSES:PayPal Fees,PayPal Bank 3,$0.71 ,"$882,788.96 "
PayPal Bank 3,9/23/23,Deposit,8YX21506GF134004X,08 VICTORY DRONES RESTR,"Subject: VICTORY DRONES
Transaction ID: 8YX21506GF134004X
https://www.paypal.com/activity/payment/8YX21506GF134004X",PayPal Bank 3,--,$2.94 ,"$882,791.90 "
Donations directed by individuals,9/23/23,Deposit,8YX21506GF134004X,08 VICTORY DRONES RESTR,Money in to PayPal,Contributed income:Donations directed by individuals,PayPal Bank 3,$3.59 ,"$882,795.49 "
PayPal Fees,9/23/23,Deposit,8YX21506GF134004X,08 VICTORY DRONES RESTR,PayPal fees,OFFICE/GENERAL ADMINISTRATIVE EXPENSES:PayPal Fees,PayPal Bank 3,$0.65 ,"$882,796.14 "
PayPal Bank 3,9/23/23,Deposit,1M9138826F965090E,04 PAYPAL GENERAL UNRESTR,"Subject: Support Ukraine
Transaction ID: 1M9138826F965090E
https://www.paypal.com/activity/payment/1M9138826F965090E",PayPal Bank 3,--,$295.36 ,"$883,091.50 "
Donations directed by individuals,9/23/23,Deposit,1M9138826F965090E,04 PAYPAL GENERAL UNRESTR,Money in to PayPal,Contributed income:Donations directed by individuals,PayPal Bank 3,$309.43 ,"$883,400.93 "
PayPal Fees,9/23/23,Deposit,1M9138826F965090E,04 PAYPAL GENERAL UNRESTR,PayPal fees,OFFICE/GENERAL ADMINISTRATIVE EXPENSES:PayPal Fees,PayPal Bank 3,$14.07 ,"$883,415.00 "
PayPal Bank 3,9/23/23,Deposit,6E1852743E7625219,07 1000 DRONES RESTR,"Subject: 1000DRONES
Transaction ID: 6E1852743E7625219
https://www.paypal.com/activity/payment/6E1852743E7625219",PayPal Bank 3,--,$39.37 ,"$883,454.37 "
Donations directed by individuals,9/23/23,Deposit,6E1852743E7625219,07 1000 DRONES RESTR,1000 DRONES FOR UKRAINE - 1000 DRONES FOR UKRAINE,Contributed income:Donations directed by individuals,PayPal Bank 3,$41.69 ,"$883,496.06 "
PayPal Fees,9/23/23,Deposit,6E1852743E7625219,07 1000 DRONES RESTR,PayPal fees,OFFICE/GENERAL ADMINISTRATIVE EXPENSES:PayPal Fees,PayPal Bank 3,$2.32 ,"$883,498.38 "
PayPal Bank 3,9/23/23,Deposit,2K874654LD241973L,04 PAYPAL GENERAL UNRESTR,"Subject: GeneralPage
Transaction ID: 2K874654LD241973L
https://www.paypal.com/activity/payment/2K874654LD241973L",PayPal Bank 3,--,$9.84 ,"$883,508.22 "
Donations directed by individuals,9/23/23,Deposit,2K874654LD241973L,04 PAYPAL GENERAL UNRESTR,Support Ukraine - Support Ukraine,Contributed income:Donations directed by individuals,PayPal Bank 3,$10.80 ,"$883,519.02 "
PayPal Fees,9/23/23,Deposit,2K874654LD241973L,04 PAYPAL GENERAL UNRESTR,PayPal fees,OFFICE/GENERAL ADMINISTRATIVE EXPENSES:PayPal Fees,PayPal Bank 3,$0.96 ,"$883,519.98 "
PayPal Bank 3,9/23/23,Deposit,2TL73642MY450052M,04 PAYPAL GENERAL UNRESTR,"Subject: GeneralPage
Transaction ID: 2TL73642MY450052M
https://www.paypal.com/activity/payment/2TL73642MY450052M",PayPal Bank 3,--,$984.54 ,"$884,504.52 "
Donations directed by individuals,9/23/23,Deposit,2TL73642MY450052M,04 PAYPAL GENERAL UNRESTR,Support Ukraine - Support Ukraine,Contributed income:Donations directed by individuals,PayPal Bank 3,"$1,030.26 ","$885,534.78 "
PayPal Fees,9/23/23,Deposit,2TL73642MY450052M,04 PAYPAL GENERAL UNRESTR,PayPal fees,OFFICE/GENERAL ADMINISTRATIVE EXPENSES:PayPal Fees,PayPal Bank 3,$45.72 ,"$885,580.50 "
PayPal Bank 3,9/23/23,Deposit,2R956744K07362254,07 1000 DRONES RESTR,"Subject: 1000DRONES
Transaction ID: 2R956744K07362254
https://www.paypal.com/activity/payment/2R956744K07362254",PayPal Bank 3,--,$50.00 ,"$885,630.50 "
Donations directed by individuals,9/23/23,Deposit,2R956744K07362254,07 1000 DRONES RESTR,1000 DRONES FOR UKRAINE - 1000 DRONES FOR UKRAINE,Contributed income:Donations directed by individuals,PayPal Bank 3,$51.99 ,"$885,682.49 "
PayPal Fees,9/23/23,Deposit,2R956744K07362254,07 1000 DRONES RESTR,PayPal fees,OFFICE/GENERAL ADMINISTRATIVE EXPENSES:PayPal Fees,PayPal Bank 3,$1.99 ,"$885,684.48 "
PayPal Bank 3,9/23/23,Deposit,5W603213F4199803D,04 PAYPAL GENERAL UNRESTR,"Subject: GeneralPage
Transaction ID: 5W603213F4199803D
https://www.paypal.com/activity/payment/5W603213F4199803D",PayPal Bank 3,--,$28.19 ,"$885,712.67 "
Donations directed by individuals,9/23/23,Deposit,5W603213F4199803D,04 PAYPAL GENERAL UNRESTR,Support Ukraine - Support Ukraine,Contributed income:Donations directed by individuals,PayPal Bank 3,$30.00 ,"$885,742.67 "
PayPal Fees,9/23/23,Deposit,5W603213F4199803D,04 PAYPAL GENERAL UNRESTR,PayPal fees,OFFICE/GENERAL ADMINISTRATIVE EXPENSES:PayPal Fees,PayPal Bank 3,$1.81 ,"$885,744.48 "
PayPal Bank 3,9/23/23,Deposit,56870444WL507231L,04 PAYPAL GENERAL UNRESTR,"Transaction ID: 56870444WL507231L
https://www.paypal.com/activity/payment/56870444WL507231L",PayPal Bank 3,--,$29.70 ,"$885,774.18 "
Donations directed by individuals,9/23/23,Deposit,56870444WL507231L,04 PAYPAL GENERAL UNRESTR,Money in to PayPal,Contributed income:Donations directed by individuals,PayPal Bank 3,$31.10 ,"$885,805.28 "
PayPal Fees,9/23/23,Deposit,56870444WL507231L,04 PAYPAL GENERAL UNRESTR,PayPal fees,OFFICE/GENERAL ADMINISTRATIVE EXPENSES:PayPal Fees,PayPal Bank 3,$1.40 ,"$885,806.68 "
PayPal Bank 3,9/23/23,Deposit,30L89620DJ600733L,04 PAYPAL GENERAL UNRESTR,"Subject: GeneralPage
Transaction ID: 30L89620DJ600733L
https://www.paypal.com/activity/payment/30L89620DJ600733L",PayPal Bank 3,--,$48.06 ,"$885,854.74 "
Donations directed by individuals,9/23/23,Deposit,30L89620DJ600733L,04 PAYPAL GENERAL UNRESTR,Support Ukraine - Support Ukraine,Contributed income:Donations directed by individuals,PayPal Bank 3,$50.00 ,"$885,904.74 "
PayPal Fees,9/23/23,Deposit,30L89620DJ600733L,04 PAYPAL GENERAL UNRESTR,PayPal fees,OFFICE/GENERAL ADMINISTRATIVE EXPENSES:PayPal Fees,PayPal Bank 3,$1.94 ,"$885,906.68 "
PayPal Bank 3,9/23/23,Deposit,4JP64523GY4382219,07 1000 DRONES RESTR,"Subject: 1000DRONES
Transaction ID: 4JP64523GY4382219
https://www.paypal.com/activity/payment/4JP64523GY4382219",PayPal Bank 3,--,$95.12 ,"$886,001.80 "
Donations directed by individuals,9/23/23,Deposit,4JP64523GY4382219,07 1000 DRONES RESTR,1000 DRONES FOR UKRAINE - 1000 DRONES FOR UKRAINE,Contributed income:Donations directed by individuals,PayPal Bank 3,$100.00 ,"$886,101.80 "
PayPal Fees,9/23/23,Deposit,4JP64523GY4382219,07 1000 DRONES RESTR,PayPal fees,OFFICE/GENERAL ADMINISTRATIVE EXPENSES:PayPal Fees,PayPal Bank 3,$4.88 ,"$886,106.68 "
PayPal Bank 3,9/23/23,Deposit,9J000095K60969356,04 PAYPAL GENERAL UNRESTR,"Subject: GeneralPage
Transaction ID: 9J000095K60969356
https://www.paypal.com/activity/payment/9J000095K60969356",PayPal Bank 3,--,$150.00 ,"$886,256.68 "
Donations directed by individuals,9/23/23,Deposit,9J000095K60969356,04 PAYPAL GENERAL UNRESTR,Support Ukraine - Support Ukraine,Contributed income:Donations directed by individuals,PayPal Bank 3,$154.97 ,"$886,411.65 "
PayPal Fees,9/23/23,Deposit,9J000095K60969356,04 PAYPAL GENERAL UNRESTR,PayPal fees,OFFICE/GENERAL ADMINISTRATIVE EXPENSES:PayPal Fees,PayPal Bank 3,$4.97 ,"$886,416.62 "
PayPal Bank 3,9/23/23,Deposit,42L88251WU3933024,04 PAYPAL GENERAL UNRESTR,"Subject: GeneralPage
Transaction ID: 42L88251WU3933024
https://www.paypal.com/activity/payment/42L88251WU3933024",PayPal Bank 3,--,$95.12 ,"$886,511.74 "
Donations directed by individuals,9/23/23,Deposit,42L88251WU3933024,04 PAYPAL GENERAL UNRESTR,Support Ukraine - Support Ukraine,Contributed income:Donations directed by individuals,PayPal Bank 3,$100.00 ,"$886,611.74 "
PayPal Fees,9/23/23,Deposit,42L88251WU3933024,04 PAYPAL GENERAL UNRESTR,PayPal fees,OFFICE/GENERAL ADMINISTRATIVE EXPENSES:PayPal Fees,PayPal Bank 3,$4.88 ,"$886,616.62 "
PayPal Bank 3,9/23/23,Deposit,5UA71580HH172350S,04 PAYPAL GENERAL UNRESTR,"Subject: GeneralPage
Transaction ID: 5UA71580HH172350S
https://www.paypal.com/activity/payment/5UA71580HH172350S",PayPal Bank 3,--,$14.76 ,"$886,631.38 "
Donations directed by individuals,9/23/23,Deposit,5UA71580HH172350S,04 PAYPAL GENERAL UNRESTR,Support Ukraine - Support Ukraine,Contributed income:Donations directed by individuals,PayPal Bank 3,$15.95 ,"$886,647.33 "
PayPal Fees,9/23/23,Deposit,5UA71580HH172350S,04 PAYPAL GENERAL UNRESTR,PayPal fees,OFFICE/GENERAL ADMINISTRATIVE EXPENSES:PayPal Fees,PayPal Bank 3,$1.19 ,"$886,648.52 "
PayPal Bank 3,9/23/23,Deposit,89U61364UP507803L,07 1000 DRONES RESTR,"Subject: 1000DRONES
Transaction ID: 89U61364UP507803L
https://www.paypal.com/activity/payment/89U61364UP507803L",PayPal Bank 3,--,$100.00 ,"$886,748.52 "
Donations directed by individuals,9/23/23,Deposit,89U61364UP507803L,07 1000 DRONES RESTR,1000 DRONES FOR UKRAINE - 1000 DRONES FOR UKRAINE,Contributed income:Donations directed by individuals,PayPal Bank 3,$103.48 ,"$886,852.00 "
PayPal Fees,9/23/23,Deposit,89U61364UP507803L,07 1000 DRONES RESTR,PayPal fees,OFFICE/GENERAL ADMINISTRATIVE EXPENSES:PayPal Fees,PayPal Bank 3,$3.48 ,"$886,855.48 "
PayPal Bank 3,9/23/23,Deposit,6JT11453Y2818021S,04 PAYPAL GENERAL UNRESTR,"Subject: GeneralPage
Transaction ID: 6JT11453Y2818021S
https://www.paypal.com/activity/payment/6JT11453Y2818021S",PayPal Bank 3,--,$100.00 ,"$886,955.48 "
Donations directed by individuals,9/23/23,Deposit,6JT11453Y2818021S,04 PAYPAL GENERAL UNRESTR,Support Ukraine - Support Ukraine,Contributed income:Donations directed by individuals,PayPal Bank 3,$103.48 ,"$887,058.96 "
PayPal Fees,9/23/23,Deposit,6JT11453Y2818021S,04 PAYPAL GENERAL UNRESTR,PayPal fees,OFFICE/GENERAL ADMINISTRATIVE EXPENSES:PayPal Fees,PayPal Bank 3,$3.48 ,"$887,062.44 "
PayPal Bank 3,9/23/23,Deposit,2KR67177EA2101107,04 PAYPAL GENERAL UNRESTR,"Subject: GeneralPage
Transaction ID: 2KR67177EA2101107
https://www.paypal.com/activity/payment/2KR67177EA2101107",PayPal Bank 3,--,$28.64 ,"$887,091.08 "
Donations directed by individuals,9/23/23,Deposit,2KR67177EA2101107,04 PAYPAL GENERAL UNRESTR,Support Ukraine - Support Ukraine,Contributed income:Donations directed by individuals,PayPal Bank 3,$30.00 ,"$887,121.08 "
PayPal Fees,9/23/23,Deposit,2KR67177EA2101107,04 PAYPAL GENERAL UNRESTR,PayPal fees,OFFICE/GENERAL ADMINISTRATIVE EXPENSES:PayPal Fees,PayPal Bank 3,$1.36 ,"$887,122.44 "
PayPal Bank 3,9/23/23,Deposit,3AA40702N9238421F,04 PAYPAL GENERAL UNRESTR,"Subject: GeneralPage
Transaction ID: 3AA40702N9238421F
https://www.paypal.com/activity/payment/3AA40702N9238421F",PayPal Bank 3,--,$49.22 ,"$887,171.66 "
Donations directed by individuals,9/23/23,Deposit,3AA40702N9238421F,04 PAYPAL GENERAL UNRESTR,Support Ukraine - Support Ukraine,Contributed income:Donations directed by individuals,PayPal Bank 3,$51.99 ,"$887,223.65 "
PayPal Fees,9/23/23,Deposit,3AA40702N9238421F,04 PAYPAL GENERAL UNRESTR,PayPal fees,OFFICE/GENERAL ADMINISTRATIVE EXPENSES:PayPal Fees,PayPal Bank 3,$2.77 ,"$887,226.42 "
PayPal Bank 3,9/23/23,Deposit,7JA06279JP053780G,04 PAYPAL GENERAL UNRESTR,"Subject: GeneralPage
Transaction ID: 7JA06279JP053780G
https://www.paypal.com/activity/payment/7JA06279JP053780G",PayPal Bank 3,--,$485.06 ,"$887,711.48 "
Donations directed by individuals,9/23/23,Deposit,7JA06279JP053780G,04 PAYPAL GENERAL UNRESTR,Support Ukraine - Support Ukraine,Contributed income:Donations directed by individuals,PayPal Bank 3,$500.00 ,"$888,211.48 "
PayPal Fees,9/23/23,Deposit,7JA06279JP053780G,04 PAYPAL GENERAL UNRESTR,PayPal fees,OFFICE/GENERAL ADMINISTRATIVE EXPENSES:PayPal Fees,PayPal Bank 3,$14.94 ,"$888,226.42 "
PayPal Bank 3,9/23/23,Deposit,9VG37145HJ154410H,04 PAYPAL GENERAL UNRESTR,"Subject: GeneralPage
Transaction ID: 9VG37145HJ154410H
https://www.paypal.com/activity/payment/9VG37145HJ154410H",PayPal Bank 3,--,$33.47 ,"$888,259.89 "
Donations directed by individuals,9/23/23,Deposit,9VG37145HJ154410H,04 PAYPAL GENERAL UNRESTR,Support Ukraine - Support Ukraine,Contributed income:Donations directed by individuals,PayPal Bank 3,$35.52 ,"$888,295.41 "
PayPal Fees,9/23/23,Deposit,9VG37145HJ154410H,04 PAYPAL GENERAL UNRESTR,PayPal fees,OFFICE/GENERAL ADMINISTRATIVE EXPENSES:PayPal Fees,PayPal Bank 3,$2.05 ,"$888,297.46 "
PayPal Bank 3,9/23/23,Deposit,54A48154P06585502,04 PAYPAL GENERAL UNRESTR,"Subject: GeneralPage
Note: Advertisement in Immigrant Porada
Transaction ID: 54A48154P06585502
https://www.paypal.com/activity/payment/54A48154P06585502",PayPal Bank 3,--,$50.00 ,"$888,347.46 "
Donations directed by individuals,9/23/23,Deposit,54A48154P06585502,04 PAYPAL GENERAL UNRESTR,Support Ukraine - Support Ukraine,Contributed income:Donations directed by individuals,PayPal Bank 3,$51.99 ,"$888,399.45 "
PayPal Fees,9/23/23,Deposit,54A48154P06585502,04 PAYPAL GENERAL UNRESTR,PayPal fees,OFFICE/GENERAL ADMINISTRATIVE EXPENSES:PayPal Fees,PayPal Bank 3,$1.99 ,"$888,401.44 "
PayPal Bank 3,9/23/23,Deposit,59462870L1711745C,04 PAYPAL GENERAL UNRESTR,"Subject: GeneralPage
Transaction ID: 59462870L1711745C
https://www.paypal.com/activity/payment/59462870L1711745C",PayPal Bank 3,--,$300.00 ,"$888,701.44 "
Donations directed by individuals,9/23/23,Deposit,59462870L1711745C,04 PAYPAL GENERAL UNRESTR,Support Ukraine - Support Ukraine,Contributed income:Donations directed by individuals,PayPal Bank 3,$309.43 ,"$889,010.87 "
PayPal Fees,9/23/23,Deposit,59462870L1711745C,04 PAYPAL GENERAL UNRESTR,PayPal fees,OFFICE/GENERAL ADMINISTRATIVE EXPENSES:PayPal Fees,PayPal Bank 3,$9.43 ,"$889,020.30 "
PayPal Bank 3,9/23/23,Deposit,4Y55306342583315J,07 1000 DRONES RESTR,"Subject: 1000DRONES
Transaction ID: 4Y55306342583315J
https://www.paypal.com/activity/payment/4Y55306342583315J",PayPal Bank 3,--,$485.06 ,"$889,505.36 "
Donations directed by individuals,9/23/23,Deposit,4Y55306342583315J,07 1000 DRONES RESTR,1000 DRONES FOR UKRAINE - 1000 DRONES FOR UKRAINE,Contributed income:Donations directed by individuals,PayPal Bank 3,$500.00 ,"$890,005.36 "
PayPal Fees,9/23/23,Deposit,4Y55306342583315J,07 1000 DRONES RESTR,PayPal fees,OFFICE/GENERAL ADMINISTRATIVE EXPENSES:PayPal Fees,PayPal Bank 3,$14.94 ,"$890,020.30 "
PayPal Bank 3,9/23/23,Deposit,3SH92116BT6873141,04 PAYPAL GENERAL UNRESTR,"Subject: Support Ukraine
Transaction ID: 3SH92116BT6873141
https://www.paypal.com/activity/payment/3SH92116BT6873141",PayPal Bank 3,--,$98.45 ,"$890,118.75 "
Donations directed by individuals,9/23/23,Deposit,3SH92116BT6873141,04 PAYPAL GENERAL UNRESTR,Money in to PayPal,Contributed income:Donations directed by individuals,PayPal Bank 3,$103.48 ,"$890,222.23 "
PayPal Fees,9/23/23,Deposit,3SH92116BT6873141,04 PAYPAL GENERAL UNRESTR,PayPal fees,OFFICE/GENERAL ADMINISTRATIVE EXPENSES:PayPal Fees,PayPal Bank 3,$5.03 ,"$890,227.26 "
PayPal Bank 3,9/23/23,Deposit,3UG31484WW383721H,04 PAYPAL GENERAL UNRESTR,"Subject: GeneralPage
Transaction ID: 3UG31484WW383721H
https://www.paypal.com/activity/payment/3UG31484WW383721H",PayPal Bank 3,--,$47.31 ,"$890,274.57 "
Donations directed by individuals,9/23/23,Deposit,3UG31484WW383721H,04 PAYPAL GENERAL UNRESTR,Support Ukraine - Support Ukraine,Contributed income:Donations directed by individuals,PayPal Bank 3,$50.00 ,"$890,324.57 "
PayPal Fees,9/23/23,Deposit,3UG31484WW383721H,04 PAYPAL GENERAL UNRESTR,PayPal fees,OFFICE/GENERAL ADMINISTRATIVE EXPENSES:PayPal Fees,PayPal Bank 3,$2.69 ,"$890,327.26 "
PayPal Bank 3,9/23/23,Deposit,5J268388MC176994C,08 VICTORY DRONES RESTR,"Subject: VICTORY DRONES
Transaction ID: 5J268388MC176994C
https://www.paypal.com/activity/payment/5J268388MC176994C",PayPal Bank 3,--,$100.00 ,"$890,427.26 "
Donations directed by individuals,9/23/23,Deposit,5J268388MC176994C,08 VICTORY DRONES RESTR,Money in to PayPal,Contributed income:Donations directed by individuals,PayPal Bank 3,$103.48 ,"$890,530.74 "
PayPal Fees,9/23/23,Deposit,5J268388MC176994C,08 VICTORY DRONES RESTR,PayPal fees,OFFICE/GENERAL ADMINISTRATIVE EXPENSES:PayPal Fees,PayPal Bank 3,$3.48 ,"$890,534.22 "
PayPal Bank 3,9/23/23,Deposit,0GA75210G10762703,04 PAYPAL GENERAL UNRESTR,"Subject: GeneralPage
Transaction ID: 0GA75210G10762703
https://www.paypal.com/activity/payment/0GA75210G10762703",PayPal Bank 3,--,$120.00 ,"$890,654.22 "
Donations directed by individuals,9/23/23,Deposit,0GA75210G10762703,04 PAYPAL GENERAL UNRESTR,Support Ukraine - Support Ukraine,Contributed income:Donations directed by individuals,PayPal Bank 3,$124.08 ,"$890,778.30 "
PayPal Fees,9/23/23,Deposit,0GA75210G10762703,04 PAYPAL GENERAL UNRESTR,PayPal fees,OFFICE/GENERAL ADMINISTRATIVE EXPENSES:PayPal Fees,PayPal Bank 3,$4.08 ,"$890,782.38 "
PayPal Bank 3,9/23/23,Deposit,56777134BK2851236,04 PAYPAL GENERAL UNRESTR,"Subject: GeneralPage
Transaction ID: 56777134BK2851236
https://www.paypal.com/activity/payment/56777134BK2851236",PayPal Bank 3,--,$120.00 ,"$890,902.38 "
Donations directed by individuals,9/23/23,Deposit,56777134BK2851236,04 PAYPAL GENERAL UNRESTR,Support Ukraine - Support Ukraine,Contributed income:Donations directed by individuals,PayPal Bank 3,$124.08 ,"$891,026.46 "
PayPal Fees,9/23/23,Deposit,56777134BK2851236,04 PAYPAL GENERAL UNRESTR,PayPal fees,OFFICE/GENERAL ADMINISTRATIVE EXPENSES:PayPal Fees,PayPal Bank 3,$4.08 ,"$891,030.54 "
PayPal Bank 3,9/23/23,Deposit,1X6852961R969633B,04 PAYPAL GENERAL UNRESTR,"Subject: GeneralPage
Transaction ID: 1X6852961R969633B
https://www.paypal.com/activity/payment/1X6852961R969633B",PayPal Bank 3,--,"$1,000.00 ","$892,030.54 "
Donations directed by individuals,9/23/23,Deposit,1X6852961R969633B,04 PAYPAL GENERAL UNRESTR,Support Ukraine - Support Ukraine,Contributed income:Donations directed by individuals,PayPal Bank 3,"$1,030.26 ","$893,060.80 "
PayPal Fees,9/23/23,Deposit,1X6852961R969633B,04 PAYPAL GENERAL UNRESTR,PayPal fees,OFFICE/GENERAL ADMINISTRATIVE EXPENSES:PayPal Fees,PayPal Bank 3,$30.26 ,"$893,091.06 "
PayPal Bank 3,9/23/23,Deposit,1DJ25972B81607007,04 PAYPAL GENERAL UNRESTR,"Subject: Support Ukraine
Transaction ID: 1DJ25972B81607007
https://www.paypal.com/activity/payment/1DJ25972B81607007",PayPal Bank 3,--,$50.00 ,"$893,141.06 "
Donations directed by individuals,9/23/23,Deposit,1DJ25972B81607007,04 PAYPAL GENERAL UNRESTR,Money in to PayPal,Contributed income:Donations directed by individuals,PayPal Bank 3,$51.99 ,"$893,193.05 "
PayPal Fees,9/23/23,Deposit,1DJ25972B81607007,04 PAYPAL GENERAL UNRESTR,PayPal fees,OFFICE/GENERAL ADMINISTRATIVE EXPENSES:PayPal Fees,PayPal Bank 3,$1.99 ,"$893,195.04 "
PayPal Bank 3,9/23/23,Deposit,3AE30931TY8746800,04 PAYPAL GENERAL UNRESTR,"Subject: Support Ukraine
Transaction ID: 3AE30931TY8746800
https://www.paypal.com/activity/payment/3AE30931TY8746800",PayPal Bank 3,--,$9.84 ,"$893,204.88 "
Donations directed by individuals,9/23/23,Deposit,3AE30931TY8746800,04 PAYPAL GENERAL UNRESTR,Money in to PayPal,Contributed income:Donations directed by individuals,PayPal Bank 3,$10.80 ,"$893,215.68 "
PayPal Fees,9/23/23,Deposit,3AE30931TY8746800,04 PAYPAL GENERAL UNRESTR,PayPal fees,OFFICE/GENERAL ADMINISTRATIVE EXPENSES:PayPal Fees,PayPal Bank 3,$0.96 ,"$893,216.64 "
PayPal Bank 3,9/23/23,Deposit,65U23597T2978325V,04 PAYPAL GENERAL UNRESTR,"Subject: Support Ukraine
Transaction ID: 65U23597T2978325V
https://www.paypal.com/activity/payment/65U23597T2978325V",PayPal Bank 3,--,$24.61 ,"$893,241.25 "
Donations directed by individuals,9/23/23,Deposit,65U23597T2978325V,04 PAYPAL GENERAL UNRESTR,Money in to PayPal,Contributed income:Donations directed by individuals,PayPal Bank 3,$26.25 ,"$893,267.50 "
PayPal Fees,9/23/23,Deposit,65U23597T2978325V,04 PAYPAL GENERAL UNRESTR,PayPal fees,OFFICE/GENERAL ADMINISTRATIVE EXPENSES:PayPal Fees,PayPal Bank 3,$1.64 ,"$893,269.14 "
PayPal Bank 3,9/23/23,Deposit,34R17728VT877705U,04 PAYPAL GENERAL UNRESTR,"Subject: Support Ukraine
Transaction ID: 34R17728VT877705U
https://www.paypal.com/activity/payment/34R17728VT877705U",PayPal Bank 3,--,$4.91 ,"$893,274.05 "
Donations directed by individuals,9/23/23,Deposit,34R17728VT877705U,04 PAYPAL GENERAL UNRESTR,Money in to PayPal,Contributed income:Donations directed by individuals,PayPal Bank 3,$5.65 ,"$893,279.70 "
PayPal Fees,9/23/23,Deposit,34R17728VT877705U,04 PAYPAL GENERAL UNRESTR,PayPal fees,OFFICE/GENERAL ADMINISTRATIVE EXPENSES:PayPal Fees,PayPal Bank 3,$0.74 ,"$893,280.44 "
PayPal Bank 3,9/23/23,Deposit,8CJ215698J065660D,04 PAYPAL GENERAL UNRESTR,"Subject: Support Ukraine
Transaction ID: 8CJ215698J065660D
https://www.paypal.com/activity/payment/8CJ215698J065660D",PayPal Bank 3,--,$147.68 ,"$893,428.12 "
Donations directed by individuals,9/23/23,Deposit,8CJ215698J065660D,04 PAYPAL GENERAL UNRESTR,Money in to PayPal,Contributed income:Donations directed by individuals,PayPal Bank 3,$154.97 ,"$893,583.09 "
PayPal Fees,9/23/23,Deposit,8CJ215698J065660D,04 PAYPAL GENERAL UNRESTR,PayPal fees,OFFICE/GENERAL ADMINISTRATIVE EXPENSES:PayPal Fees,PayPal Bank 3,$7.29 ,"$893,590.38 "
PayPal Bank 3,9/23/23,Deposit,1W636452MY857735A,04 PAYPAL GENERAL UNRESTR,"Subject: GeneralPage
Transaction ID: 1W636452MY857735A
https://www.paypal.com/activity/payment/1W636452MY857735A",PayPal Bank 3,--,$152.60 ,"$893,742.98 "
Donations directed by individuals,9/23/23,Deposit,1W636452MY857735A,04 PAYPAL GENERAL UNRESTR,Support Ukraine - Support Ukraine,Contributed income:Donations directed by individuals,PayPal Bank 3,$160.12 ,"$893,903.10 "
PayPal Fees,9/23/23,Deposit,1W636452MY857735A,04 PAYPAL GENERAL UNRESTR,PayPal fees,OFFICE/GENERAL ADMINISTRATIVE EXPENSES:PayPal Fees,PayPal Bank 3,$7.52 ,"$893,910.62 "
PayPal Bank 3,9/23/23,Deposit,2JJ91533S2733964A,04 PAYPAL GENERAL UNRESTR,"Subject: GeneralPage
Transaction ID: 2JJ91533S2733964A
https://www.paypal.com/activity/payment/2JJ91533S2733964A",PayPal Bank 3,--,$50.01 ,"$893,960.63 "
Donations directed by individuals,9/23/23,Deposit,2JJ91533S2733964A,04 PAYPAL GENERAL UNRESTR,Support Ukraine - Support Ukraine,Contributed income:Donations directed by individuals,PayPal Bank 3,$52.00 ,"$894,012.63 "
PayPal Fees,9/23/23,Deposit,2JJ91533S2733964A,04 PAYPAL GENERAL UNRESTR,PayPal fees,OFFICE/GENERAL ADMINISTRATIVE EXPENSES:PayPal Fees,PayPal Bank 3,$1.99 ,"$894,014.62 "
PayPal Bank 3,9/23/23,Deposit,5VJ33232UR9131814,04 PAYPAL GENERAL UNRESTR,"Subject: Support Ukraine
Transaction ID: 5VJ33232UR9131814
https://www.paypal.com/activity/payment/5VJ33232UR9131814",PayPal Bank 3,--,$98.45 ,"$894,113.07 "
Donations directed by individuals,9/23/23,Deposit,5VJ33232UR9131814,04 PAYPAL GENERAL UNRESTR,Money in to PayPal,Contributed income:Donations directed by individuals,PayPal Bank 3,$103.48 ,"$894,216.55 "
PayPal Fees,9/23/23,Deposit,5VJ33232UR9131814,04 PAYPAL GENERAL UNRESTR,PayPal fees,OFFICE/GENERAL ADMINISTRATIVE EXPENSES:PayPal Fees,PayPal Bank 3,$5.03 ,"$894,221.58 "
PayPal Bank 3,9/23/23,Deposit,1KM99155AX392723D,04 PAYPAL GENERAL UNRESTR,"Subject: GeneralPage
Transaction ID: 1KM99155AX392723D
https://www.paypal.com/activity/payment/1KM99155AX392723D",PayPal Bank 3,--,$100.00 ,"$894,321.58 "
Donations directed by individuals,9/23/23,Deposit,1KM99155AX392723D,04 PAYPAL GENERAL UNRESTR,Support Ukraine - Support Ukraine,Contributed income:Donations directed by individuals,PayPal Bank 3,$103.48 ,"$894,425.06 "
PayPal Fees,9/23/23,Deposit,1KM99155AX392723D,04 PAYPAL GENERAL UNRESTR,PayPal fees,OFFICE/GENERAL ADMINISTRATIVE EXPENSES:PayPal Fees,PayPal Bank 3,$3.48 ,"$894,428.54 "
PayPal Bank 3,9/23/23,Deposit,00G10777M4738273P,04 PAYPAL GENERAL UNRESTR,"Subject: GeneralPage
Note: Thank you for everything you do.  I hope peace will come soon for all Ukrainian people!
Transaction ID: 00G10777M4738273P
https://www.paypal.com/activity/payment/00G10777M4738273P",PayPal Bank 3,--,$100.00 ,"$894,528.54 "
Donations directed by individuals,9/23/23,Deposit,00G10777M4738273P,04 PAYPAL GENERAL UNRESTR,Support Ukraine - Support Ukraine,Contributed income:Donations directed by individuals,PayPal Bank 3,$103.48 ,"$894,632.02 "
PayPal Fees,9/23/23,Deposit,00G10777M4738273P,04 PAYPAL GENERAL UNRESTR,PayPal fees,OFFICE/GENERAL ADMINISTRATIVE EXPENSES:PayPal Fees,PayPal Bank 3,$3.48 ,"$894,635.50 "
PayPal Bank 3,9/23/23,Deposit,17K11555500528818,10 Flight to Recovery RESTR,"Subject: FlightToRecovery
Transaction ID: 17K11555500528818
https://www.paypal.com/activity/payment/17K11555500528818",PayPal Bank 3,--,$39.37 ,"$894,674.87 "
Donations directed by individuals,9/23/23,Deposit,17K11555500528818,10 Flight to Recovery RESTR,Dignitas Ukraine Flight to Recovery - Dignitas Ukraine Flight to Recovery,Contributed income:Donations directed by individuals,PayPal Bank 3,$41.69 ,"$894,716.56 "
PayPal Fees,9/23/23,Deposit,17K11555500528818,10 Flight to Recovery RESTR,PayPal fees,OFFICE/GENERAL ADMINISTRATIVE EXPENSES:PayPal Fees,PayPal Bank 3,$2.32 ,"$894,718.88 "
PayPal Bank 3,9/23/23,Deposit,9F247060FG610643H,04 PAYPAL GENERAL UNRESTR,"Subject: GeneralPage
Transaction ID: 9F247060FG610643H
https://www.paypal.com/activity/payment/9F247060FG610643H",PayPal Bank 3,--,$190.73 ,"$894,909.61 "
Donations directed by individuals,9/23/23,Deposit,9F247060FG610643H,04 PAYPAL GENERAL UNRESTR,Support Ukraine - Support Ukraine,Contributed income:Donations directed by individuals,PayPal Bank 3,$200.00 ,"$895,109.61 "
PayPal Fees,9/23/23,Deposit,9F247060FG610643H,04 PAYPAL GENERAL UNRESTR,PayPal fees,OFFICE/GENERAL ADMINISTRATIVE EXPENSES:PayPal Fees,PayPal Bank 3,$9.27 ,"$895,118.88 "
PayPal Bank 3,9/23/23,Deposit,4JA04879C7952490V,07 1000 DRONES RESTR,"Subject: 1000DRONES
Transaction ID: 4JA04879C7952490V
https://www.paypal.com/activity/payment/4JA04879C7952490V",PayPal Bank 3,--,$129.95 ,"$895,248.83 "
Donations directed by individuals,9/23/23,Deposit,4JA04879C7952490V,07 1000 DRONES RESTR,1000 DRONES FOR UKRAINE - 1000 DRONES FOR UKRAINE,Contributed income:Donations directed by individuals,PayPal Bank 3,$136.43 ,"$895,385.26 "
PayPal Fees,9/23/23,Deposit,4JA04879C7952490V,07 1000 DRONES RESTR,PayPal fees,OFFICE/GENERAL ADMINISTRATIVE EXPENSES:PayPal Fees,PayPal Bank 3,$6.48 ,"$895,391.74 "
PayPal Bank 3,9/23/23,Deposit,5PF5970161756693T,04 PAYPAL GENERAL UNRESTR,"Subject: GeneralPage
Transaction ID: 5PF5970161756693T
https://www.paypal.com/activity/payment/5PF5970161756693T",PayPal Bank 3,--,$95.12 ,"$895,486.86 "
Donations directed by individuals,9/23/23,Deposit,5PF5970161756693T,04 PAYPAL GENERAL UNRESTR,Support Ukraine - Support Ukraine,Contributed income:Donations directed by individuals,PayPal Bank 3,$100.00 ,"$895,586.86 "
PayPal Fees,9/23/23,Deposit,5PF5970161756693T,04 PAYPAL GENERAL UNRESTR,PayPal fees,OFFICE/GENERAL ADMINISTRATIVE EXPENSES:PayPal Fees,PayPal Bank 3,$4.88 ,"$895,591.74 "
PayPal Bank 3,9/23/23,Deposit,85C884642S920054R,04 PAYPAL GENERAL UNRESTR,"Subject: GeneralPage
Transaction ID: 85C884642S920054R
https://www.paypal.com/activity/payment/85C884642S920054R",PayPal Bank 3,--,$100.00 ,"$895,691.74 "
Donations directed by individuals,9/23/23,Deposit,85C884642S920054R,04 PAYPAL GENERAL UNRESTR,Support Ukraine - Support Ukraine,Contributed income:Donations directed by individuals,PayPal Bank 3,$103.48 ,"$895,795.22 "
PayPal Fees,9/23/23,Deposit,85C884642S920054R,04 PAYPAL GENERAL UNRESTR,PayPal fees,OFFICE/GENERAL ADMINISTRATIVE EXPENSES:PayPal Fees,PayPal Bank 3,$3.48 ,"$895,798.70 "
PayPal Bank 3,9/23/23,Deposit,2NJ26077720592129,04 PAYPAL GENERAL UNRESTR,"Subject: GeneralPage
Note: Meest America $50 Post Payment + 100 for future 2 publications
Transaction ID: 2NJ26077720592129
https://www.paypal.com/activity/payment/2NJ26077720592129",PayPal Bank 3,--,$50.00 ,"$895,848.70 "
Donations directed by individuals,9/23/23,Deposit,2NJ26077720592129,04 PAYPAL GENERAL UNRESTR,Support Ukraine - Support Ukraine,Contributed income:Donations directed by individuals,PayPal Bank 3,$51.99 ,"$895,900.69 "
PayPal Fees,9/23/23,Deposit,2NJ26077720592129,04 PAYPAL GENERAL UNRESTR,PayPal fees,OFFICE/GENERAL ADMINISTRATIVE EXPENSES:PayPal Fees,PayPal Bank 3,$1.99 ,"$895,902.68 "
PayPal Bank 3,9/23/23,Deposit,1PG54135JX7240611,04 PAYPAL GENERAL UNRESTR,"Subject: GeneralPage
Transaction ID: 1PG54135JX7240611
https://www.paypal.com/activity/payment/1PG54135JX7240611",PayPal Bank 3,--,$49.22 ,"$895,951.90 "
Donations directed by individuals,9/23/23,Deposit,1PG54135JX7240611,04 PAYPAL GENERAL UNRESTR,Support Ukraine - Support Ukraine,Contributed income:Donations directed by individuals,PayPal Bank 3,$51.99 ,"$896,003.89 "
PayPal Fees,9/23/23,Deposit,1PG54135JX7240611,04 PAYPAL GENERAL UNRESTR,PayPal fees,OFFICE/GENERAL ADMINISTRATIVE EXPENSES:PayPal Fees,PayPal Bank 3,$2.77 ,"$896,006.66 "
PayPal Bank 3,9/23/23,Deposit,5V0372480N270221C,04 PAYPAL GENERAL UNRESTR,"Subject: Support Ukraine
Transaction ID: 5V0372480N270221C
https://www.paypal.com/activity/payment/5V0372480N270221C",PayPal Bank 3,--,$193.73 ,"$896,200.39 "
Donations directed by individuals,9/23/23,Deposit,5V0372480N270221C,04 PAYPAL GENERAL UNRESTR,Money in to PayPal,Contributed income:Donations directed by individuals,PayPal Bank 3,$200.00 ,"$896,400.39 "
PayPal Fees,9/23/23,Deposit,5V0372480N270221C,04 PAYPAL GENERAL UNRESTR,PayPal fees,OFFICE/GENERAL ADMINISTRATIVE EXPENSES:PayPal Fees,PayPal Bank 3,$6.27 ,"$896,406.66 "
PayPal Bank 3,9/23/23,Deposit,83A87585UT442860P,04 PAYPAL GENERAL UNRESTR,"Subject: GeneralPage
Transaction ID: 83A87585UT442860P
https://www.paypal.com/activity/payment/83A87585UT442860P",PayPal Bank 3,--,$96.62 ,"$896,503.28 "
Donations directed by individuals,9/23/23,Deposit,83A87585UT442860P,04 PAYPAL GENERAL UNRESTR,Support Ukraine - Support Ukraine,Contributed income:Donations directed by individuals,PayPal Bank 3,$100.00 ,"$896,603.28 "
PayPal Fees,9/23/23,Deposit,83A87585UT442860P,04 PAYPAL GENERAL UNRESTR,PayPal fees,OFFICE/GENERAL ADMINISTRATIVE EXPENSES:PayPal Fees,PayPal Bank 3,$3.38 ,"$896,606.66 "
PayPal Bank 3,9/23/23,Deposit,5JA35228HA676611R,04 PAYPAL GENERAL UNRESTR,"Subject: GeneralPage
Transaction ID: 5JA35228HA676611R
https://www.paypal.com/activity/payment/5JA35228HA676611R",PayPal Bank 3,--,$492.26 ,"$897,098.92 "
Donations directed by individuals,9/23/23,Deposit,5JA35228HA676611R,04 PAYPAL GENERAL UNRESTR,Support Ukraine - Support Ukraine,Contributed income:Donations directed by individuals,PayPal Bank 3,$515.38 ,"$897,614.30 "
PayPal Fees,9/23/23,Deposit,5JA35228HA676611R,04 PAYPAL GENERAL UNRESTR,PayPal fees,OFFICE/GENERAL ADMINISTRATIVE EXPENSES:PayPal Fees,PayPal Bank 3,$23.12 ,"$897,637.42 "
PayPal Bank 3,9/23/23,Deposit,0LK53003JB1138543,04 PAYPAL GENERAL UNRESTR,"Subject: GeneralPage
Transaction ID: 0LK53003JB1138543
https://www.paypal.com/activity/payment/0LK53003JB1138543",PayPal Bank 3,--,$50.00 ,"$897,687.42 "
Donations directed by individuals,9/23/23,Deposit,0LK53003JB1138543,04 PAYPAL GENERAL UNRESTR,Support Ukraine - Support Ukraine,Contributed income:Donations directed by individuals,PayPal Bank 3,$51.99 ,"$897,739.41 "
PayPal Fees,9/23/23,Deposit,0LK53003JB1138543,04 PAYPAL GENERAL UNRESTR,PayPal fees,OFFICE/GENERAL ADMINISTRATIVE EXPENSES:PayPal Fees,PayPal Bank 3,$1.99 ,"$897,741.40 "
PayPal Bank 3,9/23/23,Deposit,02B546718W785282Y,04 PAYPAL GENERAL UNRESTR,"Subject: GeneralPage
Transaction ID: 02B546718W785282Y
https://www.paypal.com/activity/payment/02B546718W785282Y",PayPal Bank 3,--,$10.00 ,"$897,751.40 "
Donations directed by individuals,9/23/23,Deposit,02B546718W785282Y,04 PAYPAL GENERAL UNRESTR,Support Ukraine - Support Ukraine,Contributed income:Donations directed by individuals,PayPal Bank 3,$10.80 ,"$897,762.20 "
PayPal Fees,9/23/23,Deposit,02B546718W785282Y,04 PAYPAL GENERAL UNRESTR,PayPal fees,OFFICE/GENERAL ADMINISTRATIVE EXPENSES:PayPal Fees,PayPal Bank 3,$0.80 ,"$897,763.00 "
PayPal Bank 3,9/23/23,Deposit,0BK3818404001781N,04 PAYPAL GENERAL UNRESTR,"Subject: GeneralPage
Transaction ID: 0BK3818404001781N
https://www.paypal.com/activity/payment/0BK3818404001781N",PayPal Bank 3,--,$50.00 ,"$897,813.00 "
Donations directed by individuals,9/23/23,Deposit,0BK3818404001781N,04 PAYPAL GENERAL UNRESTR,Support Ukraine - Support Ukraine,Contributed income:Donations directed by individuals,PayPal Bank 3,$51.99 ,"$897,864.99 "
PayPal Fees,9/23/23,Deposit,0BK3818404001781N,04 PAYPAL GENERAL UNRESTR,PayPal fees,OFFICE/GENERAL ADMINISTRATIVE EXPENSES:PayPal Fees,PayPal Bank 3,$1.99 ,"$897,866.98 "
PayPal Bank 3,9/23/23,Deposit,2KN53284A3134434X,08 VICTORY DRONES RESTR,"Subject: VictoryDrones
Transaction ID: 2KN53284A3134434X
https://www.paypal.com/activity/payment/2KN53284A3134434X",PayPal Bank 3,--,$19.68 ,"$897,886.66 "
Donations directed by individuals,9/23/23,Deposit,2KN53284A3134434X,08 VICTORY DRONES RESTR,VICTORY DRONES - VICTORY DRONES,Contributed income:Donations directed by individuals,PayPal Bank 3,$21.10 ,"$897,907.76 "
PayPal Fees,9/23/23,Deposit,2KN53284A3134434X,08 VICTORY DRONES RESTR,PayPal fees,OFFICE/GENERAL ADMINISTRATIVE EXPENSES:PayPal Fees,PayPal Bank 3,$1.42 ,"$897,909.18 "
PayPal Bank 3,9/23/23,Deposit,14Y354229B560015H,04 PAYPAL GENERAL UNRESTR,"Subject: GeneralPage
Transaction ID: 14Y354229B560015H
https://www.paypal.com/activity/payment/14Y354229B560015H",PayPal Bank 3,--,$485.06 ,"$898,394.24 "
Donations directed by individuals,9/23/23,Deposit,14Y354229B560015H,04 PAYPAL GENERAL UNRESTR,Support Ukraine - Support Ukraine,Contributed income:Donations directed by individuals,PayPal Bank 3,$500.00 ,"$898,894.24 "
PayPal Fees,9/23/23,Deposit,14Y354229B560015H,04 PAYPAL GENERAL UNRESTR,PayPal fees,OFFICE/GENERAL ADMINISTRATIVE EXPENSES:PayPal Fees,PayPal Bank 3,$14.94 ,"$898,909.18 "
PayPal Bank 3,9/23/23,Deposit,7G457630EV506892T,04 PAYPAL GENERAL UNRESTR,"Subject: GeneralPage
Transaction ID: 7G457630EV506892T
https://www.paypal.com/activity/payment/7G457630EV506892T",PayPal Bank 3,--,$49.22 ,"$898,958.40 "
Donations directed by individuals,9/23/23,Deposit,7G457630EV506892T,04 PAYPAL GENERAL UNRESTR,Support Ukraine - Support Ukraine,Contributed income:Donations directed by individuals,PayPal Bank 3,$51.99 ,"$899,010.39 "
PayPal Fees,9/23/23,Deposit,7G457630EV506892T,04 PAYPAL GENERAL UNRESTR,PayPal fees,OFFICE/GENERAL ADMINISTRATIVE EXPENSES:PayPal Fees,PayPal Bank 3,$2.77 ,"$899,013.16 "
PayPal Bank 3,9/23/23,Deposit,66568384HG3550906,07 1000 DRONES RESTR,"Subject: 1000 DRONES FOR UKRAINE
Transaction ID: 66568384HG3550906
https://www.paypal.com/activity/payment/66568384HG3550906",PayPal Bank 3,--,$24.61 ,"$899,037.77 "
Donations directed by individuals,9/23/23,Deposit,66568384HG3550906,07 1000 DRONES RESTR,Money in to PayPal,Contributed income:Donations directed by individuals,PayPal Bank 3,$26.25 ,"$899,064.02 "
PayPal Fees,9/23/23,Deposit,66568384HG3550906,07 1000 DRONES RESTR,PayPal fees,OFFICE/GENERAL ADMINISTRATIVE EXPENSES:PayPal Fees,PayPal Bank 3,$1.64 ,"$899,065.66 "
PayPal Bank 3,9/23/23,Deposit,58M01245U2747191M,04 PAYPAL GENERAL UNRESTR,"Subject: GeneralPage
Transaction ID: 58M01245U2747191M
https://www.paypal.com/activity/payment/58M01245U2747191M",PayPal Bank 3,--,$33.47 ,"$899,099.13 "
Donations directed by individuals,9/23/23,Deposit,58M01245U2747191M,04 PAYPAL GENERAL UNRESTR,Support Ukraine - Support Ukraine,Contributed income:Donations directed by individuals,PayPal Bank 3,$35.52 ,"$899,134.65 "
PayPal Fees,9/23/23,Deposit,58M01245U2747191M,04 PAYPAL GENERAL UNRESTR,PayPal fees,OFFICE/GENERAL ADMINISTRATIVE EXPENSES:PayPal Fees,PayPal Bank 3,$2.05 ,"$899,136.70 "
PayPal Bank 3,9/23/23,Deposit,5V182613YX908114U,08 VICTORY DRONES RESTR,"Subject: VictoryDrones
Note: Honor to: Lyuba Shipovich and all team
Transaction ID: 5V182613YX908114U
https://www.paypal.com/activity/payment/5V182613YX908114U",PayPal Bank 3,--,$108.00 ,"$899,244.70 "
Donations directed by individuals,9/23/23,Deposit,5V182613YX908114U,08 VICTORY DRONES RESTR,VICTORY DRONES - VICTORY DRONES,Contributed income:Donations directed by individuals,PayPal Bank 3,$111.72 ,"$899,356.42 "
PayPal Fees,9/23/23,Deposit,5V182613YX908114U,08 VICTORY DRONES RESTR,PayPal fees,OFFICE/GENERAL ADMINISTRATIVE EXPENSES:PayPal Fees,PayPal Bank 3,$3.72 ,"$899,360.14 "
PayPal Bank 3,9/23/23,Deposit,91077538HL419931F,07 1000 DRONES RESTR,"Subject: GeneralPage
Note: На дрони на честь дня народження Катерини Шліфер
Transaction ID: 91077538HL419931F
https://www.paypal.com/activity/payment/91077538HL419931F",PayPal Bank 3,--,$49.22 ,"$899,409.36 "
Donations directed by individuals,9/23/23,Deposit,91077538HL419931F,07 1000 DRONES RESTR,Support Ukraine - Support Ukraine,Contributed income:Donations directed by individuals,PayPal Bank 3,$51.99 ,"$899,461.35 "
PayPal Fees,9/23/23,Deposit,91077538HL419931F,07 1000 DRONES RESTR,PayPal fees,OFFICE/GENERAL ADMINISTRATIVE EXPENSES:PayPal Fees,PayPal Bank 3,$2.77 ,"$899,464.12 "
PayPal Bank 3,9/23/23,Deposit,1NW228256Y3581319,04 PAYPAL GENERAL UNRESTR,"Subject: GeneralPage
Transaction ID: 1NW228256Y3581319
https://www.paypal.com/activity/payment/1NW228256Y3581319",PayPal Bank 3,--,$19.68 ,"$899,483.80 "
Donations directed by individuals,9/23/23,Deposit,1NW228256Y3581319,04 PAYPAL GENERAL UNRESTR,Support Ukraine - Support Ukraine,Contributed income:Donations directed by individuals,PayPal Bank 3,$21.10 ,"$899,504.90 "
PayPal Fees,9/23/23,Deposit,1NW228256Y3581319,04 PAYPAL GENERAL UNRESTR,PayPal fees,OFFICE/GENERAL ADMINISTRATIVE EXPENSES:PayPal Fees,PayPal Bank 3,$1.42 ,"$899,506.32 "
PayPal Bank 3,9/23/23,Deposit,79N73737P6977362H,04 PAYPAL GENERAL UNRESTR,"Subject: GeneralPage
Transaction ID: 79N73737P6977362H
https://www.paypal.com/activity/payment/79N73737P6977362H",PayPal Bank 3,--,$50.00 ,"$899,556.32 "
Donations directed by individuals,9/23/23,Deposit,79N73737P6977362H,04 PAYPAL GENERAL UNRESTR,Support Ukraine - Support Ukraine,Contributed income:Donations directed by individuals,PayPal Bank 3,$51.99 ,"$899,608.31 "
PayPal Fees,9/23/23,Deposit,79N73737P6977362H,04 PAYPAL GENERAL UNRESTR,PayPal fees,OFFICE/GENERAL ADMINISTRATIVE EXPENSES:PayPal Fees,PayPal Bank 3,$1.99 ,"$899,610.30 "
PayPal Bank 3,9/23/23,Deposit,01A20139MG717545R,07 1000 DRONES RESTR,"Subject: 1000DRONES
Transaction ID: 01A20139MG717545R
https://www.paypal.com/activity/payment/01A20139MG717545R",PayPal Bank 3,--,$9.07 ,"$899,619.37 "
Donations directed by individuals,9/23/23,Deposit,01A20139MG717545R,07 1000 DRONES RESTR,1000 DRONES FOR UKRAINE - 1000 DRONES FOR UKRAINE,Contributed income:Donations directed by individuals,PayPal Bank 3,$10.00 ,"$899,629.37 "
PayPal Fees,9/23/23,Deposit,01A20139MG717545R,07 1000 DRONES RESTR,PayPal fees,OFFICE/GENERAL ADMINISTRATIVE EXPENSES:PayPal Fees,PayPal Bank 3,$0.93 ,"$899,630.30 "
PayPal Bank 3,9/23/23,Deposit,3K7471717F527735M,04 PAYPAL GENERAL UNRESTR,"Subject: Support Ukraine
Transaction ID: 3K7471717F527735M
https://www.paypal.com/activity/payment/3K7471717F527735M",PayPal Bank 3,--,$11.81 ,"$899,642.11 "
Donations directed by individuals,9/23/23,Deposit,3K7471717F527735M,04 PAYPAL GENERAL UNRESTR,Money in to PayPal,Contributed income:Donations directed by individuals,PayPal Bank 3,$12.86 ,"$899,654.97 "
PayPal Fees,9/23/23,Deposit,3K7471717F527735M,04 PAYPAL GENERAL UNRESTR,PayPal fees,OFFICE/GENERAL ADMINISTRATIVE EXPENSES:PayPal Fees,PayPal Bank 3,$1.05 ,"$899,656.02 "
PayPal Bank 3,9/23/23,Deposit,6CJ25789UF098361K,07 1000 DRONES RESTR,"Subject: 1000 DRONES FOR UKRAINE
Transaction ID: 6CJ25789UF098361K
https://www.paypal.com/activity/payment/6CJ25789UF098361K",PayPal Bank 3,--,$10.82 ,"$899,666.84 "
Donations directed by individuals,9/23/23,Deposit,6CJ25789UF098361K,07 1000 DRONES RESTR,Money in to PayPal,Contributed income:Donations directed by individuals,PayPal Bank 3,$11.83 ,"$899,678.67 "
PayPal Fees,9/23/23,Deposit,6CJ25789UF098361K,07 1000 DRONES RESTR,PayPal fees,OFFICE/GENERAL ADMINISTRATIVE EXPENSES:PayPal Fees,PayPal Bank 3,$1.01 ,"$899,679.68 "
PayPal Bank 3,9/23/23,Deposit,4K041382F2815471L,04 PAYPAL GENERAL UNRESTR,"Subject: GeneralPage
Transaction ID: 4K041382F2815471L
https://www.paypal.com/activity/payment/4K041382F2815471L",PayPal Bank 3,--,$100.00 ,"$899,779.68 "
Donations directed by individuals,9/23/23,Deposit,4K041382F2815471L,04 PAYPAL GENERAL UNRESTR,Support Ukraine - Support Ukraine,Contributed income:Donations directed by individuals,PayPal Bank 3,$103.48 ,"$899,883.16 "
PayPal Fees,9/23/23,Deposit,4K041382F2815471L,04 PAYPAL GENERAL UNRESTR,PayPal fees,OFFICE/GENERAL ADMINISTRATIVE EXPENSES:PayPal Fees,PayPal Bank 3,$3.48 ,"$899,886.64 "
PayPal Bank 3,9/23/23,Deposit,5N255724782856438,04 PAYPAL GENERAL UNRESTR,"Subject: GeneralPage
Transaction ID: 5N255724782856438
https://www.paypal.com/activity/payment/5N255724782856438",PayPal Bank 3,--,$98.45 ,"$899,985.09 "
Donations directed by individuals,9/23/23,Deposit,5N255724782856438,04 PAYPAL GENERAL UNRESTR,Support Ukraine - Support Ukraine,Contributed income:Donations directed by individuals,PayPal Bank 3,$103.48 ,"$900,088.57 "
PayPal Fees,9/23/23,Deposit,5N255724782856438,04 PAYPAL GENERAL UNRESTR,PayPal fees,OFFICE/GENERAL ADMINISTRATIVE EXPENSES:PayPal Fees,PayPal Bank 3,$5.03 ,"$900,093.60 "
PayPal Bank 3,9/23/23,Deposit,27038802EP0081510,04 PAYPAL GENERAL UNRESTR,"Subject: GeneralPage
Transaction ID: 27038802EP0081510
https://www.paypal.com/activity/payment/27038802EP0081510",PayPal Bank 3,--,$96.62 ,"$900,190.22 "
Donations directed by individuals,9/23/23,Deposit,27038802EP0081510,04 PAYPAL GENERAL UNRESTR,Support Ukraine - Support Ukraine,Contributed income:Donations directed by individuals,PayPal Bank 3,$100.00 ,"$900,290.22 "
PayPal Fees,9/23/23,Deposit,27038802EP0081510,04 PAYPAL GENERAL UNRESTR,PayPal fees,OFFICE/GENERAL ADMINISTRATIVE EXPENSES:PayPal Fees,PayPal Bank 3,$3.38 ,"$900,293.60 "
PayPal Bank 3,9/23/23,Deposit,28E10268044666340,04 PAYPAL GENERAL UNRESTR,"Subject: GeneralPage
Transaction ID: 28E10268044666340
https://www.paypal.com/activity/payment/28E10268044666340",PayPal Bank 3,--,$50.00 ,"$900,343.60 "
Donations directed by individuals,9/23/23,Deposit,28E10268044666340,04 PAYPAL GENERAL UNRESTR,Support Ukraine - Support Ukraine,Contributed income:Donations directed by individuals,PayPal Bank 3,$51.99 ,"$900,395.59 "
PayPal Fees,9/23/23,Deposit,28E10268044666340,04 PAYPAL GENERAL UNRESTR,PayPal fees,OFFICE/GENERAL ADMINISTRATIVE EXPENSES:PayPal Fees,PayPal Bank 3,$1.99 ,"$900,397.58 "
PayPal Bank 3,9/23/23,Deposit,54K03927TK6156128,04 PAYPAL GENERAL UNRESTR,"Subject: GeneralPage
Transaction ID: 54K03927TK6156128
https://www.paypal.com/activity/payment/54K03927TK6156128",PayPal Bank 3,--,$19.68 ,"$900,417.26 "
Donations directed by individuals,9/23/23,Deposit,54K03927TK6156128,04 PAYPAL GENERAL UNRESTR,Support Ukraine - Support Ukraine,Contributed income:Donations directed by individuals,PayPal Bank 3,$21.10 ,"$900,438.36 "
PayPal Fees,9/23/23,Deposit,54K03927TK6156128,04 PAYPAL GENERAL UNRESTR,PayPal fees,OFFICE/GENERAL ADMINISTRATIVE EXPENSES:PayPal Fees,PayPal Bank 3,$1.42 ,"$900,439.78 "
PayPal Bank 3,9/23/23,Deposit,2WJ30512FX3528524,04 PAYPAL GENERAL UNRESTR,"Subject: Support Ukraine
Transaction ID: 2WJ30512FX3528524
https://www.paypal.com/activity/payment/2WJ30512FX3528524",PayPal Bank 3,--,$29.53 ,"$900,469.31 "
Donations directed by individuals,9/23/23,Deposit,2WJ30512FX3528524,04 PAYPAL GENERAL UNRESTR,Money in to PayPal,Contributed income:Donations directed by individuals,PayPal Bank 3,$31.40 ,"$900,500.71 "
PayPal Fees,9/23/23,Deposit,2WJ30512FX3528524,04 PAYPAL GENERAL UNRESTR,PayPal fees,OFFICE/GENERAL ADMINISTRATIVE EXPENSES:PayPal Fees,PayPal Bank 3,$1.87 ,"$900,502.58 "
PayPal Bank 3,9/23/23,Deposit,8VB648034T5190047,04 PAYPAL GENERAL UNRESTR,"Subject: GeneralPage
Transaction ID: 8VB648034T5190047
https://www.paypal.com/activity/payment/8VB648034T5190047",PayPal Bank 3,--,$25.00 ,"$900,527.58 "
Donations directed by individuals,9/23/23,Deposit,8VB648034T5190047,04 PAYPAL GENERAL UNRESTR,Support Ukraine - Support Ukraine,Contributed income:Donations directed by individuals,PayPal Bank 3,$26.25 ,"$900,553.83 "
PayPal Fees,9/23/23,Deposit,8VB648034T5190047,04 PAYPAL GENERAL UNRESTR,PayPal fees,OFFICE/GENERAL ADMINISTRATIVE EXPENSES:PayPal Fees,PayPal Bank 3,$1.25 ,"$900,555.08 "
PayPal Bank 3,9/23/23,Deposit,5BD32753B65157406,04 PAYPAL GENERAL UNRESTR,"Subject: GeneralPage
Transaction ID: 5BD32753B65157406
https://www.paypal.com/activity/payment/5BD32753B65157406",PayPal Bank 3,--,$50.00 ,"$900,605.08 "
Donations directed by individuals,9/23/23,Deposit,5BD32753B65157406,04 PAYPAL GENERAL UNRESTR,Support Ukraine - Support Ukraine,Contributed income:Donations directed by individuals,PayPal Bank 3,$51.99 ,"$900,657.07 "
PayPal Fees,9/23/23,Deposit,5BD32753B65157406,04 PAYPAL GENERAL UNRESTR,PayPal fees,OFFICE/GENERAL ADMINISTRATIVE EXPENSES:PayPal Fees,PayPal Bank 3,$1.99 ,"$900,659.06 "
PayPal Bank 3,9/23/23,Deposit,4S657812RT310644B,04 PAYPAL GENERAL UNRESTR,"Subject: GeneralPage
Transaction ID: 4S657812RT310644B
https://www.paypal.com/activity/payment/4S657812RT310644B",PayPal Bank 3,--,$9.07 ,"$900,668.13 "
Donations directed by individuals,9/23/23,Deposit,4S657812RT310644B,04 PAYPAL GENERAL UNRESTR,Support Ukraine - Support Ukraine,Contributed income:Donations directed by individuals,PayPal Bank 3,$10.00 ,"$900,678.13 "
PayPal Fees,9/23/23,Deposit,4S657812RT310644B,04 PAYPAL GENERAL UNRESTR,PayPal fees,OFFICE/GENERAL ADMINISTRATIVE EXPENSES:PayPal Fees,PayPal Bank 3,$0.93 ,"$900,679.06 "
PayPal Bank 3,9/23/23,Deposit,1FW155467A029952T,04 PAYPAL GENERAL UNRESTR,"Subject: GeneralPage
Transaction ID: 1FW155467A029952T
https://www.paypal.com/activity/payment/1FW155467A029952T",PayPal Bank 3,--,$10.00 ,"$900,689.06 "
Donations directed by individuals,9/23/23,Deposit,1FW155467A029952T,04 PAYPAL GENERAL UNRESTR,Support Ukraine - Support Ukraine,Contributed income:Donations directed by individuals,PayPal Bank 3,$10.80 ,"$900,699.86 "
PayPal Fees,9/23/23,Deposit,1FW155467A029952T,04 PAYPAL GENERAL UNRESTR,PayPal fees,OFFICE/GENERAL ADMINISTRATIVE EXPENSES:PayPal Fees,PayPal Bank 3,$0.80 ,"$900,700.66 "
PayPal Bank 3,9/23/23,Deposit,2HX1819960016541E,04 PAYPAL GENERAL UNRESTR,"Subject: GeneralPage
Transaction ID: 2HX1819960016541E
https://www.paypal.com/activity/payment/2HX1819960016541E",PayPal Bank 3,--,$200.00 ,"$900,900.66 "
Donations directed by individuals,9/23/23,Deposit,2HX1819960016541E,04 PAYPAL GENERAL UNRESTR,Support Ukraine - Support Ukraine,Contributed income:Donations directed by individuals,PayPal Bank 3,$206.46 ,"$901,107.12 "
PayPal Fees,9/23/23,Deposit,2HX1819960016541E,04 PAYPAL GENERAL UNRESTR,PayPal fees,OFFICE/GENERAL ADMINISTRATIVE EXPENSES:PayPal Fees,PayPal Bank 3,$6.46 ,"$901,113.58 "
PayPal Bank 3,9/23/23,Deposit,07740514KY660261P,10 Flight to Recovery RESTR,"Subject: Dignitas Ukraine Flight to Recovery
Transaction ID: 07740514KY660261P
https://www.paypal.com/activity/payment/07740514KY660261P",PayPal Bank 3,--,$50.00 ,"$901,163.58 "
Donations directed by individuals,9/23/23,Deposit,07740514KY660261P,10 Flight to Recovery RESTR,Money in to PayPal,Contributed income:Donations directed by individuals,PayPal Bank 3,$51.99 ,"$901,215.57 "
PayPal Fees,9/23/23,Deposit,07740514KY660261P,10 Flight to Recovery RESTR,PayPal fees,OFFICE/GENERAL ADMINISTRATIVE EXPENSES:PayPal Fees,PayPal Bank 3,$1.99 ,"$901,217.56 "
PayPal Bank 3,9/23/23,Deposit,3SM22770VR113021S,04 PAYPAL GENERAL UNRESTR,"Subject: GeneralPage
Transaction ID: 3SM22770VR113021S
https://www.paypal.com/activity/payment/3SM22770VR113021S",PayPal Bank 3,--,$28.19 ,"$901,245.75 "
Donations directed by individuals,9/23/23,Deposit,3SM22770VR113021S,04 PAYPAL GENERAL UNRESTR,Support Ukraine - Support Ukraine,Contributed income:Donations directed by individuals,PayPal Bank 3,$30.00 ,"$901,275.75 "
PayPal Fees,9/23/23,Deposit,3SM22770VR113021S,04 PAYPAL GENERAL UNRESTR,PayPal fees,OFFICE/GENERAL ADMINISTRATIVE EXPENSES:PayPal Fees,PayPal Bank 3,$1.81 ,"$901,277.56 "
PayPal Bank 3,9/23/23,Deposit,1PJ21337X0381634E,08 VICTORY DRONES RESTR,"Subject: VICTORY DRONES
Transaction ID: 1PJ21337X0381634E
https://www.paypal.com/activity/payment/1PJ21337X0381634E",PayPal Bank 3,--,$98.45 ,"$901,376.01 "
Donations directed by individuals,9/23/23,Deposit,1PJ21337X0381634E,08 VICTORY DRONES RESTR,Money in to PayPal,Contributed income:Donations directed by individuals,PayPal Bank 3,$103.48 ,"$901,479.49 "
PayPal Fees,9/23/23,Deposit,1PJ21337X0381634E,08 VICTORY DRONES RESTR,PayPal fees,OFFICE/GENERAL ADMINISTRATIVE EXPENSES:PayPal Fees,PayPal Bank 3,$5.03 ,"$901,484.52 "
PayPal Bank 3,9/23/23,Deposit,5GC20159K01484358,10 Flight to Recovery RESTR,"Subject: Dignitas Ukraine Flight to Recovery
Transaction ID: 5GC20159K01484358
https://www.paypal.com/activity/payment/5GC20159K01484358",PayPal Bank 3,--,$98.45 ,"$901,582.97 "
Donations directed by individuals,9/23/23,Deposit,5GC20159K01484358,10 Flight to Recovery RESTR,Money in to PayPal,Contributed income:Donations directed by individuals,PayPal Bank 3,$103.48 ,"$901,686.45 "
PayPal Fees,9/23/23,Deposit,5GC20159K01484358,10 Flight to Recovery RESTR,PayPal fees,OFFICE/GENERAL ADMINISTRATIVE EXPENSES:PayPal Fees,PayPal Bank 3,$5.03 ,"$901,691.48 "
PayPal Bank 3,9/23/23,Deposit,9XB53773E89036047,04 PAYPAL GENERAL UNRESTR,"Subject: GeneralPage
Transaction ID: 9XB53773E89036047
https://www.paypal.com/activity/payment/9XB53773E89036047",PayPal Bank 3,--,$96.62 ,"$901,788.10 "
Donations directed by individuals,9/23/23,Deposit,9XB53773E89036047,04 PAYPAL GENERAL UNRESTR,Support Ukraine - Support Ukraine,Contributed income:Donations directed by individuals,PayPal Bank 3,$100.00 ,"$901,888.10 "
PayPal Fees,9/23/23,Deposit,9XB53773E89036047,04 PAYPAL GENERAL UNRESTR,PayPal fees,OFFICE/GENERAL ADMINISTRATIVE EXPENSES:PayPal Fees,PayPal Bank 3,$3.38 ,"$901,891.48 "
PayPal Bank 3,9/23/23,Deposit,78N74887AR473462F,04 PAYPAL GENERAL UNRESTR,"Subject: GeneralPage
Transaction ID: 78N74887AR473462F
https://www.paypal.com/activity/payment/78N74887AR473462F",PayPal Bank 3,--,$20.54 ,"$901,912.02 "
Donations directed by individuals,9/23/23,Deposit,78N74887AR473462F,04 PAYPAL GENERAL UNRESTR,Support Ukraine - Support Ukraine,Contributed income:Donations directed by individuals,PayPal Bank 3,$22.00 ,"$901,934.02 "
PayPal Fees,9/23/23,Deposit,78N74887AR473462F,04 PAYPAL GENERAL UNRESTR,PayPal fees,OFFICE/GENERAL ADMINISTRATIVE EXPENSES:PayPal Fees,PayPal Bank 3,$1.46 ,"$901,935.48 "
PayPal Bank 3,9/23/23,Deposit,7H440140EG856641L,04 PAYPAL GENERAL UNRESTR,"Subject: GeneralPage
Transaction ID: 7H440140EG856641L
https://www.paypal.com/activity/payment/7H440140EG856641L",PayPal Bank 3,--,$13.85 ,"$901,949.33 "
Donations directed by individuals,9/23/23,Deposit,7H440140EG856641L,04 PAYPAL GENERAL UNRESTR,Support Ukraine - Support Ukraine,Contributed income:Donations directed by individuals,PayPal Bank 3,$15.00 ,"$901,964.33 "
PayPal Fees,9/23/23,Deposit,7H440140EG856641L,04 PAYPAL GENERAL UNRESTR,PayPal fees,OFFICE/GENERAL ADMINISTRATIVE EXPENSES:PayPal Fees,PayPal Bank 3,$1.15 ,"$901,965.48 "
PayPal Bank 3,9/23/23,Deposit,31P730153B8899938,04 PAYPAL GENERAL UNRESTR,"Subject: GeneralPage
Note: Thank you for your support.   Glory to Ukraine!
Transaction ID: 31P730153B8899938
https://www.paypal.com/activity/payment/31P730153B8899938",PayPal Bank 3,--,$50.00 ,"$902,015.48 "
Donations directed by individuals,9/23/23,Deposit,31P730153B8899938,04 PAYPAL GENERAL UNRESTR,Support Ukraine - Support Ukraine,Contributed income:Donations directed by individuals,PayPal Bank 3,$51.99 ,"$902,067.47 "
PayPal Fees,9/23/23,Deposit,31P730153B8899938,04 PAYPAL GENERAL UNRESTR,PayPal fees,OFFICE/GENERAL ADMINISTRATIVE EXPENSES:PayPal Fees,PayPal Bank 3,$1.99 ,"$902,069.46 "
PayPal Bank 3,9/23/23,Deposit,927981320R714934J,07 1000 DRONES RESTR,"Subject: 1000DRONES
Note: нехай летять пташки
Transaction ID: 927981320R714934J
https://www.paypal.com/activity/payment/927981320R714934J",PayPal Bank 3,--,$630.72 ,"$902,700.18 "
Donations directed by individuals,9/23/23,Deposit,927981320R714934J,07 1000 DRONES RESTR,1000 DRONES FOR UKRAINE - 1000 DRONES FOR UKRAINE,Contributed income:Donations directed by individuals,PayPal Bank 3,$650.00 ,"$903,350.18 "
PayPal Fees,9/23/23,Deposit,927981320R714934J,07 1000 DRONES RESTR,PayPal fees,OFFICE/GENERAL ADMINISTRATIVE EXPENSES:PayPal Fees,PayPal Bank 3,$19.28 ,"$903,369.46 "
PayPal Bank 3,9/23/23,Deposit,0AD26228P85908925,07 1000 DRONES RESTR,"Subject: 1000DRONES
Note: Donate from Dub Family to purchase drones
Transaction ID: 0AD26228P85908925
https://www.paypal.com/activity/payment/0AD26228P85908925",PayPal Bank 3,--,$100.00 ,"$903,469.46 "
Donations directed by individuals,9/23/23,Deposit,0AD26228P85908925,07 1000 DRONES RESTR,1000 DRONES FOR UKRAINE - 1000 DRONES FOR UKRAINE,Contributed income:Donations directed by individuals,PayPal Bank 3,$103.48 ,"$903,572.94 "
PayPal Fees,9/23/23,Deposit,0AD26228P85908925,07 1000 DRONES RESTR,PayPal fees,OFFICE/GENERAL ADMINISTRATIVE EXPENSES:PayPal Fees,PayPal Bank 3,$3.48 ,"$903,576.42 "
PayPal Bank 3,9/23/23,Deposit,3AC87114AX939674L,04 PAYPAL GENERAL UNRESTR,"Subject: GeneralPage
Transaction ID: 3AC87114AX939674L
https://www.paypal.com/activity/payment/3AC87114AX939674L",PayPal Bank 3,--,$100.00 ,"$903,676.42 "
Donations directed by individuals,9/23/23,Deposit,3AC87114AX939674L,04 PAYPAL GENERAL UNRESTR,Support Ukraine - Support Ukraine,Contributed income:Donations directed by individuals,PayPal Bank 3,$103.48 ,"$903,779.90 "
PayPal Fees,9/23/23,Deposit,3AC87114AX939674L,04 PAYPAL GENERAL UNRESTR,PayPal fees,OFFICE/GENERAL ADMINISTRATIVE EXPENSES:PayPal Fees,PayPal Bank 3,$3.48 ,"$903,783.38 "
PayPal Bank 3,9/23/23,Deposit,3VS706893Y980111Y,04 PAYPAL GENERAL UNRESTR,"Subject: GeneralPage
Transaction ID: 3VS706893Y980111Y
https://www.paypal.com/activity/payment/3VS706893Y980111Y",PayPal Bank 3,--,$49.22 ,"$903,832.60 "
Donations directed by individuals,9/23/23,Deposit,3VS706893Y980111Y,04 PAYPAL GENERAL UNRESTR,Support Ukraine - Support Ukraine,Contributed income:Donations directed by individuals,PayPal Bank 3,$51.99 ,"$903,884.59 "
PayPal Fees,9/23/23,Deposit,3VS706893Y980111Y,04 PAYPAL GENERAL UNRESTR,PayPal fees,OFFICE/GENERAL ADMINISTRATIVE EXPENSES:PayPal Fees,PayPal Bank 3,$2.77 ,"$903,887.36 "
PayPal Bank 3,9/23/23,Deposit,1WS5944815973093P,04 PAYPAL GENERAL UNRESTR,"Subject: GeneralPage
Note: How much does a drone cost?
Transaction ID: 1WS5944815973093P
https://www.paypal.com/activity/payment/1WS5944815973093P",PayPal Bank 3,--,$541.49 ,"$904,428.85 "
Donations directed by individuals,9/23/23,Deposit,1WS5944815973093P,04 PAYPAL GENERAL UNRESTR,Support Ukraine - Support Ukraine,Contributed income:Donations directed by individuals,PayPal Bank 3,$566.87 ,"$904,995.72 "
PayPal Fees,9/23/23,Deposit,1WS5944815973093P,04 PAYPAL GENERAL UNRESTR,PayPal fees,OFFICE/GENERAL ADMINISTRATIVE EXPENSES:PayPal Fees,PayPal Bank 3,$25.38 ,"$905,021.10 "
PayPal Bank 3,9/23/23,Deposit,5MM51854BE9204300,04 PAYPAL GENERAL UNRESTR,"Subject: Support Ukraine
Transaction ID: 5MM51854BE9204300
https://www.paypal.com/activity/payment/5MM51854BE9204300",PayPal Bank 3,--,$4.29 ,"$905,025.39 "
Donations directed by individuals,9/23/23,Deposit,5MM51854BE9204300,04 PAYPAL GENERAL UNRESTR,Money in to PayPal,Contributed income:Donations directed by individuals,PayPal Bank 3,$5.00 ,"$905,030.39 "
PayPal Fees,9/23/23,Deposit,5MM51854BE9204300,04 PAYPAL GENERAL UNRESTR,PayPal fees,OFFICE/GENERAL ADMINISTRATIVE EXPENSES:PayPal Fees,PayPal Bank 3,$0.71 ,"$905,031.10 "
PayPal Bank 3,9/23/23,Deposit,7T65970426349884E,07 1000 DRONES RESTR,"Subject: 1000DRONES
Transaction ID: 7T65970426349884E
https://www.paypal.com/activity/payment/7T65970426349884E",PayPal Bank 3,--,$19.68 ,"$905,050.78 "
Donations directed by individuals,9/23/23,Deposit,7T65970426349884E,07 1000 DRONES RESTR,1000 DRONES FOR UKRAINE - 1000 DRONES FOR UKRAINE,Contributed income:Donations directed by individuals,PayPal Bank 3,$21.10 ,"$905,071.88 "
PayPal Fees,9/23/23,Deposit,7T65970426349884E,07 1000 DRONES RESTR,PayPal fees,OFFICE/GENERAL ADMINISTRATIVE EXPENSES:PayPal Fees,PayPal Bank 3,$1.42 ,"$905,073.30 "
PayPal Bank 3,9/23/23,Deposit,7PJ53948KS975352J,07 1000 DRONES RESTR,"Subject: GeneralPage
Note: На дрон для України
Transaction ID: 7PJ53948KS975352J
https://www.paypal.com/activity/payment/7PJ53948KS975352J",PayPal Bank 3,--,$96.62 ,"$905,169.92 "
Donations directed by individuals,9/23/23,Deposit,7PJ53948KS975352J,07 1000 DRONES RESTR,Support Ukraine - Support Ukraine,Contributed income:Donations directed by individuals,PayPal Bank 3,$100.00 ,"$905,269.92 "
PayPal Fees,9/23/23,Deposit,7PJ53948KS975352J,07 1000 DRONES RESTR,PayPal fees,OFFICE/GENERAL ADMINISTRATIVE EXPENSES:PayPal Fees,PayPal Bank 3,$3.38 ,"$905,273.30 "
PayPal Bank 3,9/23/23,Deposit,2RG00312E60205211,04 PAYPAL GENERAL UNRESTR,"Subject: GeneralPage
Transaction ID: 2RG00312E60205211
https://www.paypal.com/activity/payment/2RG00312E60205211",PayPal Bank 3,--,"$1,941.71 ","$907,215.01 "
Donations directed by individuals,9/23/23,Deposit,2RG00312E60205211,04 PAYPAL GENERAL UNRESTR,Support Ukraine - Support Ukraine,Contributed income:Donations directed by individuals,PayPal Bank 3,"$2,000.00 ","$909,215.01 "
PayPal Fees,9/23/23,Deposit,2RG00312E60205211,04 PAYPAL GENERAL UNRESTR,PayPal fees,OFFICE/GENERAL ADMINISTRATIVE EXPENSES:PayPal Fees,PayPal Bank 3,$58.29 ,"$909,273.30 "
PayPal Bank 3,9/23/23,Deposit,9FL410281P3847604,04 PAYPAL GENERAL UNRESTR,"Subject: Support Ukraine
Transaction ID: 9FL410281P3847604
https://www.paypal.com/activity/payment/9FL410281P3847604",PayPal Bank 3,--,$25.00 ,"$909,298.30 "
Donations directed by individuals,9/23/23,Deposit,9FL410281P3847604,04 PAYPAL GENERAL UNRESTR,Money in to PayPal,Contributed income:Donations directed by individuals,PayPal Bank 3,$26.25 ,"$909,324.55 "
PayPal Fees,9/23/23,Deposit,9FL410281P3847604,04 PAYPAL GENERAL UNRESTR,PayPal fees,OFFICE/GENERAL ADMINISTRATIVE EXPENSES:PayPal Fees,PayPal Bank 3,$1.25 ,"$909,325.80 "
PayPal Bank 3,9/23/23,Deposit,26W22203Y72452334,04 PAYPAL GENERAL UNRESTR,"Subject: GeneralPage
Transaction ID: 26W22203Y72452334
https://www.paypal.com/activity/payment/26W22203Y72452334",PayPal Bank 3,--,$9.07 ,"$909,334.87 "
Donations directed by individuals,9/23/23,Deposit,26W22203Y72452334,04 PAYPAL GENERAL UNRESTR,Support Ukraine - Support Ukraine,Contributed income:Donations directed by individuals,PayPal Bank 3,$10.00 ,"$909,344.87 "
PayPal Fees,9/23/23,Deposit,26W22203Y72452334,04 PAYPAL GENERAL UNRESTR,PayPal fees,OFFICE/GENERAL ADMINISTRATIVE EXPENSES:PayPal Fees,PayPal Bank 3,$0.93 ,"$909,345.80 "
PayPal Bank 3,9/23/23,Deposit,9AF94349FL570562G,04 PAYPAL GENERAL UNRESTR,"Subject: Support Ukraine
Transaction ID: 9AF94349FL570562G
https://www.paypal.com/activity/payment/9AF94349FL570562G",PayPal Bank 3,--,$68.35 ,"$909,414.15 "
Donations directed by individuals,9/23/23,Deposit,9AF94349FL570562G,04 PAYPAL GENERAL UNRESTR,Money in to PayPal,Contributed income:Donations directed by individuals,PayPal Bank 3,$72.00 ,"$909,486.15 "
PayPal Fees,9/23/23,Deposit,9AF94349FL570562G,04 PAYPAL GENERAL UNRESTR,PayPal fees,OFFICE/GENERAL ADMINISTRATIVE EXPENSES:PayPal Fees,PayPal Bank 3,$3.65 ,"$909,489.80 "
PayPal Bank 3,9/23/23,Deposit,8TJ76527VB7262132,04 PAYPAL GENERAL UNRESTR,"Subject: GeneralPage
Transaction ID: 8TJ76527VB7262132
https://www.paypal.com/activity/payment/8TJ76527VB7262132",PayPal Bank 3,--,$193.73 ,"$909,683.53 "
Donations directed by individuals,9/23/23,Deposit,8TJ76527VB7262132,04 PAYPAL GENERAL UNRESTR,Support Ukraine - Support Ukraine,Contributed income:Donations directed by individuals,PayPal Bank 3,$200.00 ,"$909,883.53 "
PayPal Fees,9/23/23,Deposit,8TJ76527VB7262132,04 PAYPAL GENERAL UNRESTR,PayPal fees,OFFICE/GENERAL ADMINISTRATIVE EXPENSES:PayPal Fees,PayPal Bank 3,$6.27 ,"$909,889.80 "
PayPal Bank 3,9/23/23,Deposit,6N342795V3145753P,04 PAYPAL GENERAL UNRESTR,"Subject: GeneralPage
Transaction ID: 6N342795V3145753P
https://www.paypal.com/activity/payment/6N342795V3145753P",PayPal Bank 3,--,$33.47 ,"$909,923.27 "
Donations directed by individuals,9/23/23,Deposit,6N342795V3145753P,04 PAYPAL GENERAL UNRESTR,Support Ukraine - Support Ukraine,Contributed income:Donations directed by individuals,PayPal Bank 3,$35.52 ,"$909,958.79 "
PayPal Fees,9/23/23,Deposit,6N342795V3145753P,04 PAYPAL GENERAL UNRESTR,PayPal fees,OFFICE/GENERAL ADMINISTRATIVE EXPENSES:PayPal Fees,PayPal Bank 3,$2.05 ,"$909,960.84 "
PayPal Bank 3,9/23/23,Deposit,8T877231T1544720B,04 PAYPAL GENERAL UNRESTR,"Subject: GeneralPage
Transaction ID: 8T877231T1544720B
https://www.paypal.com/activity/payment/8T877231T1544720B",PayPal Bank 3,--,$43.21 ,"$910,004.05 "
Donations directed by individuals,9/23/23,Deposit,8T877231T1544720B,04 PAYPAL GENERAL UNRESTR,Support Ukraine - Support Ukraine,Contributed income:Donations directed by individuals,PayPal Bank 3,$45.00 ,"$910,049.05 "
PayPal Fees,9/23/23,Deposit,8T877231T1544720B,04 PAYPAL GENERAL UNRESTR,PayPal fees,OFFICE/GENERAL ADMINISTRATIVE EXPENSES:PayPal Fees,PayPal Bank 3,$1.79 ,"$910,050.84 "
PayPal Bank 3,9/23/23,Deposit,5GX51317U50567018,07 1000 DRONES RESTR,"Subject: 1000DRONES
Transaction ID: 5GX51317U50567018
https://www.paypal.com/activity/payment/5GX51317U50567018",PayPal Bank 3,--,$48.06 ,"$910,098.90 "
Donations directed by individuals,9/23/23,Deposit,5GX51317U50567018,07 1000 DRONES RESTR,1000 DRONES FOR UKRAINE - 1000 DRONES FOR UKRAINE,Contributed income:Donations directed by individuals,PayPal Bank 3,$50.00 ,"$910,148.90 "
PayPal Fees,9/23/23,Deposit,5GX51317U50567018,07 1000 DRONES RESTR,PayPal fees,OFFICE/GENERAL ADMINISTRATIVE EXPENSES:PayPal Fees,PayPal Bank 3,$1.94 ,"$910,150.84 "
PayPal Bank 3,9/23/23,Deposit,78F25486W9536003E,07 1000 DRONES RESTR,"Subject: 1000DRONES
Transaction ID: 78F25486W9536003E
https://www.paypal.com/activity/payment/78F25486W9536003E",PayPal Bank 3,--,$51.00 ,"$910,201.84 "
Donations directed by individuals,9/23/23,Deposit,78F25486W9536003E,07 1000 DRONES RESTR,1000 DRONES FOR UKRAINE - 1000 DRONES FOR UKRAINE,Contributed income:Donations directed by individuals,PayPal Bank 3,$53.02 ,"$910,254.86 "
PayPal Fees,9/23/23,Deposit,78F25486W9536003E,07 1000 DRONES RESTR,PayPal fees,OFFICE/GENERAL ADMINISTRATIVE EXPENSES:PayPal Fees,PayPal Bank 3,$2.02 ,"$910,256.88 "
PayPal Bank 3,9/23/23,Deposit,1NM59292S3155102V,07 1000 DRONES RESTR,"Subject: 1000DRONES
Transaction ID: 1NM59292S3155102V
https://www.paypal.com/activity/payment/1NM59292S3155102V",PayPal Bank 3,--,$50.00 ,"$910,306.88 "
Donations directed by individuals,9/23/23,Deposit,1NM59292S3155102V,07 1000 DRONES RESTR,1000 DRONES FOR UKRAINE - 1000 DRONES FOR UKRAINE,Contributed income:Donations directed by individuals,PayPal Bank 3,$51.99 ,"$910,358.87 "
PayPal Fees,9/23/23,Deposit,1NM59292S3155102V,07 1000 DRONES RESTR,PayPal fees,OFFICE/GENERAL ADMINISTRATIVE EXPENSES:PayPal Fees,PayPal Bank 3,$1.99 ,"$910,360.86 "
PayPal Bank 3,9/23/23,Deposit,0U783249UR824542A,04 PAYPAL GENERAL UNRESTR,"Subject: GeneralPage
Transaction ID: 0U783249UR824542A
https://www.paypal.com/activity/payment/0U783249UR824542A",PayPal Bank 3,--,$49.22 ,"$910,410.08 "
Donations directed by individuals,9/23/23,Deposit,0U783249UR824542A,04 PAYPAL GENERAL UNRESTR,Support Ukraine - Support Ukraine,Contributed income:Donations directed by individuals,PayPal Bank 3,$51.99 ,"$910,462.07 "
PayPal Fees,9/23/23,Deposit,0U783249UR824542A,04 PAYPAL GENERAL UNRESTR,PayPal fees,OFFICE/GENERAL ADMINISTRATIVE EXPENSES:PayPal Fees,PayPal Bank 3,$2.77 ,"$910,464.84 "
PayPal Bank 3,9/23/23,Deposit,42H94566U4364802S,04 PAYPAL GENERAL UNRESTR,"Subject: GeneralPage
Transaction ID: 42H94566U4364802S
https://www.paypal.com/activity/payment/42H94566U4364802S",PayPal Bank 3,--,$18.93 ,"$910,483.77 "
Donations directed by individuals,9/23/23,Deposit,42H94566U4364802S,04 PAYPAL GENERAL UNRESTR,Support Ukraine - Support Ukraine,Contributed income:Donations directed by individuals,PayPal Bank 3,$20.00 ,"$910,503.77 "
PayPal Fees,9/23/23,Deposit,42H94566U4364802S,04 PAYPAL GENERAL UNRESTR,PayPal fees,OFFICE/GENERAL ADMINISTRATIVE EXPENSES:PayPal Fees,PayPal Bank 3,$1.07 ,"$910,504.84 "
PayPal Bank 3,9/23/23,Deposit,51836067JM587700N,04 PAYPAL GENERAL UNRESTR,"Subject: GeneralPage
Transaction ID: 51836067JM587700N
https://www.paypal.com/activity/payment/51836067JM587700N",PayPal Bank 3,--,$10.00 ,"$910,514.84 "
Donations directed by individuals,9/23/23,Deposit,51836067JM587700N,04 PAYPAL GENERAL UNRESTR,Support Ukraine - Support Ukraine,Contributed income:Donations directed by individuals,PayPal Bank 3,$10.80 ,"$910,525.64 "
PayPal Fees,9/23/23,Deposit,51836067JM587700N,04 PAYPAL GENERAL UNRESTR,PayPal fees,OFFICE/GENERAL ADMINISTRATIVE EXPENSES:PayPal Fees,PayPal Bank 3,$0.80 ,"$910,526.44 "
PayPal Bank 3,9/23/23,Deposit,9J4295428X058634N,07 1000 DRONES RESTR,"Subject: 1000DRONES
Transaction ID: 9J4295428X058634N
https://www.paypal.com/activity/payment/9J4295428X058634N",PayPal Bank 3,--,$96.62 ,"$910,623.06 "
Donations directed by individuals,9/23/23,Deposit,9J4295428X058634N,07 1000 DRONES RESTR,1000 DRONES FOR UKRAINE - 1000 DRONES FOR UKRAINE,Contributed income:Donations directed by individuals,PayPal Bank 3,$100.00 ,"$910,723.06 "
PayPal Fees,9/23/23,Deposit,9J4295428X058634N,07 1000 DRONES RESTR,PayPal fees,OFFICE/GENERAL ADMINISTRATIVE EXPENSES:PayPal Fees,PayPal Bank 3,$3.38 ,"$910,726.44 "
PayPal Bank 3,9/23/23,Deposit,5PA79431BA3165439,04 PAYPAL GENERAL UNRESTR,"Subject: GeneralPage
Transaction ID: 5PA79431BA3165439
https://www.paypal.com/activity/payment/5PA79431BA3165439",PayPal Bank 3,--,"$2,912.81 ","$913,639.25 "
Donations directed by individuals,9/23/23,Deposit,5PA79431BA3165439,04 PAYPAL GENERAL UNRESTR,Support Ukraine - Support Ukraine,Contributed income:Donations directed by individuals,PayPal Bank 3,"$3,000.00 ","$916,639.25 "
PayPal Fees,9/23/23,Deposit,5PA79431BA3165439,04 PAYPAL GENERAL UNRESTR,PayPal fees,OFFICE/GENERAL ADMINISTRATIVE EXPENSES:PayPal Fees,PayPal Bank 3,$87.19 ,"$916,726.44 "
PayPal Bank 3,9/23/23,Deposit,34S99665R0270580N,07 1000 DRONES RESTR,"Subject: 1000DRONES
Transaction ID: 34S99665R0270580N
https://www.paypal.com/activity/payment/34S99665R0270580N",PayPal Bank 3,--,$48.06 ,"$916,774.50 "
Donations directed by individuals,9/23/23,Deposit,34S99665R0270580N,07 1000 DRONES RESTR,1000 DRONES FOR UKRAINE - 1000 DRONES FOR UKRAINE,Contributed income:Donations directed by individuals,PayPal Bank 3,$50.00 ,"$916,824.50 "
PayPal Fees,9/23/23,Deposit,34S99665R0270580N,07 1000 DRONES RESTR,PayPal fees,OFFICE/GENERAL ADMINISTRATIVE EXPENSES:PayPal Fees,PayPal Bank 3,$1.94 ,"$916,826.44 "
PayPal Bank 3,9/23/23,Deposit,15D70934N0933822G,04 PAYPAL GENERAL UNRESTR,"Transaction ID: 15D70934N0933822G
https://www.paypal.com/activity/payment/15D70934N0933822G",PayPal Bank 3,--,$63.06 ,"$916,889.50 "
Donations directed by individuals,9/23/23,Deposit,15D70934N0933822G,04 PAYPAL GENERAL UNRESTR,Money in to PayPal,Contributed income:Donations directed by individuals,PayPal Bank 3,$65.00 ,"$916,954.50 "
PayPal Fees,9/23/23,Deposit,15D70934N0933822G,04 PAYPAL GENERAL UNRESTR,PayPal fees,OFFICE/GENERAL ADMINISTRATIVE EXPENSES:PayPal Fees,PayPal Bank 3,$1.94 ,"$916,956.44 "
PayPal Bank 3,9/23/23,Deposit,5CA36807KN644971L,04 PAYPAL GENERAL UNRESTR,"Subject: Support Ukraine
Transaction ID: 5CA36807KN644971L
https://www.paypal.com/activity/payment/5CA36807KN644971L",PayPal Bank 3,--,$29.53 ,"$916,985.97 "
Donations directed by individuals,9/23/23,Deposit,5CA36807KN644971L,04 PAYPAL GENERAL UNRESTR,Money in to PayPal,Contributed income:Donations directed by individuals,PayPal Bank 3,$31.40 ,"$917,017.37 "
PayPal Fees,9/23/23,Deposit,5CA36807KN644971L,04 PAYPAL GENERAL UNRESTR,PayPal fees,OFFICE/GENERAL ADMINISTRATIVE EXPENSES:PayPal Fees,PayPal Bank 3,$1.87 ,"$917,019.24 "
PayPal Bank 3,9/23/23,Deposit,13V74422FY753873N,04 PAYPAL GENERAL UNRESTR,"Subject: GeneralPage
Transaction ID: 13V74422FY753873N
https://www.paypal.com/activity/payment/13V74422FY753873N",PayPal Bank 3,--,$10.00 ,"$917,029.24 "
Donations directed by individuals,9/23/23,Deposit,13V74422FY753873N,04 PAYPAL GENERAL UNRESTR,Support Ukraine - Support Ukraine,Contributed income:Donations directed by individuals,PayPal Bank 3,$10.80 ,"$917,040.04 "
PayPal Fees,9/23/23,Deposit,13V74422FY753873N,04 PAYPAL GENERAL UNRESTR,PayPal fees,OFFICE/GENERAL ADMINISTRATIVE EXPENSES:PayPal Fees,PayPal Bank 3,$0.80 ,"$917,040.84 "
PayPal Bank 3,9/23/23,Deposit,71L55419TW982943L,04 PAYPAL GENERAL UNRESTR,"Subject: GeneralPage
Transaction ID: 71L55419TW982943L
https://www.paypal.com/activity/payment/71L55419TW982943L",PayPal Bank 3,--,$96.00 ,"$917,136.84 "
Donations directed by individuals,9/23/23,Deposit,71L55419TW982943L,04 PAYPAL GENERAL UNRESTR,Support Ukraine - Support Ukraine,Contributed income:Donations directed by individuals,PayPal Bank 3,$99.36 ,"$917,236.20 "
PayPal Fees,9/23/23,Deposit,71L55419TW982943L,04 PAYPAL GENERAL UNRESTR,PayPal fees,OFFICE/GENERAL ADMINISTRATIVE EXPENSES:PayPal Fees,PayPal Bank 3,$3.36 ,"$917,239.56 "
PayPal Bank 3,9/23/23,Deposit,7A087318BH466411C,04 PAYPAL GENERAL UNRESTR,"Subject: Support Ukraine
Transaction ID: 7A087318BH466411C
https://www.paypal.com/activity/payment/7A087318BH466411C",PayPal Bank 3,--,$100.00 ,"$917,339.56 "
Donations directed by individuals,9/23/23,Deposit,7A087318BH466411C,04 PAYPAL GENERAL UNRESTR,Money in to PayPal,Contributed income:Donations directed by individuals,PayPal Bank 3,$103.48 ,"$917,443.04 "
PayPal Fees,9/23/23,Deposit,7A087318BH466411C,04 PAYPAL GENERAL UNRESTR,PayPal fees,OFFICE/GENERAL ADMINISTRATIVE EXPENSES:PayPal Fees,PayPal Bank 3,$3.48 ,"$917,446.52 "
PayPal Bank 3,9/23/23,Deposit,04G44155D73746205,04 PAYPAL GENERAL UNRESTR,"Subject: Support Ukraine
Transaction ID: 04G44155D73746205
https://www.paypal.com/activity/payment/04G44155D73746205",PayPal Bank 3,--,$47.31 ,"$917,493.83 "
Donations directed by individuals,9/23/23,Deposit,04G44155D73746205,04 PAYPAL GENERAL UNRESTR,Money in to PayPal,Contributed income:Donations directed by individuals,PayPal Bank 3,$50.00 ,"$917,543.83 "
PayPal Fees,9/23/23,Deposit,04G44155D73746205,04 PAYPAL GENERAL UNRESTR,PayPal fees,OFFICE/GENERAL ADMINISTRATIVE EXPENSES:PayPal Fees,PayPal Bank 3,$2.69 ,"$917,546.52 "
PayPal Bank 3,9/23/23,Deposit,4BE16008E6168690H,04 PAYPAL GENERAL UNRESTR,"Subject: Support Ukraine
Transaction ID: 4BE16008E6168690H
https://www.paypal.com/activity/payment/4BE16008E6168690H",PayPal Bank 3,--,$18.63 ,"$917,565.15 "
Donations directed by individuals,9/23/23,Deposit,4BE16008E6168690H,04 PAYPAL GENERAL UNRESTR,Money in to PayPal,Contributed income:Donations directed by individuals,PayPal Bank 3,$20.00 ,"$917,585.15 "
PayPal Fees,9/23/23,Deposit,4BE16008E6168690H,04 PAYPAL GENERAL UNRESTR,PayPal fees,OFFICE/GENERAL ADMINISTRATIVE EXPENSES:PayPal Fees,PayPal Bank 3,$1.37 ,"$917,586.52 "
PayPal Bank 3,9/23/23,Deposit,02D910410J470822A,04 PAYPAL GENERAL UNRESTR,"Subject: Support Ukraine
Transaction ID: 02D910410J470822A
https://www.paypal.com/activity/payment/02D910410J470822A",PayPal Bank 3,--,$4.91 ,"$917,591.43 "
Donations directed by individuals,9/23/23,Deposit,02D910410J470822A,04 PAYPAL GENERAL UNRESTR,Money in to PayPal,Contributed income:Donations directed by individuals,PayPal Bank 3,$5.65 ,"$917,597.08 "
PayPal Fees,9/23/23,Deposit,02D910410J470822A,04 PAYPAL GENERAL UNRESTR,PayPal fees,OFFICE/GENERAL ADMINISTRATIVE EXPENSES:PayPal Fees,PayPal Bank 3,$0.74 ,"$917,597.82 "
PayPal Bank 3,9/23/23,Deposit,2Y456890DA875781C,04 PAYPAL GENERAL UNRESTR,"Subject: Support Ukraine
Transaction ID: 2Y456890DA875781C
https://www.paypal.com/activity/payment/2Y456890DA875781C",PayPal Bank 3,--,$23.41 ,"$917,621.23 "
Donations directed by individuals,9/23/23,Deposit,2Y456890DA875781C,04 PAYPAL GENERAL UNRESTR,Money in to PayPal,Contributed income:Donations directed by individuals,PayPal Bank 3,$25.00 ,"$917,646.23 "
PayPal Fees,9/23/23,Deposit,2Y456890DA875781C,04 PAYPAL GENERAL UNRESTR,PayPal fees,OFFICE/GENERAL ADMINISTRATIVE EXPENSES:PayPal Fees,PayPal Bank 3,$1.59 ,"$917,647.82 "
PayPal Bank 3,9/23/23,Deposit,1LM92038FY190573T,04 PAYPAL GENERAL UNRESTR,"Subject: GeneralPage
Transaction ID: 1LM92038FY190573T
https://www.paypal.com/activity/payment/1LM92038FY190573T",PayPal Bank 3,--,$98.45 ,"$917,746.27 "
Donations directed by individuals,9/23/23,Deposit,1LM92038FY190573T,04 PAYPAL GENERAL UNRESTR,Support Ukraine - Support Ukraine,Contributed income:Donations directed by individuals,PayPal Bank 3,$103.48 ,"$917,849.75 "
PayPal Fees,9/23/23,Deposit,1LM92038FY190573T,04 PAYPAL GENERAL UNRESTR,PayPal fees,OFFICE/GENERAL ADMINISTRATIVE EXPENSES:PayPal Fees,PayPal Bank 3,$5.03 ,"$917,854.78 "
PayPal Bank 3,9/23/23,Deposit,45M624386T715762R,04 PAYPAL GENERAL UNRESTR,"Subject: GeneralPage
Transaction ID: 45M624386T715762R
https://www.paypal.com/activity/payment/45M624386T715762R",PayPal Bank 3,--,$48.06 ,"$917,902.84 "
Donations directed by individuals,9/23/23,Deposit,45M624386T715762R,04 PAYPAL GENERAL UNRESTR,Support Ukraine - Support Ukraine,Contributed income:Donations directed by individuals,PayPal Bank 3,$50.00 ,"$917,952.84 "
PayPal Fees,9/23/23,Deposit,45M624386T715762R,04 PAYPAL GENERAL UNRESTR,PayPal fees,OFFICE/GENERAL ADMINISTRATIVE EXPENSES:PayPal Fees,PayPal Bank 3,$1.94 ,"$917,954.78 "
PayPal Bank 3,9/23/23,Deposit,99569497VD451211B,04 PAYPAL GENERAL UNRESTR,"Subject: GeneralPage
Note: Spende Ukraine
Transaction ID: 99569497VD451211B
https://www.paypal.com/activity/payment/99569497VD451211B",PayPal Bank 3,--,$344.59 ,"$918,299.37 "
Donations directed by individuals,9/23/23,Deposit,99569497VD451211B,04 PAYPAL GENERAL UNRESTR,Support Ukraine - Support Ukraine,Contributed income:Donations directed by individuals,PayPal Bank 3,$360.92 ,"$918,660.29 "
PayPal Fees,9/23/23,Deposit,99569497VD451211B,04 PAYPAL GENERAL UNRESTR,PayPal fees,OFFICE/GENERAL ADMINISTRATIVE EXPENSES:PayPal Fees,PayPal Bank 3,$16.33 ,"$918,676.62 "
PayPal Bank 3,9/23/23,Deposit,3T873985DH286712E,04 PAYPAL GENERAL UNRESTR,"Subject: Support Ukraine
Transaction ID: 3T873985DH286712E
https://www.paypal.com/activity/payment/3T873985DH286712E",PayPal Bank 3,--,$50.00 ,"$918,726.62 "
Donations directed by individuals,9/23/23,Deposit,3T873985DH286712E,04 PAYPAL GENERAL UNRESTR,Money in to PayPal,Contributed income:Donations directed by individuals,PayPal Bank 3,$51.99 ,"$918,778.61 "
PayPal Fees,9/23/23,Deposit,3T873985DH286712E,04 PAYPAL GENERAL UNRESTR,PayPal fees,OFFICE/GENERAL ADMINISTRATIVE EXPENSES:PayPal Fees,PayPal Bank 3,$1.99 ,"$918,780.60 "
PayPal Bank 3,9/23/23,Deposit,6SK89523M9875584P,04 PAYPAL GENERAL UNRESTR,"Subject: GeneralPage
Transaction ID: 6SK89523M9875584P
https://www.paypal.com/activity/payment/6SK89523M9875584P",PayPal Bank 3,--,$193.73 ,"$918,974.33 "
Donations directed by individuals,9/23/23,Deposit,6SK89523M9875584P,04 PAYPAL GENERAL UNRESTR,Support Ukraine - Support Ukraine,Contributed income:Donations directed by individuals,PayPal Bank 3,$200.00 ,"$919,174.33 "
PayPal Fees,9/23/23,Deposit,6SK89523M9875584P,04 PAYPAL GENERAL UNRESTR,PayPal fees,OFFICE/GENERAL ADMINISTRATIVE EXPENSES:PayPal Fees,PayPal Bank 3,$6.27 ,"$919,180.60 "
PayPal Bank 3,9/23/23,Deposit,9F973955SH182635L,04 PAYPAL GENERAL UNRESTR,"Subject: GeneralPage
Transaction ID: 9F973955SH182635L
https://www.paypal.com/activity/payment/9F973955SH182635L",PayPal Bank 3,--,$67.49 ,"$919,248.09 "
Donations directed by individuals,9/23/23,Deposit,9F973955SH182635L,04 PAYPAL GENERAL UNRESTR,Support Ukraine - Support Ukraine,Contributed income:Donations directed by individuals,PayPal Bank 3,$70.00 ,"$919,318.09 "
PayPal Fees,9/23/23,Deposit,9F973955SH182635L,04 PAYPAL GENERAL UNRESTR,PayPal fees,OFFICE/GENERAL ADMINISTRATIVE EXPENSES:PayPal Fees,PayPal Bank 3,$2.51 ,"$919,320.60 "
PayPal Bank 3,9/23/23,Deposit,19P82825UW920902X,08 VICTORY DRONES RESTR,"Subject: GeneralPage
Note: Donate for victory drones
Transaction ID: 19P82825UW920902X
https://www.paypal.com/activity/payment/19P82825UW920902X",PayPal Bank 3,--,$98.45 ,"$919,419.05 "
Donations directed by individuals,9/23/23,Deposit,19P82825UW920902X,08 VICTORY DRONES RESTR,Support Ukraine - Support Ukraine,Contributed income:Donations directed by individuals,PayPal Bank 3,$103.48 ,"$919,522.53 "
PayPal Fees,9/23/23,Deposit,19P82825UW920902X,08 VICTORY DRONES RESTR,PayPal fees,OFFICE/GENERAL ADMINISTRATIVE EXPENSES:PayPal Fees,PayPal Bank 3,$5.03 ,"$919,527.56 "
PayPal Bank 3,9/23/23,Deposit,1YD34091R7488540S,04 PAYPAL GENERAL UNRESTR,"Transaction ID: 1YD34091R7488540S
https://www.paypal.com/activity/payment/1YD34091R7488540S",PayPal Bank 3,--,$9.31 ,"$919,536.87 "
Donations directed by individuals,9/23/23,Deposit,1YD34091R7488540S,04 PAYPAL GENERAL UNRESTR,Money in to PayPal,Contributed income:Donations directed by individuals,PayPal Bank 3,$10.00 ,"$919,546.87 "
PayPal Fees,9/23/23,Deposit,1YD34091R7488540S,04 PAYPAL GENERAL UNRESTR,PayPal fees,OFFICE/GENERAL ADMINISTRATIVE EXPENSES:PayPal Fees,PayPal Bank 3,$0.69 ,"$919,547.56 "
PayPal Bank 3,9/23/23,Deposit,8WS73739X12345511,07 1000 DRONES RESTR,"Subject: 1000DRONES
Transaction ID: 8WS73739X12345511
https://www.paypal.com/activity/payment/8WS73739X12345511",PayPal Bank 3,--,$196.93 ,"$919,744.49 "
Donations directed by individuals,9/23/23,Deposit,8WS73739X12345511,07 1000 DRONES RESTR,1000 DRONES FOR UKRAINE - 1000 DRONES FOR UKRAINE,Contributed income:Donations directed by individuals,PayPal Bank 3,$204.56 ,"$919,949.05 "
PayPal Fees,9/23/23,Deposit,8WS73739X12345511,07 1000 DRONES RESTR,PayPal fees,OFFICE/GENERAL ADMINISTRATIVE EXPENSES:PayPal Fees,PayPal Bank 3,$7.63 ,"$919,956.68 "
PayPal Bank 3,9/23/23,Deposit,3UT78771CR865904G,07 1000 DRONES RESTR,"Subject: 1000DRONES
Transaction ID: 3UT78771CR865904G
https://www.paypal.com/activity/payment/3UT78771CR865904G",PayPal Bank 3,--,$40.00 ,"$919,996.68 "
Donations directed by individuals,9/23/23,Deposit,3UT78771CR865904G,07 1000 DRONES RESTR,1000 DRONES FOR UKRAINE - 1000 DRONES FOR UKRAINE,Contributed income:Donations directed by individuals,PayPal Bank 3,$41.31 ,"$920,037.99 "
PayPal Fees,9/23/23,Deposit,3UT78771CR865904G,07 1000 DRONES RESTR,PayPal fees,OFFICE/GENERAL ADMINISTRATIVE EXPENSES:PayPal Fees,PayPal Bank 3,$1.31 ,"$920,039.30 "
PayPal Bank 3,9/23/23,Deposit,3FE87981R98698824,04 PAYPAL GENERAL UNRESTR,"Subject: Support Ukraine
Transaction ID: 3FE87981R98698824
https://www.paypal.com/activity/payment/3FE87981R98698824",PayPal Bank 3,--,$47.76 ,"$920,087.06 "
Donations directed by individuals,9/23/23,Deposit,3FE87981R98698824,04 PAYPAL GENERAL UNRESTR,Money in to PayPal,Contributed income:Donations directed by individuals,PayPal Bank 3,$50.00 ,"$920,137.06 "
PayPal Fees,9/23/23,Deposit,3FE87981R98698824,04 PAYPAL GENERAL UNRESTR,PayPal fees,OFFICE/GENERAL ADMINISTRATIVE EXPENSES:PayPal Fees,PayPal Bank 3,$2.24 ,"$920,139.30 "
PayPal Bank 3,9/23/23,Deposit,8JE64607KS718594D,04 PAYPAL GENERAL UNRESTR,"Subject: Support Ukraine
Transaction ID: 8JE64607KS718594D
https://www.paypal.com/activity/payment/8JE64607KS718594D",PayPal Bank 3,--,$25.24 ,"$920,164.54 "
Donations directed by individuals,9/23/23,Deposit,8JE64607KS718594D,04 PAYPAL GENERAL UNRESTR,Money in to PayPal,Contributed income:Donations directed by individuals,PayPal Bank 3,$26.25 ,"$920,190.79 "
PayPal Fees,9/23/23,Deposit,8JE64607KS718594D,04 PAYPAL GENERAL UNRESTR,PayPal fees,OFFICE/GENERAL ADMINISTRATIVE EXPENSES:PayPal Fees,PayPal Bank 3,$1.01 ,"$920,191.80 "
PayPal Bank 3,9/23/23,Deposit,2PU14474GD5114805,04 PAYPAL GENERAL UNRESTR,"Subject: Support Ukraine
Transaction ID: 2PU14474GD5114805
https://www.paypal.com/activity/payment/2PU14474GD5114805",PayPal Bank 3,--,$50.47 ,"$920,242.27 "
Donations directed by individuals,9/23/23,Deposit,2PU14474GD5114805,04 PAYPAL GENERAL UNRESTR,Money in to PayPal,Contributed income:Donations directed by individuals,PayPal Bank 3,$51.99 ,"$920,294.26 "
PayPal Fees,9/23/23,Deposit,2PU14474GD5114805,04 PAYPAL GENERAL UNRESTR,PayPal fees,OFFICE/GENERAL ADMINISTRATIVE EXPENSES:PayPal Fees,PayPal Bank 3,$1.52 ,"$920,295.78 "
PayPal Bank 3,9/23/23,Deposit,6AE64066MN9093316,04 PAYPAL GENERAL UNRESTR,"Subject: GeneralPage
Transaction ID: 6AE64066MN9093316
https://www.paypal.com/activity/payment/6AE64066MN9093316",PayPal Bank 3,--,$400.00 ,"$920,695.78 "
Donations directed by individuals,9/23/23,Deposit,6AE64066MN9093316,04 PAYPAL GENERAL UNRESTR,Support Ukraine - Support Ukraine,Contributed income:Donations directed by individuals,PayPal Bank 3,$408.62 ,"$921,104.40 "
PayPal Fees,9/23/23,Deposit,6AE64066MN9093316,04 PAYPAL GENERAL UNRESTR,PayPal fees,OFFICE/GENERAL ADMINISTRATIVE EXPENSES:PayPal Fees,PayPal Bank 3,$8.62 ,"$921,113.02 "
PayPal Bank 3,9/23/23,Deposit,9PS81558AD5751825,07 1000 DRONES RESTR,"Subject: 1000DRONES
Transaction ID: 9PS81558AD5751825
https://www.paypal.com/activity/payment/9PS81558AD5751825",PayPal Bank 3,--,$192.53 ,"$921,305.55 "
Donations directed by individuals,9/23/23,Deposit,9PS81558AD5751825,07 1000 DRONES RESTR,1000 DRONES FOR UKRAINE - 1000 DRONES FOR UKRAINE,Contributed income:Donations directed by individuals,PayPal Bank 3,$200.00 ,"$921,505.55 "
PayPal Fees,9/23/23,Deposit,9PS81558AD5751825,07 1000 DRONES RESTR,PayPal fees,OFFICE/GENERAL ADMINISTRATIVE EXPENSES:PayPal Fees,PayPal Bank 3,$7.47 ,"$921,513.02 "
PayPal Bank 3,9/23/23,Deposit,2JA30787RC953050R,11 VETERANIUS RESTR,"Subject: Veteranius
Transaction ID: 2JA30787RC953050R
https://www.paypal.com/activity/payment/2JA30787RC953050R",PayPal Bank 3,--,$98.46 ,"$921,611.48 "
Donations directed by individuals,9/23/23,Deposit,2JA30787RC953050R,11 VETERANIUS RESTR,Veteranius - helping veterans to learn and gain experience in IT. - Veteranius - helping veterans to learn and gain experience in IT.,Contributed income:Donations directed by individuals,PayPal Bank 3,$102.53 ,"$921,714.01 "
PayPal Fees,9/23/23,Deposit,2JA30787RC953050R,11 VETERANIUS RESTR,PayPal fees,OFFICE/GENERAL ADMINISTRATIVE EXPENSES:PayPal Fees,PayPal Bank 3,$4.07 ,"$921,718.08 "
PayPal Bank 3,9/23/23,Deposit,6XJ28338AM1360502,04 PAYPAL GENERAL UNRESTR,"Subject: GeneralPage
Transaction ID: 6XJ28338AM1360502
https://www.paypal.com/activity/payment/6XJ28338AM1360502",PayPal Bank 3,--,"$1,959.71 ","$923,677.79 "
Donations directed by individuals,9/23/23,Deposit,6XJ28338AM1360502,04 PAYPAL GENERAL UNRESTR,Support Ukraine - Support Ukraine,Contributed income:Donations directed by individuals,PayPal Bank 3,"$2,000.00 ","$925,677.79 "
PayPal Fees,9/23/23,Deposit,6XJ28338AM1360502,04 PAYPAL GENERAL UNRESTR,PayPal fees,OFFICE/GENERAL ADMINISTRATIVE EXPENSES:PayPal Fees,PayPal Bank 3,$40.29 ,"$925,718.08 "
PayPal Bank 3,9/23/23,Deposit,6B946761K9904120E,04 PAYPAL GENERAL UNRESTR,"Subject: GeneralPage
Transaction ID: 6B946761K9904120E
https://www.paypal.com/activity/payment/6B946761K9904120E",PayPal Bank 3,--,$48.51 ,"$925,766.59 "
Donations directed by individuals,9/23/23,Deposit,6B946761K9904120E,04 PAYPAL GENERAL UNRESTR,Support Ukraine - Support Ukraine,Contributed income:Donations directed by individuals,PayPal Bank 3,$50.00 ,"$925,816.59 "
PayPal Fees,9/23/23,Deposit,6B946761K9904120E,04 PAYPAL GENERAL UNRESTR,PayPal fees,OFFICE/GENERAL ADMINISTRATIVE EXPENSES:PayPal Fees,PayPal Bank 3,$1.49 ,"$925,818.08 "
PayPal Bank 3,9/23/23,Deposit,2EP49106DA773372R,07 1000 DRONES RESTR,"Subject: 1000DRONES
Transaction ID: 2EP49106DA773372R
https://www.paypal.com/activity/payment/2EP49106DA773372R",PayPal Bank 3,--,$100.00 ,"$925,918.08 "
Donations directed by individuals,9/23/23,Deposit,2EP49106DA773372R,07 1000 DRONES RESTR,1000 DRONES FOR UKRAINE - 1000 DRONES FOR UKRAINE,Contributed income:Donations directed by individuals,PayPal Bank 3,$102.53 ,"$926,020.61 "
PayPal Fees,9/23/23,Deposit,2EP49106DA773372R,07 1000 DRONES RESTR,PayPal fees,OFFICE/GENERAL ADMINISTRATIVE EXPENSES:PayPal Fees,PayPal Bank 3,$2.53 ,"$926,023.14 "
PayPal Bank 3,9/23/23,Deposit,5WW65991N4317911W,04 PAYPAL GENERAL UNRESTR,"Subject: GeneralPage
Transaction ID: 5WW65991N4317911W
https://www.paypal.com/activity/payment/5WW65991N4317911W",PayPal Bank 3,--,$98.46 ,"$926,121.60 "
Donations directed by individuals,9/23/23,Deposit,5WW65991N4317911W,04 PAYPAL GENERAL UNRESTR,Support Ukraine - Support Ukraine,Contributed income:Donations directed by individuals,PayPal Bank 3,$102.53 ,"$926,224.13 "
PayPal Fees,9/23/23,Deposit,5WW65991N4317911W,04 PAYPAL GENERAL UNRESTR,PayPal fees,OFFICE/GENERAL ADMINISTRATIVE EXPENSES:PayPal Fees,PayPal Bank 3,$4.07 ,"$926,228.20 "
PayPal Bank 3,9/23/23,Deposit,84466089EX976871M,04 PAYPAL GENERAL UNRESTR,"Subject: Support Ukraine
Transaction ID: 84466089EX976871M
https://www.paypal.com/activity/payment/84466089EX976871M",PayPal Bank 3,--,$99.38 ,"$926,327.58 "
Donations directed by individuals,9/23/23,Deposit,84466089EX976871M,04 PAYPAL GENERAL UNRESTR,Money in to PayPal,Contributed income:Donations directed by individuals,PayPal Bank 3,$103.48 ,"$926,431.06 "
PayPal Fees,9/23/23,Deposit,84466089EX976871M,04 PAYPAL GENERAL UNRESTR,PayPal fees,OFFICE/GENERAL ADMINISTRATIVE EXPENSES:PayPal Fees,PayPal Bank 3,$4.10 ,"$926,435.16 "
PayPal Bank 3,9/23/23,Deposit,5PA16879TR066460J,04 PAYPAL GENERAL UNRESTR,"Subject: Support Ukraine
Transaction ID: 5PA16879TR066460J
https://www.paypal.com/activity/payment/5PA16879TR066460J",PayPal Bank 3,--,$20.95 ,"$926,456.11 "
Donations directed by individuals,9/23/23,Deposit,5PA16879TR066460J,04 PAYPAL GENERAL UNRESTR,Money in to PayPal,Contributed income:Donations directed by individuals,PayPal Bank 3,$22.22 ,"$926,478.33 "
PayPal Fees,9/23/23,Deposit,5PA16879TR066460J,04 PAYPAL GENERAL UNRESTR,PayPal fees,OFFICE/GENERAL ADMINISTRATIVE EXPENSES:PayPal Fees,PayPal Bank 3,$1.27 ,"$926,479.60 "
PayPal Bank 3,9/23/23,Deposit,26R09799C76104222,07 1000 DRONES RESTR,"Subject: 1000DRONES
Transaction ID: 26R09799C76104222
https://www.paypal.com/activity/payment/26R09799C76104222",PayPal Bank 3,--,$100.00 ,"$926,579.60 "
Donations directed by individuals,9/23/23,Deposit,26R09799C76104222,07 1000 DRONES RESTR,1000 DRONES FOR UKRAINE - 1000 DRONES FOR UKRAINE,Contributed income:Donations directed by individuals,PayPal Bank 3,$102.53 ,"$926,682.13 "
PayPal Fees,9/23/23,Deposit,26R09799C76104222,07 1000 DRONES RESTR,PayPal fees,OFFICE/GENERAL ADMINISTRATIVE EXPENSES:PayPal Fees,PayPal Bank 3,$2.53 ,"$926,684.66 "
PayPal Bank 3,9/23/23,Deposit,83N187201S549120G,04 PAYPAL GENERAL UNRESTR,"Subject: GeneralPage
Transaction ID: 83N187201S549120G
https://www.paypal.com/activity/payment/83N187201S549120G",PayPal Bank 3,--,$979.61 ,"$927,664.27 "
Donations directed by individuals,9/23/23,Deposit,83N187201S549120G,04 PAYPAL GENERAL UNRESTR,Support Ukraine - Support Ukraine,Contributed income:Donations directed by individuals,PayPal Bank 3,"$1,000.00 ","$928,664.27 "
PayPal Fees,9/23/23,Deposit,83N187201S549120G,04 PAYPAL GENERAL UNRESTR,PayPal fees,OFFICE/GENERAL ADMINISTRATIVE EXPENSES:PayPal Fees,PayPal Bank 3,$20.39 ,"$928,684.66 "
PayPal Bank 3,9/23/23,Deposit,33765861FR6787714,08 VICTORY DRONES RESTR,"Subject: VICTORY DRONES
Transaction ID: 33765861FR6787714
https://www.paypal.com/activity/payment/33765861FR6787714",PayPal Bank 3,--,$2.97 ,"$928,687.63 "
Donations directed by individuals,9/23/23,Deposit,33765861FR6787714,08 VICTORY DRONES RESTR,Money in to PayPal,Contributed income:Donations directed by individuals,PayPal Bank 3,$3.59 ,"$928,691.22 "
PayPal Fees,9/23/23,Deposit,33765861FR6787714,08 VICTORY DRONES RESTR,PayPal fees,OFFICE/GENERAL ADMINISTRATIVE EXPENSES:PayPal Fees,PayPal Bank 3,$0.62 ,"$928,691.84 "
PayPal Bank 3,9/23/23,Deposit,1P552229DP111282U,04 PAYPAL GENERAL UNRESTR,"Subject: Support Ukraine
Transaction ID: 1P552229DP111282U
https://www.paypal.com/activity/payment/1P552229DP111282U",PayPal Bank 3,--,$14.90 ,"$928,706.74 "
Donations directed by individuals,9/23/23,Deposit,1P552229DP111282U,04 PAYPAL GENERAL UNRESTR,Money in to PayPal,Contributed income:Donations directed by individuals,PayPal Bank 3,$15.95 ,"$928,722.69 "
PayPal Fees,9/23/23,Deposit,1P552229DP111282U,04 PAYPAL GENERAL UNRESTR,PayPal fees,OFFICE/GENERAL ADMINISTRATIVE EXPENSES:PayPal Fees,PayPal Bank 3,$1.05 ,"$928,723.74 "
PayPal Bank 3,9/23/23,Deposit,0TA752610A418533K,04 PAYPAL GENERAL UNRESTR,"Subject: GeneralPage
Transaction ID: 0TA752610A418533K
https://www.paypal.com/activity/payment/0TA752610A418533K",PayPal Bank 3,--,$10.00 ,"$928,733.74 "
Donations directed by individuals,9/23/23,Deposit,0TA752610A418533K,04 PAYPAL GENERAL UNRESTR,Support Ukraine - Support Ukraine,Contributed income:Donations directed by individuals,PayPal Bank 3,$10.70 ,"$928,744.44 "
PayPal Fees,9/23/23,Deposit,0TA752610A418533K,04 PAYPAL GENERAL UNRESTR,PayPal fees,OFFICE/GENERAL ADMINISTRATIVE EXPENSES:PayPal Fees,PayPal Bank 3,$0.70 ,"$928,745.14 "
PayPal Bank 3,9/23/23,Deposit,4GU45865KY334124U,04 PAYPAL GENERAL UNRESTR,"Subject: GeneralPage
Transaction ID: 4GU45865KY334124U
https://www.paypal.com/activity/payment/4GU45865KY334124U",PayPal Bank 3,--,$19.11 ,"$928,764.25 "
Donations directed by individuals,9/23/23,Deposit,4GU45865KY334124U,04 PAYPAL GENERAL UNRESTR,Support Ukraine - Support Ukraine,Contributed income:Donations directed by individuals,PayPal Bank 3,$20.00 ,"$928,784.25 "
PayPal Fees,9/23/23,Deposit,4GU45865KY334124U,04 PAYPAL GENERAL UNRESTR,PayPal fees,OFFICE/GENERAL ADMINISTRATIVE EXPENSES:PayPal Fees,PayPal Bank 3,$0.89 ,"$928,785.14 "
PayPal Bank 3,9/23/23,Deposit,3K659993JD342510P,07 1000 DRONES RESTR,"Subject: 1000DRONES
Transaction ID: 3K659993JD342510P
https://www.paypal.com/activity/payment/3K659993JD342510P",PayPal Bank 3,--,$40.00 ,"$928,825.14 "
Donations directed by individuals,9/23/23,Deposit,3K659993JD342510P,07 1000 DRONES RESTR,1000 DRONES FOR UKRAINE - 1000 DRONES FOR UKRAINE,Contributed income:Donations directed by individuals,PayPal Bank 3,$41.31 ,"$928,866.45 "
PayPal Fees,9/23/23,Deposit,3K659993JD342510P,07 1000 DRONES RESTR,PayPal fees,OFFICE/GENERAL ADMINISTRATIVE EXPENSES:PayPal Fees,PayPal Bank 3,$1.31 ,"$928,867.76 "
PayPal Bank 3,9/23/23,Deposit,0WV599940U585104C,04 PAYPAL GENERAL UNRESTR,"Subject: GeneralPage
Transaction ID: 0WV599940U585104C
https://www.paypal.com/activity/payment/0WV599940U585104C",PayPal Bank 3,--,$25.00 ,"$928,892.76 "
Donations directed by individuals,9/23/23,Deposit,0WV599940U585104C,04 PAYPAL GENERAL UNRESTR,Support Ukraine - Support Ukraine,Contributed income:Donations directed by individuals,PayPal Bank 3,$26.01 ,"$928,918.77 "
PayPal Fees,9/23/23,Deposit,0WV599940U585104C,04 PAYPAL GENERAL UNRESTR,PayPal fees,OFFICE/GENERAL ADMINISTRATIVE EXPENSES:PayPal Fees,PayPal Bank 3,$1.01 ,"$928,919.78 "
PayPal Bank 3,9/23/23,Deposit,5FR896372R403225V,07 1000 DRONES RESTR,"Subject: 1000DRONES
Note: Keep up the efforts!
Transaction ID: 5FR896372R403225V
https://www.paypal.com/activity/payment/5FR896372R403225V",PayPal Bank 3,--,$50.00 ,"$928,969.78 "
Donations directed by individuals,9/23/23,Deposit,5FR896372R403225V,07 1000 DRONES RESTR,1000 DRONES FOR UKRAINE - 1000 DRONES FOR UKRAINE,Contributed income:Donations directed by individuals,PayPal Bank 3,$51.52 ,"$929,021.30 "
PayPal Fees,9/23/23,Deposit,5FR896372R403225V,07 1000 DRONES RESTR,PayPal fees,OFFICE/GENERAL ADMINISTRATIVE EXPENSES:PayPal Fees,PayPal Bank 3,$1.52 ,"$929,022.82 "
PayPal Bank 3,9/23/23,Deposit,2RN51759TG6027126,04 PAYPAL GENERAL UNRESTR,"Subject: GeneralPage
Transaction ID: 2RN51759TG6027126
https://www.paypal.com/activity/payment/2RN51759TG6027126",PayPal Bank 3,--,$98.46 ,"$929,121.28 "
Donations directed by individuals,9/23/23,Deposit,2RN51759TG6027126,04 PAYPAL GENERAL UNRESTR,Support Ukraine - Support Ukraine,Contributed income:Donations directed by individuals,PayPal Bank 3,$102.53 ,"$929,223.81 "
PayPal Fees,9/23/23,Deposit,2RN51759TG6027126,04 PAYPAL GENERAL UNRESTR,PayPal fees,OFFICE/GENERAL ADMINISTRATIVE EXPENSES:PayPal Fees,PayPal Bank 3,$4.07 ,"$929,227.88 "
PayPal Bank 3,9/23/23,Deposit,5T330197UG820070X,07 1000 DRONES RESTR,"Subject: 1000 DRONES FOR UKRAINE
Transaction ID: 5T330197UG820070X
https://www.paypal.com/activity/payment/5T330197UG820070X",PayPal Bank 3,--,$18.81 ,"$929,246.69 "
Donations directed by individuals,9/23/23,Deposit,5T330197UG820070X,07 1000 DRONES RESTR,Money in to PayPal,Contributed income:Donations directed by individuals,PayPal Bank 3,$20.00 ,"$929,266.69 "
PayPal Fees,9/23/23,Deposit,5T330197UG820070X,07 1000 DRONES RESTR,PayPal fees,OFFICE/GENERAL ADMINISTRATIVE EXPENSES:PayPal Fees,PayPal Bank 3,$1.19 ,"$929,267.88 "
PayPal Bank 3,9/23/23,Deposit,18J77972CF9364227,04 PAYPAL GENERAL UNRESTR,"Subject: Support Ukraine
Transaction ID: 18J77972CF9364227
https://www.paypal.com/activity/payment/18J77972CF9364227",PayPal Bank 3,--,$9.93 ,"$929,277.81 "
Donations directed by individuals,9/23/23,Deposit,18J77972CF9364227,04 PAYPAL GENERAL UNRESTR,Money in to PayPal,Contributed income:Donations directed by individuals,PayPal Bank 3,$10.80 ,"$929,288.61 "
PayPal Fees,9/23/23,Deposit,18J77972CF9364227,04 PAYPAL GENERAL UNRESTR,PayPal fees,OFFICE/GENERAL ADMINISTRATIVE EXPENSES:PayPal Fees,PayPal Bank 3,$0.87 ,"$929,289.48 "
PayPal Bank 3,9/23/23,Deposit,8YV9810276530830C,04 PAYPAL GENERAL UNRESTR,"Subject: Support Ukraine
Transaction ID: 8YV9810276530830C
https://www.paypal.com/activity/payment/8YV9810276530830C",PayPal Bank 3,--,$47.70 ,"$929,337.18 "
Donations directed by individuals,9/23/23,Deposit,8YV9810276530830C,04 PAYPAL GENERAL UNRESTR,Money in to PayPal,Contributed income:Donations directed by individuals,PayPal Bank 3,$49.93 ,"$929,387.11 "
PayPal Fees,9/23/23,Deposit,8YV9810276530830C,04 PAYPAL GENERAL UNRESTR,PayPal fees,OFFICE/GENERAL ADMINISTRATIVE EXPENSES:PayPal Fees,PayPal Bank 3,$2.23 ,"$929,389.34 "
PayPal Bank 3,9/23/23,Deposit,07678604JN8369642,04 PAYPAL GENERAL UNRESTR,"Subject: Support Ukraine
Transaction ID: 07678604JN8369642
https://www.paypal.com/activity/payment/07678604JN8369642",PayPal Bank 3,--,$19.87 ,"$929,409.21 "
Donations directed by individuals,9/23/23,Deposit,07678604JN8369642,04 PAYPAL GENERAL UNRESTR,Money in to PayPal,Contributed income:Donations directed by individuals,PayPal Bank 3,$21.10 ,"$929,430.31 "
PayPal Fees,9/23/23,Deposit,07678604JN8369642,04 PAYPAL GENERAL UNRESTR,PayPal fees,OFFICE/GENERAL ADMINISTRATIVE EXPENSES:PayPal Fees,PayPal Bank 3,$1.23 ,"$929,431.54 "
PayPal Bank 3,9/23/23,Deposit,37H36594RR807390K,04 PAYPAL GENERAL UNRESTR,"Subject: GeneralPage
Transaction ID: 37H36594RR807390K
https://www.paypal.com/activity/payment/37H36594RR807390K",PayPal Bank 3,--,$20.00 ,"$929,451.54 "
Donations directed by individuals,9/23/23,Deposit,37H36594RR807390K,04 PAYPAL GENERAL UNRESTR,Support Ukraine - Support Ukraine,Contributed income:Donations directed by individuals,PayPal Bank 3,$20.91 ,"$929,472.45 "
PayPal Fees,9/23/23,Deposit,37H36594RR807390K,04 PAYPAL GENERAL UNRESTR,PayPal fees,OFFICE/GENERAL ADMINISTRATIVE EXPENSES:PayPal Fees,PayPal Bank 3,$0.91 ,"$929,473.36 "
PayPal Bank 3,9/23/23,Deposit,5V9207285B996490E,04 PAYPAL GENERAL UNRESTR,"Subject: GeneralPage
Transaction ID: 5V9207285B996490E
https://www.paypal.com/activity/payment/5V9207285B996490E",PayPal Bank 3,--,$240.78 ,"$929,714.14 "
Donations directed by individuals,9/23/23,Deposit,5V9207285B996490E,04 PAYPAL GENERAL UNRESTR,Support Ukraine - Support Ukraine,Contributed income:Donations directed by individuals,PayPal Bank 3,$250.00 ,"$929,964.14 "
PayPal Fees,9/23/23,Deposit,5V9207285B996490E,04 PAYPAL GENERAL UNRESTR,PayPal fees,OFFICE/GENERAL ADMINISTRATIVE EXPENSES:PayPal Fees,PayPal Bank 3,$9.22 ,"$929,973.36 "
PayPal Bank 3,9/23/23,Deposit,61917329PC2791013,04 PAYPAL GENERAL UNRESTR,"Subject: GeneralPage
Transaction ID: 61917329PC2791013
https://www.paypal.com/activity/payment/61917329PC2791013",PayPal Bank 3,--,$33.29 ,"$930,006.65 "
Donations directed by individuals,9/23/23,Deposit,61917329PC2791013,04 PAYPAL GENERAL UNRESTR,Support Ukraine - Support Ukraine,Contributed income:Donations directed by individuals,PayPal Bank 3,$35.00 ,"$930,041.65 "
PayPal Fees,9/23/23,Deposit,61917329PC2791013,04 PAYPAL GENERAL UNRESTR,PayPal fees,OFFICE/GENERAL ADMINISTRATIVE EXPENSES:PayPal Fees,PayPal Bank 3,$1.71 ,"$930,043.36 "
PayPal Bank 3,9/23/23,Deposit,3S014363KB405321J,04 PAYPAL GENERAL UNRESTR,"Subject: Support Ukraine
Transaction ID: 3S014363KB405321J
https://www.paypal.com/activity/payment/3S014363KB405321J",PayPal Bank 3,--,$9.16 ,"$930,052.52 "
Donations directed by individuals,9/23/23,Deposit,3S014363KB405321J,04 PAYPAL GENERAL UNRESTR,Money in to PayPal,Contributed income:Donations directed by individuals,PayPal Bank 3,$10.00 ,"$930,062.52 "
PayPal Fees,9/23/23,Deposit,3S014363KB405321J,04 PAYPAL GENERAL UNRESTR,PayPal fees,OFFICE/GENERAL ADMINISTRATIVE EXPENSES:PayPal Fees,PayPal Bank 3,$0.84 ,"$930,063.36 "
PayPal Bank 3,9/23/23,Deposit,12V23331W25909314,04 PAYPAL GENERAL UNRESTR,"Subject: Support Ukraine
Transaction ID: 12V23331W25909314
https://www.paypal.com/activity/payment/12V23331W25909314",PayPal Bank 3,--,$9.16 ,"$930,072.52 "
Donations directed by individuals,9/23/23,Deposit,12V23331W25909314,04 PAYPAL GENERAL UNRESTR,Money in to PayPal,Contributed income:Donations directed by individuals,PayPal Bank 3,$10.00 ,"$930,082.52 "
PayPal Fees,9/23/23,Deposit,12V23331W25909314,04 PAYPAL GENERAL UNRESTR,PayPal fees,OFFICE/GENERAL ADMINISTRATIVE EXPENSES:PayPal Fees,PayPal Bank 3,$0.84 ,"$930,083.36 "
PayPal Bank 3,9/23/23,Deposit,7HG12062YJ689072J,04 PAYPAL GENERAL UNRESTR,"Subject: Support Ukraine
Transaction ID: 7HG12062YJ689072J
https://www.paypal.com/activity/payment/7HG12062YJ689072J",PayPal Bank 3,--,$70.08 ,"$930,153.44 "
Donations directed by individuals,9/23/23,Deposit,7HG12062YJ689072J,04 PAYPAL GENERAL UNRESTR,Money in to PayPal,Contributed income:Donations directed by individuals,PayPal Bank 3,$72.00 ,"$930,225.44 "
PayPal Fees,9/23/23,Deposit,7HG12062YJ689072J,04 PAYPAL GENERAL UNRESTR,PayPal fees,OFFICE/GENERAL ADMINISTRATIVE EXPENSES:PayPal Fees,PayPal Bank 3,$1.92 ,"$930,227.36 "
PayPal Bank 3,9/23/23,Deposit,7NX273243G961310U,07 1000 DRONES RESTR,"Subject: 1000DRONES
Transaction ID: 7NX273243G961310U
https://www.paypal.com/activity/payment/7NX273243G961310U",PayPal Bank 3,--,$50.00 ,"$930,277.36 "
Donations directed by individuals,9/23/23,Deposit,7NX273243G961310U,07 1000 DRONES RESTR,1000 DRONES FOR UKRAINE - 1000 DRONES FOR UKRAINE,Contributed income:Donations directed by individuals,PayPal Bank 3,$51.52 ,"$930,328.88 "
PayPal Fees,9/23/23,Deposit,7NX273243G961310U,07 1000 DRONES RESTR,PayPal fees,OFFICE/GENERAL ADMINISTRATIVE EXPENSES:PayPal Fees,PayPal Bank 3,$1.52 ,"$930,330.40 "
PayPal Bank 3,9/23/23,Deposit,1WH08163T02032328,04 PAYPAL GENERAL UNRESTR,"Subject: GeneralPage
Transaction ID: 1WH08163T02032328
https://www.paypal.com/activity/payment/1WH08163T02032328",PayPal Bank 3,--,$98.46 ,"$930,428.86 "
Donations directed by individuals,9/23/23,Deposit,1WH08163T02032328,04 PAYPAL GENERAL UNRESTR,Support Ukraine - Support Ukraine,Contributed income:Donations directed by individuals,PayPal Bank 3,$102.53 ,"$930,531.39 "
PayPal Fees,9/23/23,Deposit,1WH08163T02032328,04 PAYPAL GENERAL UNRESTR,PayPal fees,OFFICE/GENERAL ADMINISTRATIVE EXPENSES:PayPal Fees,PayPal Bank 3,$4.07 ,"$930,535.46 "
PayPal Bank 3,9/23/23,Deposit,4J582708UY6395935,04 PAYPAL GENERAL UNRESTR,"Subject: GeneralPage
Transaction ID: 4J582708UY6395935
https://www.paypal.com/activity/payment/4J582708UY6395935",PayPal Bank 3,--,$14.76 ,"$930,550.22 "
Donations directed by individuals,9/23/23,Deposit,4J582708UY6395935,04 PAYPAL GENERAL UNRESTR,Support Ukraine - Support Ukraine,Contributed income:Donations directed by individuals,PayPal Bank 3,$15.80 ,"$930,566.02 "
PayPal Fees,9/23/23,Deposit,4J582708UY6395935,04 PAYPAL GENERAL UNRESTR,PayPal fees,OFFICE/GENERAL ADMINISTRATIVE EXPENSES:PayPal Fees,PayPal Bank 3,$1.04 ,"$930,567.06 "
PayPal Bank 3,9/23/23,Deposit,1H9309582T195293W,04 PAYPAL GENERAL UNRESTR,"Subject: GeneralPage
Transaction ID: 1H9309582T195293W
https://www.paypal.com/activity/payment/1H9309582T195293W",PayPal Bank 3,--,$13.99 ,"$930,581.05 "
Donations directed by individuals,9/23/23,Deposit,1H9309582T195293W,04 PAYPAL GENERAL UNRESTR,Support Ukraine - Support Ukraine,Contributed income:Donations directed by individuals,PayPal Bank 3,$15.00 ,"$930,596.05 "
PayPal Fees,9/23/23,Deposit,1H9309582T195293W,04 PAYPAL GENERAL UNRESTR,PayPal fees,OFFICE/GENERAL ADMINISTRATIVE EXPENSES:PayPal Fees,PayPal Bank 3,$1.01 ,"$930,597.06 "
PayPal Bank 3,9/23/23,Deposit,2VA91517Y7736632M,04 PAYPAL GENERAL UNRESTR,"Subject: GeneralPage
Transaction ID: 2VA91517Y7736632M
https://www.paypal.com/activity/payment/2VA91517Y7736632M",PayPal Bank 3,--,$19.69 ,"$930,616.75 "
Donations directed by individuals,9/23/23,Deposit,2VA91517Y7736632M,04 PAYPAL GENERAL UNRESTR,Support Ukraine - Support Ukraine,Contributed income:Donations directed by individuals,PayPal Bank 3,$20.91 ,"$930,637.66 "
PayPal Fees,9/23/23,Deposit,2VA91517Y7736632M,04 PAYPAL GENERAL UNRESTR,PayPal fees,OFFICE/GENERAL ADMINISTRATIVE EXPENSES:PayPal Fees,PayPal Bank 3,$1.22 ,"$930,638.88 "
PayPal Bank 3,9/23/23,Deposit,79868079J1552083V,07 1000 DRONES RESTR,"Subject: 1000DRONES
Transaction ID: 79868079J1552083V
https://www.paypal.com/activity/payment/79868079J1552083V",PayPal Bank 3,--,$13.99 ,"$930,652.87 "
Donations directed by individuals,9/23/23,Deposit,79868079J1552083V,07 1000 DRONES RESTR,1000 DRONES FOR UKRAINE - 1000 DRONES FOR UKRAINE,Contributed income:Donations directed by individuals,PayPal Bank 3,$15.00 ,"$930,667.87 "
PayPal Fees,9/23/23,Deposit,79868079J1552083V,07 1000 DRONES RESTR,PayPal fees,OFFICE/GENERAL ADMINISTRATIVE EXPENSES:PayPal Fees,PayPal Bank 3,$1.01 ,"$930,668.88 "
PayPal Bank 3,9/23/23,Deposit,7KN82143DM7337318,08 VICTORY DRONES RESTR,"Subject: VictoryDrones
Note: Mon cœur saigne pour l'Ukraine et ses enfants
Transaction ID: 7KN82143DM7337318
https://www.paypal.com/activity/payment/7KN82143DM7337318",PayPal Bank 3,--,$49.23 ,"$930,718.11 "
Donations directed by individuals,9/23/23,Deposit,7KN82143DM7337318,08 VICTORY DRONES RESTR,VICTORY DRONES - VICTORY DRONES,Contributed income:Donations directed by individuals,PayPal Bank 3,$51.52 ,"$930,769.63 "
PayPal Fees,9/23/23,Deposit,7KN82143DM7337318,08 VICTORY DRONES RESTR,PayPal fees,OFFICE/GENERAL ADMINISTRATIVE EXPENSES:PayPal Fees,PayPal Bank 3,$2.29 ,"$930,771.92 "
PayPal Bank 3,9/23/23,Deposit,46859611XW0374221,08 VICTORY DRONES RESTR,"Subject: GeneralPage
Note: For Victory drones
Transaction ID: 46859611XW0374221
https://www.paypal.com/activity/payment/46859611XW0374221",PayPal Bank 3,--,$98.46 ,"$930,870.38 "
Donations directed by individuals,9/23/23,Deposit,46859611XW0374221,08 VICTORY DRONES RESTR,Support Ukraine - Support Ukraine,Contributed income:Donations directed by individuals,PayPal Bank 3,$102.53 ,"$930,972.91 "
PayPal Fees,9/23/23,Deposit,46859611XW0374221,08 VICTORY DRONES RESTR,PayPal fees,OFFICE/GENERAL ADMINISTRATIVE EXPENSES:PayPal Fees,PayPal Bank 3,$4.07 ,"$930,976.98 "
PayPal Bank 3,9/23/23,Deposit,58N9109608977802L,04 PAYPAL GENERAL UNRESTR,"Subject: Support Ukraine
Transaction ID: 58N9109608977802L
https://www.paypal.com/activity/payment/58N9109608977802L",PayPal Bank 3,--,$23.63 ,"$931,000.61 "
Donations directed by individuals,9/23/23,Deposit,58N9109608977802L,04 PAYPAL GENERAL UNRESTR,Money in to PayPal,Contributed income:Donations directed by individuals,PayPal Bank 3,$24.99 ,"$931,025.60 "
PayPal Fees,9/23/23,Deposit,58N9109608977802L,04 PAYPAL GENERAL UNRESTR,PayPal fees,OFFICE/GENERAL ADMINISTRATIVE EXPENSES:PayPal Fees,PayPal Bank 3,$1.36 ,"$931,026.96 "
PayPal Bank 3,9/23/23,Deposit,1E7087339M483122S,04 PAYPAL GENERAL UNRESTR,"Subject: Support Ukraine
Transaction ID: 1E7087339M483122S
https://www.paypal.com/activity/payment/1E7087339M483122S",PayPal Bank 3,--,$50.47 ,"$931,077.43 "
Donations directed by individuals,9/23/23,Deposit,1E7087339M483122S,04 PAYPAL GENERAL UNRESTR,Money in to PayPal,Contributed income:Donations directed by individuals,PayPal Bank 3,$51.99 ,"$931,129.42 "
PayPal Fees,9/23/23,Deposit,1E7087339M483122S,04 PAYPAL GENERAL UNRESTR,PayPal fees,OFFICE/GENERAL ADMINISTRATIVE EXPENSES:PayPal Fees,PayPal Bank 3,$1.52 ,"$931,130.94 "
PayPal Bank 3,9/23/23,Deposit,3PM027124H5809403,04 PAYPAL GENERAL UNRESTR,"Subject: Support Ukraine
Transaction ID: 3PM027124H5809403
https://www.paypal.com/activity/payment/3PM027124H5809403",PayPal Bank 3,--,$24.84 ,"$931,155.78 "
Donations directed by individuals,9/23/23,Deposit,3PM027124H5809403,04 PAYPAL GENERAL UNRESTR,Money in to PayPal,Contributed income:Donations directed by individuals,PayPal Bank 3,$26.25 ,"$931,182.03 "
PayPal Fees,9/23/23,Deposit,3PM027124H5809403,04 PAYPAL GENERAL UNRESTR,PayPal fees,OFFICE/GENERAL ADMINISTRATIVE EXPENSES:PayPal Fees,PayPal Bank 3,$1.41 ,"$931,183.44 "
PayPal Bank 3,9/23/23,Deposit,1J663185AF925474U,04 PAYPAL GENERAL UNRESTR,"Subject: GeneralPage
Transaction ID: 1J663185AF925474U
https://www.paypal.com/activity/payment/1J663185AF925474U",PayPal Bank 3,--,$50.00 ,"$931,233.44 "
Donations directed by individuals,9/23/23,Deposit,1J663185AF925474U,04 PAYPAL GENERAL UNRESTR,Support Ukraine - Support Ukraine,Contributed income:Donations directed by individuals,PayPal Bank 3,$51.52 ,"$931,284.96 "
PayPal Fees,9/23/23,Deposit,1J663185AF925474U,04 PAYPAL GENERAL UNRESTR,PayPal fees,OFFICE/GENERAL ADMINISTRATIVE EXPENSES:PayPal Fees,PayPal Bank 3,$1.52 ,"$931,286.48 "
PayPal Bank 3,9/23/23,Deposit,6LA55917HM237133U,08 VICTORY DRONES RESTR,"Subject: VictoryDrones
Transaction ID: 6LA55917HM237133U
https://www.paypal.com/activity/payment/6LA55917HM237133U",PayPal Bank 3,--,$19.69 ,"$931,306.17 "
Donations directed by individuals,9/23/23,Deposit,6LA55917HM237133U,08 VICTORY DRONES RESTR,VICTORY DRONES - VICTORY DRONES,Contributed income:Donations directed by individuals,PayPal Bank 3,$20.91 ,"$931,327.08 "
PayPal Fees,9/23/23,Deposit,6LA55917HM237133U,08 VICTORY DRONES RESTR,PayPal fees,OFFICE/GENERAL ADMINISTRATIVE EXPENSES:PayPal Fees,PayPal Bank 3,$1.22 ,"$931,328.30 "
PayPal Bank 3,9/23/23,Deposit,8X691922F2159121A,04 PAYPAL GENERAL UNRESTR,"Subject: GeneralPage
Transaction ID: 8X691922F2159121A
https://www.paypal.com/activity/payment/8X691922F2159121A",PayPal Bank 3,--,$28.46 ,"$931,356.76 "
Donations directed by individuals,9/23/23,Deposit,8X691922F2159121A,04 PAYPAL GENERAL UNRESTR,Support Ukraine - Support Ukraine,Contributed income:Donations directed by individuals,PayPal Bank 3,$30.00 ,"$931,386.76 "
PayPal Fees,9/23/23,Deposit,8X691922F2159121A,04 PAYPAL GENERAL UNRESTR,PayPal fees,OFFICE/GENERAL ADMINISTRATIVE EXPENSES:PayPal Fees,PayPal Bank 3,$1.54 ,"$931,388.30 "
PayPal Bank 3,9/23/23,Deposit,0L6491910N057512B,07 1000 DRONES RESTR,"Subject: 1000DRONES
Transaction ID: 0L6491910N057512B
https://www.paypal.com/activity/payment/0L6491910N057512B",PayPal Bank 3,--,$350.00 ,"$931,738.30 "
Donations directed by individuals,9/23/23,Deposit,0L6491910N057512B,07 1000 DRONES RESTR,1000 DRONES FOR UKRAINE - 1000 DRONES FOR UKRAINE,Contributed income:Donations directed by individuals,PayPal Bank 3,$357.61 ,"$932,095.91 "
PayPal Fees,9/23/23,Deposit,0L6491910N057512B,07 1000 DRONES RESTR,PayPal fees,OFFICE/GENERAL ADMINISTRATIVE EXPENSES:PayPal Fees,PayPal Bank 3,$7.61 ,"$932,103.52 "
PayPal Bank 3,9/23/23,Deposit,5M582547J8243941X,04 PAYPAL GENERAL UNRESTR,"Subject: Support Ukraine
Transaction ID: 5M582547J8243941X
https://www.paypal.com/activity/payment/5M582547J8243941X",PayPal Bank 3,--,$298.14 ,"$932,401.66 "
Donations directed by individuals,9/23/23,Deposit,5M582547J8243941X,04 PAYPAL GENERAL UNRESTR,Money in to PayPal,Contributed income:Donations directed by individuals,PayPal Bank 3,$309.43 ,"$932,711.09 "
PayPal Fees,9/23/23,Deposit,5M582547J8243941X,04 PAYPAL GENERAL UNRESTR,PayPal fees,OFFICE/GENERAL ADMINISTRATIVE EXPENSES:PayPal Fees,PayPal Bank 3,$11.29 ,"$932,722.38 "
PayPal Bank 3,9/23/23,Deposit,90C54420CK002871N,08 VICTORY DRONES RESTR,"Subject: VICTORY DRONES
Transaction ID: 90C54420CK002871N
https://www.paypal.com/activity/payment/90C54420CK002871N",PayPal Bank 3,--,$2.97 ,"$932,725.35 "
Donations directed by individuals,9/23/23,Deposit,90C54420CK002871N,08 VICTORY DRONES RESTR,Money in to PayPal,Contributed income:Donations directed by individuals,PayPal Bank 3,$3.59 ,"$932,728.94 "
PayPal Fees,9/23/23,Deposit,90C54420CK002871N,08 VICTORY DRONES RESTR,PayPal fees,OFFICE/GENERAL ADMINISTRATIVE EXPENSES:PayPal Fees,PayPal Bank 3,$0.62 ,"$932,729.56 "
PayPal Bank 3,9/23/23,Deposit,11620412WD586600A,07 1000 DRONES RESTR,"Subject: 1000DRONES
Transaction ID: 11620412WD586600A
https://www.paypal.com/activity/payment/11620412WD586600A",PayPal Bank 3,--,$76.72 ,"$932,806.28 "
Donations directed by individuals,9/23/23,Deposit,11620412WD586600A,07 1000 DRONES RESTR,1000 DRONES FOR UKRAINE - 1000 DRONES FOR UKRAINE,Contributed income:Donations directed by individuals,PayPal Bank 3,$80.00 ,"$932,886.28 "
PayPal Fees,9/23/23,Deposit,11620412WD586600A,07 1000 DRONES RESTR,PayPal fees,OFFICE/GENERAL ADMINISTRATIVE EXPENSES:PayPal Fees,PayPal Bank 3,$3.28 ,"$932,889.56 "
PayPal Bank 3,9/23/23,Deposit,1CG25991JH2526544,07 1000 DRONES RESTR,"Subject: 1000DRONES
Transaction ID: 1CG25991JH2526544
https://www.paypal.com/activity/payment/1CG25991JH2526544",PayPal Bank 3,--,$33.29 ,"$932,922.85 "
Donations directed by individuals,9/23/23,Deposit,1CG25991JH2526544,07 1000 DRONES RESTR,1000 DRONES FOR UKRAINE - 1000 DRONES FOR UKRAINE,Contributed income:Donations directed by individuals,PayPal Bank 3,$35.00 ,"$932,957.85 "
PayPal Fees,9/23/23,Deposit,1CG25991JH2526544,07 1000 DRONES RESTR,PayPal fees,OFFICE/GENERAL ADMINISTRATIVE EXPENSES:PayPal Fees,PayPal Bank 3,$1.71 ,"$932,959.56 "
PayPal Bank 3,9/23/23,Deposit,4K044405KJ9262848,04 PAYPAL GENERAL UNRESTR,"Subject: GeneralPage
Transaction ID: 4K044405KJ9262848
https://www.paypal.com/activity/payment/4K044405KJ9262848",PayPal Bank 3,--,$196.93 ,"$933,156.49 "
Donations directed by individuals,9/23/23,Deposit,4K044405KJ9262848,04 PAYPAL GENERAL UNRESTR,Support Ukraine - Support Ukraine,Contributed income:Donations directed by individuals,PayPal Bank 3,$204.56 ,"$933,361.05 "
PayPal Fees,9/23/23,Deposit,4K044405KJ9262848,04 PAYPAL GENERAL UNRESTR,PayPal fees,OFFICE/GENERAL ADMINISTRATIVE EXPENSES:PayPal Fees,PayPal Bank 3,$7.63 ,"$933,368.68 "
PayPal Bank 3,9/22/23,Deposit,0HV42330874359326,04 PAYPAL GENERAL UNRESTR,"Transaction ID: 0HV42330874359326
https://www.paypal.com/activity/payment/0HV42330874359326",PayPal Bank 3,Donations directed by individuals,$1.00 ,"$933,369.68 "
Donations directed by individuals,9/22/23,Deposit,0HV42330874359326,04 PAYPAL GENERAL UNRESTR,Money in to PayPal,Contributed income:Donations directed by individuals,PayPal Bank 3,$1.00 ,"$933,370.68 "
PayPal Bank 3,9/22/23,Deposit,0AA89879UC6834253,04 PAYPAL GENERAL UNRESTR,"Transaction ID: 0AA89879UC6834253
https://www.paypal.com/activity/payment/0AA89879UC6834253",PayPal Bank 3,--,$0.97 ,"$933,371.65 "
Donations directed by individuals,9/22/23,Deposit,0AA89879UC6834253,04 PAYPAL GENERAL UNRESTR,Money in to PayPal,Contributed income:Donations directed by individuals,PayPal Bank 3,$1.00 ,"$933,372.65 "
PayPal Fees,9/22/23,Deposit,0AA89879UC6834253,04 PAYPAL GENERAL UNRESTR,PayPal fees,OFFICE/GENERAL ADMINISTRATIVE EXPENSES:PayPal Fees,PayPal Bank 3,$0.03 ,"$933,372.68 "
PayPal Bank 3,9/22/23,Deposit,4P401955JK890434L,04 PAYPAL GENERAL UNRESTR,"Note: Charitable donation
Transaction ID: 4P401955JK890434L
https://www.paypal.com/activity/payment/4P401955JK890434L",PayPal Bank 3,--,$1.46 ,"$933,374.14 "
Donations directed by individuals,9/22/23,Deposit,4P401955JK890434L,04 PAYPAL GENERAL UNRESTR,Money in to PayPal,Contributed income:Donations directed by individuals,PayPal Bank 3,$1.50 ,"$933,375.64 "
PayPal Fees,9/22/23,Deposit,4P401955JK890434L,04 PAYPAL GENERAL UNRESTR,PayPal fees,OFFICE/GENERAL ADMINISTRATIVE EXPENSES:PayPal Fees,PayPal Bank 3,$0.04 ,"$933,375.68 "
PayPal Bank 3,9/22/23,Deposit,8WJ42244VJ270542F,04 PAYPAL GENERAL UNRESTR,"Transaction ID: 8WJ42244VJ270542F
https://www.paypal.com/activity/payment/8WJ42244VJ270542F",PayPal Bank 3,--,$0.72 ,"$933,376.40 "
Donations directed by individuals,9/22/23,Deposit,8WJ42244VJ270542F,04 PAYPAL GENERAL UNRESTR,Support Ukraine - Support Ukraine,Contributed income:Donations directed by individuals,PayPal Bank 3,$1.25 ,"$933,377.65 "
PayPal Fees,9/22/23,Deposit,8WJ42244VJ270542F,04 PAYPAL GENERAL UNRESTR,PayPal fees,OFFICE/GENERAL ADMINISTRATIVE EXPENSES:PayPal Fees,PayPal Bank 3,$0.53 ,"$933,378.18 "
PayPal Bank 3,9/22/23,Deposit,6RJ52649XP8481323,07 1000 DRONES RESTR,"Subject: 1000DRONES
Transaction ID: 6RJ52649XP8481323
https://www.paypal.com/activity/payment/6RJ52649XP8481323",PayPal Bank 3,--,$4.37 ,"$933,382.55 "
Donations directed by individuals,9/22/23,Deposit,6RJ52649XP8481323,07 1000 DRONES RESTR,1000 DRONES FOR UKRAINE - 1000 DRONES FOR UKRAINE,Contributed income:Donations directed by individuals,PayPal Bank 3,$5.00 ,"$933,387.55 "
PayPal Fees,9/22/23,Deposit,6RJ52649XP8481323,07 1000 DRONES RESTR,PayPal fees,OFFICE/GENERAL ADMINISTRATIVE EXPENSES:PayPal Fees,PayPal Bank 3,$0.63 ,"$933,388.18 "
PayPal Bank 3,9/22/23,Deposit,2EF777993G965104E,07 1000 DRONES RESTR,"Transaction ID: 2EF777993G965104E
https://www.paypal.com/activity/payment/2EF777993G965104E",PayPal Bank 3,--,$1.45 ,"$933,389.63 "
Donations directed by individuals,9/22/23,Deposit,2EF777993G965104E,07 1000 DRONES RESTR,1000 DRONES FOR UKRAINE - 1000 DRONES FOR UKRAINE,Contributed income:Donations directed by individuals,PayPal Bank 3,$2.00 ,"$933,391.63 "
PayPal Fees,9/22/23,Deposit,2EF777993G965104E,07 1000 DRONES RESTR,PayPal fees,OFFICE/GENERAL ADMINISTRATIVE EXPENSES:PayPal Fees,PayPal Bank 3,$0.55 ,"$933,392.18 "
PayPal Bank 3,9/22/23,Deposit,2RF49709GG496905S,07 1000 DRONES RESTR,"Subject: custom
Transaction ID: 2RF49709GG496905S
https://www.paypal.com/activity/payment/2RF49709GG496905S",PayPal Bank 3,--,$2.42 ,"$933,394.60 "
Donations directed by individuals,9/22/23,Deposit,2RF49709GG496905S,07 1000 DRONES RESTR,1000 DRONES FOR UKRAINE - 1000 DRONES FOR UKRAINE,Contributed income:Donations directed by individuals,PayPal Bank 3,$3.00 ,"$933,397.60 "
PayPal Fees,9/22/23,Deposit,2RF49709GG496905S,07 1000 DRONES RESTR,PayPal fees,OFFICE/GENERAL ADMINISTRATIVE EXPENSES:PayPal Fees,PayPal Bank 3,$0.58 ,"$933,398.18 "
PayPal Bank 3,9/22/23,Deposit,4FF159007F788522X,04 PAYPAL GENERAL UNRESTR,"Note: test2
Transaction ID: 4FF159007F788522X
https://www.paypal.com/activity/payment/4FF159007F788522X",PayPal Bank 3,--,$3.39 ,"$933,401.57 "
Donations directed by individuals,9/22/23,Deposit,4FF159007F788522X,04 PAYPAL GENERAL UNRESTR,Support Ukraine - Support Ukraine,Contributed income:Donations directed by individuals,PayPal Bank 3,$4.00 ,"$933,405.57 "
PayPal Fees,9/22/23,Deposit,4FF159007F788522X,04 PAYPAL GENERAL UNRESTR,PayPal fees,OFFICE/GENERAL ADMINISTRATIVE EXPENSES:PayPal Fees,PayPal Bank 3,$0.61 ,"$933,406.18 "
PayPal Bank 3,9/22/23,Deposit,66F19293T9603492H,04 PAYPAL GENERAL UNRESTR,"Subject: GeneralPage
Transaction ID: 66F19293T9603492H
https://www.paypal.com/activity/payment/66F19293T9603492H",PayPal Bank 3,--,$1.94 ,"$933,408.12 "
Donations directed by individuals,9/22/23,Deposit,66F19293T9603492H,04 PAYPAL GENERAL UNRESTR,Support Ukraine - Support Ukraine,Contributed income:Donations directed by individuals,PayPal Bank 3,$2.50 ,"$933,410.62 "
PayPal Fees,9/22/23,Deposit,66F19293T9603492H,04 PAYPAL GENERAL UNRESTR,PayPal fees,OFFICE/GENERAL ADMINISTRATIVE EXPENSES:PayPal Fees,PayPal Bank 3,$0.56 ,"$933,411.18 "
PayPal Bank 3,9/22/23,Deposit,9FH91472TG424470X,09 MSU RESTR,"Subject: MobileShowers
Transaction ID: 9FH91472TG424470X
https://www.paypal.com/activity/payment/9FH91472TG424470X",PayPal Bank 3,--,$2.91 ,"$933,414.09 "
Donations directed by individuals,9/22/23,Deposit,9FH91472TG424470X,09 MSU RESTR,Mobile Shower Unit - Mobile Shower Unit,Contributed income:Donations directed by individuals,PayPal Bank 3,$3.50 ,"$933,417.59 "
PayPal Fees,9/22/23,Deposit,9FH91472TG424470X,09 MSU RESTR,PayPal fees,OFFICE/GENERAL ADMINISTRATIVE EXPENSES:PayPal Fees,PayPal Bank 3,$0.59 ,"$933,418.18 "
PayPal Bank 3,9/22/23,Deposit,0JM97106YK418792H,04 PAYPAL GENERAL UNRESTR,"Subject: GeneralPage
Transaction ID: 0JM97106YK418792H
https://www.paypal.com/activity/payment/0JM97106YK418792H",PayPal Bank 3,--,$47.31 ,"$933,465.49 "
Donations directed by individuals,9/22/23,Deposit,0JM97106YK418792H,04 PAYPAL GENERAL UNRESTR,Support Ukraine - Support Ukraine,Contributed income:Donations directed by individuals,PayPal Bank 3,$50.00 ,"$933,515.49 "
PayPal Fees,9/22/23,Deposit,0JM97106YK418792H,04 PAYPAL GENERAL UNRESTR,PayPal fees,OFFICE/GENERAL ADMINISTRATIVE EXPENSES:PayPal Fees,PayPal Bank 3,$2.69 ,"$933,518.18 "
PayPal Bank 3,9/22/23,Deposit,44U07303Y8553993T,04 PAYPAL GENERAL UNRESTR,"Subject: GeneralPage
Transaction ID: 44U07303Y8553993T
https://www.paypal.com/activity/payment/44U07303Y8553993T",PayPal Bank 3,--,$50.00 ,"$933,568.18 "
Donations directed by individuals,9/22/23,Deposit,44U07303Y8553993T,04 PAYPAL GENERAL UNRESTR,Support Ukraine - Support Ukraine,Contributed income:Donations directed by individuals,PayPal Bank 3,$51.99 ,"$933,620.17 "
PayPal Fees,9/22/23,Deposit,44U07303Y8553993T,04 PAYPAL GENERAL UNRESTR,PayPal fees,OFFICE/GENERAL ADMINISTRATIVE EXPENSES:PayPal Fees,PayPal Bank 3,$1.99 ,"$933,622.16 "
PayPal Bank 3,9/22/23,Deposit,7NS60564MJ2446452,04 PAYPAL GENERAL UNRESTR,"Subject: GeneralPage
Transaction ID: 7NS60564MJ2446452
https://www.paypal.com/activity/payment/7NS60564MJ2446452",PayPal Bank 3,--,$19.68 ,"$933,641.84 "
Donations directed by individuals,9/22/23,Deposit,7NS60564MJ2446452,04 PAYPAL GENERAL UNRESTR,Support Ukraine - Support Ukraine,Contributed income:Donations directed by individuals,PayPal Bank 3,$21.10 ,"$933,662.94 "
PayPal Fees,9/22/23,Deposit,7NS60564MJ2446452,04 PAYPAL GENERAL UNRESTR,PayPal fees,OFFICE/GENERAL ADMINISTRATIVE EXPENSES:PayPal Fees,PayPal Bank 3,$1.42 ,"$933,664.36 "
PayPal Bank 3,9/22/23,Deposit,7SY36505W01215518,04 PAYPAL GENERAL UNRESTR,"Subject: GeneralPage
Note: Люті Пташки
Transaction ID: 7SY36505W01215518
https://www.paypal.com/activity/payment/7SY36505W01215518",PayPal Bank 3,--,$4.91 ,"$933,669.27 "
Donations directed by individuals,9/22/23,Deposit,7SY36505W01215518,04 PAYPAL GENERAL UNRESTR,Support Ukraine - Support Ukraine,Contributed income:Donations directed by individuals,PayPal Bank 3,$5.65 ,"$933,674.92 "
PayPal Fees,9/22/23,Deposit,7SY36505W01215518,04 PAYPAL GENERAL UNRESTR,PayPal fees,OFFICE/GENERAL ADMINISTRATIVE EXPENSES:PayPal Fees,PayPal Bank 3,$0.74 ,"$933,675.66 "
PayPal Bank 3,9/22/23,Deposit,84T83713CJ921330V,04 PAYPAL GENERAL UNRESTR,"Subject: GeneralPage
Note: Пташки.
Transaction ID: 84T83713CJ921330V
https://www.paypal.com/activity/payment/84T83713CJ921330V",PayPal Bank 3,--,$19.10 ,"$933,694.76 "
Donations directed by individuals,9/22/23,Deposit,84T83713CJ921330V,04 PAYPAL GENERAL UNRESTR,Support Ukraine - Support Ukraine,Contributed income:Donations directed by individuals,PayPal Bank 3,$20.17 ,"$933,714.93 "
PayPal Fees,9/22/23,Deposit,84T83713CJ921330V,04 PAYPAL GENERAL UNRESTR,PayPal fees,OFFICE/GENERAL ADMINISTRATIVE EXPENSES:PayPal Fees,PayPal Bank 3,$1.07 ,"$933,716.00 "
PayPal Bank 3,9/22/23,Deposit,7KR60090A6224784J,04 PAYPAL GENERAL UNRESTR,"Subject: GeneralPage
Transaction ID: 7KR60090A6224784J
https://www.paypal.com/activity/payment/7KR60090A6224784J",PayPal Bank 3,--,$18.63 ,"$933,734.63 "
Donations directed by individuals,9/22/23,Deposit,7KR60090A6224784J,04 PAYPAL GENERAL UNRESTR,Support Ukraine - Support Ukraine,Contributed income:Donations directed by individuals,PayPal Bank 3,$20.00 ,"$933,754.63 "
PayPal Fees,9/22/23,Deposit,7KR60090A6224784J,04 PAYPAL GENERAL UNRESTR,PayPal fees,OFFICE/GENERAL ADMINISTRATIVE EXPENSES:PayPal Fees,PayPal Bank 3,$1.37 ,"$933,756.00 "
PayPal Bank 3,9/22/23,Deposit,14E94277XH613253K,04 PAYPAL GENERAL UNRESTR,"Subject: GeneralPage
Transaction ID: 14E94277XH613253K
https://www.paypal.com/activity/payment/14E94277XH613253K",PayPal Bank 3,--,$19.68 ,"$933,775.68 "
Donations directed by individuals,9/22/23,Deposit,14E94277XH613253K,04 PAYPAL GENERAL UNRESTR,Support Ukraine - Support Ukraine,Contributed income:Donations directed by individuals,PayPal Bank 3,$21.10 ,"$933,796.78 "
PayPal Fees,9/22/23,Deposit,14E94277XH613253K,04 PAYPAL GENERAL UNRESTR,PayPal fees,OFFICE/GENERAL ADMINISTRATIVE EXPENSES:PayPal Fees,PayPal Bank 3,$1.42 ,"$933,798.20 "
PayPal Bank 3,9/22/23,Deposit,8H861756N83160718,04 PAYPAL GENERAL UNRESTR,"Subject: GeneralPage
Transaction ID: 8H861756N83160718
https://www.paypal.com/activity/payment/8H861756N83160718",PayPal Bank 3,--,$48.06 ,"$933,846.26 "
Donations directed by individuals,9/22/23,Deposit,8H861756N83160718,04 PAYPAL GENERAL UNRESTR,Support Ukraine - Support Ukraine,Contributed income:Donations directed by individuals,PayPal Bank 3,$50.00 ,"$933,896.26 "
PayPal Fees,9/22/23,Deposit,8H861756N83160718,04 PAYPAL GENERAL UNRESTR,PayPal fees,OFFICE/GENERAL ADMINISTRATIVE EXPENSES:PayPal Fees,PayPal Bank 3,$1.94 ,"$933,898.20 "
PayPal Bank 3,9/22/23,Deposit,53K30129G6093241W,04 PAYPAL GENERAL UNRESTR,"Subject: GeneralPage
Transaction ID: 53K30129G6093241W
https://www.paypal.com/activity/payment/53K30129G6093241W",PayPal Bank 3,--,$35.00 ,"$933,933.20 "
Donations directed by individuals,9/22/23,Deposit,53K30129G6093241W,04 PAYPAL GENERAL UNRESTR,Support Ukraine - Support Ukraine,Contributed income:Donations directed by individuals,PayPal Bank 3,$36.55 ,"$933,969.75 "
PayPal Fees,9/22/23,Deposit,53K30129G6093241W,04 PAYPAL GENERAL UNRESTR,PayPal fees,OFFICE/GENERAL ADMINISTRATIVE EXPENSES:PayPal Fees,PayPal Bank 3,$1.55 ,"$933,971.30 "
PayPal Bank 3,9/22/23,Deposit,50560152XS4838256,04 PAYPAL GENERAL UNRESTR,"Subject: Support Ukraine
Transaction ID: 50560152XS4838256
https://www.paypal.com/activity/payment/50560152XS4838256",PayPal Bank 3,--,$20.75 ,"$933,992.05 "
Donations directed by individuals,9/22/23,Deposit,50560152XS4838256,04 PAYPAL GENERAL UNRESTR,Money in to PayPal,Contributed income:Donations directed by individuals,PayPal Bank 3,$22.22 ,"$934,014.27 "
PayPal Fees,9/22/23,Deposit,50560152XS4838256,04 PAYPAL GENERAL UNRESTR,PayPal fees,OFFICE/GENERAL ADMINISTRATIVE EXPENSES:PayPal Fees,PayPal Bank 3,$1.47 ,"$934,015.74 "
PayPal Bank 3,9/22/23,Deposit,0L767735Y6221111F,04 PAYPAL GENERAL UNRESTR,"Subject: GeneralPage
Transaction ID: 0L767735Y6221111F
https://www.paypal.com/activity/payment/0L767735Y6221111F",PayPal Bank 3,--,$196.91 ,"$934,212.65 "
Donations directed by individuals,9/22/23,Deposit,0L767735Y6221111F,04 PAYPAL GENERAL UNRESTR,Support Ukraine - Support Ukraine,Contributed income:Donations directed by individuals,PayPal Bank 3,$206.46 ,"$934,419.11 "
PayPal Fees,9/22/23,Deposit,0L767735Y6221111F,04 PAYPAL GENERAL UNRESTR,PayPal fees,OFFICE/GENERAL ADMINISTRATIVE EXPENSES:PayPal Fees,PayPal Bank 3,$9.55 ,"$934,428.66 "
PayPal Bank 3,9/22/23,Deposit,8R219962PY374993X,04 PAYPAL GENERAL UNRESTR,"Subject: GeneralPage
Transaction ID: 8R219962PY374993X
https://www.paypal.com/activity/payment/8R219962PY374993X",PayPal Bank 3,--,$9.07 ,"$934,437.73 "
Donations directed by individuals,9/22/23,Deposit,8R219962PY374993X,04 PAYPAL GENERAL UNRESTR,Support Ukraine - Support Ukraine,Contributed income:Donations directed by individuals,PayPal Bank 3,$10.00 ,"$934,447.73 "
PayPal Fees,9/22/23,Deposit,8R219962PY374993X,04 PAYPAL GENERAL UNRESTR,PayPal fees,OFFICE/GENERAL ADMINISTRATIVE EXPENSES:PayPal Fees,PayPal Bank 3,$0.93 ,"$934,448.66 "
PayPal Bank 3,9/22/23,Deposit,1NC05142YH997404V,04 PAYPAL GENERAL UNRESTR,"Subject: GeneralPage
Transaction ID: 1NC05142YH997404V
https://www.paypal.com/activity/payment/1NC05142YH997404V",PayPal Bank 3,--,$9.38 ,"$934,458.04 "
Donations directed by individuals,9/22/23,Deposit,1NC05142YH997404V,04 PAYPAL GENERAL UNRESTR,Support Ukraine - Support Ukraine,Contributed income:Donations directed by individuals,PayPal Bank 3,$10.16 ,"$934,468.20 "
PayPal Fees,9/22/23,Deposit,1NC05142YH997404V,04 PAYPAL GENERAL UNRESTR,PayPal fees,OFFICE/GENERAL ADMINISTRATIVE EXPENSES:PayPal Fees,PayPal Bank 3,$0.78 ,"$934,468.98 "
PayPal Bank 3,9/22/23,Deposit,9R8007695J744380Y,07 1000 DRONES RESTR,"Subject: 1000DRONES
Transaction ID: 9R8007695J744380Y
https://www.paypal.com/activity/payment/9R8007695J744380Y",PayPal Bank 3,--,$200.00 ,"$934,668.98 "
Donations directed by individuals,9/22/23,Deposit,9R8007695J744380Y,07 1000 DRONES RESTR,1000 DRONES FOR UKRAINE - 1000 DRONES FOR UKRAINE,Contributed income:Donations directed by individuals,PayPal Bank 3,$206.46 ,"$934,875.44 "
PayPal Fees,9/22/23,Deposit,9R8007695J744380Y,07 1000 DRONES RESTR,PayPal fees,OFFICE/GENERAL ADMINISTRATIVE EXPENSES:PayPal Fees,PayPal Bank 3,$6.46 ,"$934,881.90 "
PayPal Bank 3,9/22/23,Deposit,512558065H042980K,04 PAYPAL GENERAL UNRESTR,"Subject: GeneralPage
Transaction ID: 512558065H042980K
https://www.paypal.com/activity/payment/512558065H042980K",PayPal Bank 3,--,$295.36 ,"$935,177.26 "
Donations directed by individuals,9/22/23,Deposit,512558065H042980K,04 PAYPAL GENERAL UNRESTR,Support Ukraine - Support Ukraine,Contributed income:Donations directed by individuals,PayPal Bank 3,$309.43 ,"$935,486.69 "
PayPal Fees,9/22/23,Deposit,512558065H042980K,04 PAYPAL GENERAL UNRESTR,PayPal fees,OFFICE/GENERAL ADMINISTRATIVE EXPENSES:PayPal Fees,PayPal Bank 3,$14.07 ,"$935,500.76 "
PayPal Bank 3,9/22/23,Deposit,9GM05354NJ928712F,07 1000 DRONES RESTR,"Subject: 1000DRONES
Transaction ID: 9GM05354NJ928712F
https://www.paypal.com/activity/payment/9GM05354NJ928712F",PayPal Bank 3,--,$150.00 ,"$935,650.76 "
Donations directed by individuals,9/22/23,Deposit,9GM05354NJ928712F,07 1000 DRONES RESTR,1000 DRONES FOR UKRAINE - 1000 DRONES FOR UKRAINE,Contributed income:Donations directed by individuals,PayPal Bank 3,$154.97 ,"$935,805.73 "
PayPal Fees,9/22/23,Deposit,9GM05354NJ928712F,07 1000 DRONES RESTR,PayPal fees,OFFICE/GENERAL ADMINISTRATIVE EXPENSES:PayPal Fees,PayPal Bank 3,$4.97 ,"$935,810.70 "
PayPal Bank 3,9/22/23,Deposit,98F33477MJ3619639,07 1000 DRONES RESTR,"Subject: 1000DRONES
Note: Летіть соколи!!! Знищіть усю наволоч з Неньки!!
Transaction ID: 98F33477MJ3619639
https://www.paypal.com/activity/payment/98F33477MJ3619639",PayPal Bank 3,--,$100.00 ,"$935,910.70 "
Donations directed by individuals,9/22/23,Deposit,98F33477MJ3619639,07 1000 DRONES RESTR,1000 DRONES FOR UKRAINE - 1000 DRONES FOR UKRAINE,Contributed income:Donations directed by individuals,PayPal Bank 3,$103.48 ,"$936,014.18 "
PayPal Fees,9/22/23,Deposit,98F33477MJ3619639,07 1000 DRONES RESTR,PayPal fees,OFFICE/GENERAL ADMINISTRATIVE EXPENSES:PayPal Fees,PayPal Bank 3,$3.48 ,"$936,017.66 "
PayPal Bank 3,9/22/23,Deposit,8LW55511PT859325M,04 PAYPAL GENERAL UNRESTR,"Subject: GeneralPage
Transaction ID: 8LW55511PT859325M
https://www.paypal.com/activity/payment/8LW55511PT859325M",PayPal Bank 3,--,$48.06 ,"$936,065.72 "
Donations directed by individuals,9/22/23,Deposit,8LW55511PT859325M,04 PAYPAL GENERAL UNRESTR,Support Ukraine - Support Ukraine,Contributed income:Donations directed by individuals,PayPal Bank 3,$50.00 ,"$936,115.72 "
PayPal Fees,9/22/23,Deposit,8LW55511PT859325M,04 PAYPAL GENERAL UNRESTR,PayPal fees,OFFICE/GENERAL ADMINISTRATIVE EXPENSES:PayPal Fees,PayPal Bank 3,$1.94 ,"$936,117.66 "
PayPal Bank 3,9/22/23,Deposit,3TW85559AF991533K,04 PAYPAL GENERAL UNRESTR,"Subject: GeneralPage
Transaction ID: 3TW85559AF991533K
https://www.paypal.com/activity/payment/3TW85559AF991533K",PayPal Bank 3,--,$9.07 ,"$936,126.73 "
Donations directed by individuals,9/22/23,Deposit,3TW85559AF991533K,04 PAYPAL GENERAL UNRESTR,Support Ukraine - Support Ukraine,Contributed income:Donations directed by individuals,PayPal Bank 3,$10.00 ,"$936,136.73 "
PayPal Fees,9/22/23,Deposit,3TW85559AF991533K,04 PAYPAL GENERAL UNRESTR,PayPal fees,OFFICE/GENERAL ADMINISTRATIVE EXPENSES:PayPal Fees,PayPal Bank 3,$0.93 ,"$936,137.66 "
PayPal Bank 3,9/22/23,Deposit,5XH604208A562253K,04 PAYPAL GENERAL UNRESTR,"Subject: GeneralPage
Transaction ID: 5XH604208A562253K
https://www.paypal.com/activity/payment/5XH604208A562253K",PayPal Bank 3,--,$24.61 ,"$936,162.27 "
Donations directed by individuals,9/22/23,Deposit,5XH604208A562253K,04 PAYPAL GENERAL UNRESTR,Support Ukraine - Support Ukraine,Contributed income:Donations directed by individuals,PayPal Bank 3,$26.25 ,"$936,188.52 "
PayPal Fees,9/22/23,Deposit,5XH604208A562253K,04 PAYPAL GENERAL UNRESTR,PayPal fees,OFFICE/GENERAL ADMINISTRATIVE EXPENSES:PayPal Fees,PayPal Bank 3,$1.64 ,"$936,190.16 "
PayPal Bank 3,9/22/23,Deposit,3GU950742M022670B,04 PAYPAL GENERAL UNRESTR,"Subject: GeneralPage
Transaction ID: 3GU950742M022670B
https://www.paypal.com/activity/payment/3GU950742M022670B",PayPal Bank 3,--,$18.63 ,"$936,208.79 "
Donations directed by individuals,9/22/23,Deposit,3GU950742M022670B,04 PAYPAL GENERAL UNRESTR,Support Ukraine - Support Ukraine,Contributed income:Donations directed by individuals,PayPal Bank 3,$20.00 ,"$936,228.79 "
PayPal Fees,9/22/23,Deposit,3GU950742M022670B,04 PAYPAL GENERAL UNRESTR,PayPal fees,OFFICE/GENERAL ADMINISTRATIVE EXPENSES:PayPal Fees,PayPal Bank 3,$1.37 ,"$936,230.16 "
PayPal Bank 3,9/22/23,Deposit,72774626JX7855846,04 PAYPAL GENERAL UNRESTR,"Subject: GeneralPage
Transaction ID: 72774626JX7855846
https://www.paypal.com/activity/payment/72774626JX7855846",PayPal Bank 3,--,$19.68 ,"$936,249.84 "
Donations directed by individuals,9/22/23,Deposit,72774626JX7855846,04 PAYPAL GENERAL UNRESTR,Support Ukraine - Support Ukraine,Contributed income:Donations directed by individuals,PayPal Bank 3,$21.10 ,"$936,270.94 "
PayPal Fees,9/22/23,Deposit,72774626JX7855846,04 PAYPAL GENERAL UNRESTR,PayPal fees,OFFICE/GENERAL ADMINISTRATIVE EXPENSES:PayPal Fees,PayPal Bank 3,$1.42 ,"$936,272.36 "
PayPal Bank 3,9/22/23,Deposit,82783001AN018073E,04 PAYPAL GENERAL UNRESTR,"Subject: GeneralPage
Transaction ID: 82783001AN018073E
https://www.paypal.com/activity/payment/82783001AN018073E",PayPal Bank 3,--,$4.91 ,"$936,277.27 "
Donations directed by individuals,9/22/23,Deposit,82783001AN018073E,04 PAYPAL GENERAL UNRESTR,Support Ukraine - Support Ukraine,Contributed income:Donations directed by individuals,PayPal Bank 3,$5.65 ,"$936,282.92 "
PayPal Fees,9/22/23,Deposit,82783001AN018073E,04 PAYPAL GENERAL UNRESTR,PayPal fees,OFFICE/GENERAL ADMINISTRATIVE EXPENSES:PayPal Fees,PayPal Bank 3,$0.74 ,"$936,283.66 "
PayPal Bank 3,9/22/23,Deposit,2AR79510MK1154237,04 PAYPAL GENERAL UNRESTR,"Subject: GeneralPage
Transaction ID: 2AR79510MK1154237
https://www.paypal.com/activity/payment/2AR79510MK1154237",PayPal Bank 3,--,$2.38 ,"$936,286.04 "
Donations directed by individuals,9/22/23,Deposit,2AR79510MK1154237,04 PAYPAL GENERAL UNRESTR,Support Ukraine - Support Ukraine,Contributed income:Donations directed by individuals,PayPal Bank 3,$3.00 ,"$936,289.04 "
PayPal Fees,9/22/23,Deposit,2AR79510MK1154237,04 PAYPAL GENERAL UNRESTR,PayPal fees,OFFICE/GENERAL ADMINISTRATIVE EXPENSES:PayPal Fees,PayPal Bank 3,$0.62 ,"$936,289.66 "
PayPal Bank 3,9/22/23,Deposit,46H820006S7828536,04 PAYPAL GENERAL UNRESTR,"Subject: GeneralPage
Transaction ID: 46H820006S7828536
https://www.paypal.com/activity/payment/46H820006S7828536",PayPal Bank 3,--,$47.31 ,"$936,336.97 "
Donations directed by individuals,9/22/23,Deposit,46H820006S7828536,04 PAYPAL GENERAL UNRESTR,Support Ukraine - Support Ukraine,Contributed income:Donations directed by individuals,PayPal Bank 3,$50.00 ,"$936,386.97 "
PayPal Fees,9/22/23,Deposit,46H820006S7828536,04 PAYPAL GENERAL UNRESTR,PayPal fees,OFFICE/GENERAL ADMINISTRATIVE EXPENSES:PayPal Fees,PayPal Bank 3,$2.69 ,"$936,389.66 "
PayPal Bank 3,9/22/23,Deposit,2F9962056E6925709,07 1000 DRONES RESTR,"Subject: 1000DRONES
Note: charity
Transaction ID: 2F9962056E6925709
https://www.paypal.com/activity/payment/2F9962056E6925709",PayPal Bank 3,--,$9.84 ,"$936,399.50 "
Donations directed by individuals,9/22/23,Deposit,2F9962056E6925709,07 1000 DRONES RESTR,1000 DRONES FOR UKRAINE - 1000 DRONES FOR UKRAINE,Contributed income:Donations directed by individuals,PayPal Bank 3,$10.80 ,"$936,410.30 "
PayPal Fees,9/22/23,Deposit,2F9962056E6925709,07 1000 DRONES RESTR,PayPal fees,OFFICE/GENERAL ADMINISTRATIVE EXPENSES:PayPal Fees,PayPal Bank 3,$0.96 ,"$936,411.26 "
PayPal Bank 3,9/22/23,Deposit,7.69378E+16,04 PAYPAL GENERAL UNRESTR,"Subject: GeneralPage
Transaction ID: 76937804149483342
https://www.paypal.com/activity/payment/76937804149483342",PayPal Bank 3,--,$14.76 ,"$936,426.02 "
Donations directed by individuals,9/22/23,Deposit,7.69378E+16,04 PAYPAL GENERAL UNRESTR,Support Ukraine - Support Ukraine,Contributed income:Donations directed by individuals,PayPal Bank 3,$15.95 ,"$936,441.97 "
PayPal Fees,9/22/23,Deposit,7.69378E+16,04 PAYPAL GENERAL UNRESTR,PayPal fees,OFFICE/GENERAL ADMINISTRATIVE EXPENSES:PayPal Fees,PayPal Bank 3,$1.19 ,"$936,443.16 "
PayPal Bank 3,9/22/23,Deposit,0TW881165Y916752N,04 PAYPAL GENERAL UNRESTR,"Subject: GeneralPage
Transaction ID: 0TW881165Y916752N
https://www.paypal.com/activity/payment/0TW881165Y916752N",PayPal Bank 3,--,$98.45 ,"$936,541.61 "
Donations directed by individuals,9/22/23,Deposit,0TW881165Y916752N,04 PAYPAL GENERAL UNRESTR,Support Ukraine - Support Ukraine,Contributed income:Donations directed by individuals,PayPal Bank 3,$103.48 ,"$936,645.09 "
PayPal Fees,9/22/23,Deposit,0TW881165Y916752N,04 PAYPAL GENERAL UNRESTR,PayPal fees,OFFICE/GENERAL ADMINISTRATIVE EXPENSES:PayPal Fees,PayPal Bank 3,$5.03 ,"$936,650.12 "
PayPal Bank 3,9/22/23,Deposit,2TM59647S0102361C,04 PAYPAL GENERAL UNRESTR,"Subject: GeneralPage
Note: Charitable donation to Ukrainian defenders
Transaction ID: 2TM59647S0102361C
https://www.paypal.com/activity/payment/2TM59647S0102361C",PayPal Bank 3,--,$98.45 ,"$936,748.57 "
Donations directed by individuals,9/22/23,Deposit,2TM59647S0102361C,04 PAYPAL GENERAL UNRESTR,Support Ukraine - Support Ukraine,Contributed income:Donations directed by individuals,PayPal Bank 3,$103.48 ,"$936,852.05 "
PayPal Fees,9/22/23,Deposit,2TM59647S0102361C,04 PAYPAL GENERAL UNRESTR,PayPal fees,OFFICE/GENERAL ADMINISTRATIVE EXPENSES:PayPal Fees,PayPal Bank 3,$5.03 ,"$936,857.08 "
PayPal Bank 3,9/22/23,Deposit,9W886417HX4120808,04 PAYPAL GENERAL UNRESTR,"Subject: GeneralPage
Transaction ID: 9W886417HX4120808
https://www.paypal.com/activity/payment/9W886417HX4120808",PayPal Bank 3,--,$98.45 ,"$936,955.53 "
Donations directed by individuals,9/22/23,Deposit,9W886417HX4120808,04 PAYPAL GENERAL UNRESTR,Support Ukraine - Support Ukraine,Contributed income:Donations directed by individuals,PayPal Bank 3,$103.48 ,"$937,059.01 "
PayPal Fees,9/22/23,Deposit,9W886417HX4120808,04 PAYPAL GENERAL UNRESTR,PayPal fees,OFFICE/GENERAL ADMINISTRATIVE EXPENSES:PayPal Fees,PayPal Bank 3,$5.03 ,"$937,064.04 "
PayPal Bank 3,9/22/23,Deposit,0UU743164B438782K,04 PAYPAL GENERAL UNRESTR,"Subject: GeneralPage
Transaction ID: 0UU743164B438782K
https://www.paypal.com/activity/payment/0UU743164B438782K",PayPal Bank 3,--,$50.00 ,"$937,114.04 "
Donations directed by individuals,9/22/23,Deposit,0UU743164B438782K,04 PAYPAL GENERAL UNRESTR,Support Ukraine - Support Ukraine,Contributed income:Donations directed by individuals,PayPal Bank 3,$51.99 ,"$937,166.03 "
PayPal Fees,9/22/23,Deposit,0UU743164B438782K,04 PAYPAL GENERAL UNRESTR,PayPal fees,OFFICE/GENERAL ADMINISTRATIVE EXPENSES:PayPal Fees,PayPal Bank 3,$1.99 ,"$937,168.02 "
PayPal Bank 3,9/22/23,Deposit,6CP61379D15078157,04 PAYPAL GENERAL UNRESTR,"Subject: GeneralPage
Transaction ID: 6CP61379D15078157
https://www.paypal.com/activity/payment/6CP61379D15078157",PayPal Bank 3,--,$9.07 ,"$937,177.09 "
Donations directed by individuals,9/22/23,Deposit,6CP61379D15078157,04 PAYPAL GENERAL UNRESTR,Support Ukraine - Support Ukraine,Contributed income:Donations directed by individuals,PayPal Bank 3,$10.00 ,"$937,187.09 "
PayPal Fees,9/22/23,Deposit,6CP61379D15078157,04 PAYPAL GENERAL UNRESTR,PayPal fees,OFFICE/GENERAL ADMINISTRATIVE EXPENSES:PayPal Fees,PayPal Bank 3,$0.93 ,"$937,188.02 "
PayPal Bank 3,9/22/23,Deposit,07H433459W059753W,04 PAYPAL GENERAL UNRESTR,"Subject: GeneralPage
Note: На люті пташки
Transaction ID: 07H433459W059753W
https://www.paypal.com/activity/payment/07H433459W059753W",PayPal Bank 3,--,$9.07 ,"$937,197.09 "
Donations directed by individuals,9/22/23,Deposit,07H433459W059753W,04 PAYPAL GENERAL UNRESTR,Support Ukraine - Support Ukraine,Contributed income:Donations directed by individuals,PayPal Bank 3,$10.00 ,"$937,207.09 "
PayPal Fees,9/22/23,Deposit,07H433459W059753W,04 PAYPAL GENERAL UNRESTR,PayPal fees,OFFICE/GENERAL ADMINISTRATIVE EXPENSES:PayPal Fees,PayPal Bank 3,$0.93 ,"$937,208.02 "
PayPal Bank 3,9/22/23,Deposit,33W119410J994640D,04 PAYPAL GENERAL UNRESTR,"Subject: GeneralPage
Transaction ID: 33W119410J994640D
https://www.paypal.com/activity/payment/33W119410J994640D",PayPal Bank 3,--,$96.62 ,"$937,304.64 "
Donations directed by individuals,9/22/23,Deposit,33W119410J994640D,04 PAYPAL GENERAL UNRESTR,Support Ukraine - Support Ukraine,Contributed income:Donations directed by individuals,PayPal Bank 3,$100.00 ,"$937,404.64 "
PayPal Fees,9/22/23,Deposit,33W119410J994640D,04 PAYPAL GENERAL UNRESTR,PayPal fees,OFFICE/GENERAL ADMINISTRATIVE EXPENSES:PayPal Fees,PayPal Bank 3,$3.38 ,"$937,408.02 "
PayPal Bank 3,9/22/23,Deposit,88V864228U716564Y,04 PAYPAL GENERAL UNRESTR,"Subject: GeneralPage
Transaction ID: 88V864228U716564Y
https://www.paypal.com/activity/payment/88V864228U716564Y",PayPal Bank 3,--,$18.63 ,"$937,426.65 "
Donations directed by individuals,9/22/23,Deposit,88V864228U716564Y,04 PAYPAL GENERAL UNRESTR,Support Ukraine - Support Ukraine,Contributed income:Donations directed by individuals,PayPal Bank 3,$20.00 ,"$937,446.65 "
PayPal Fees,9/22/23,Deposit,88V864228U716564Y,04 PAYPAL GENERAL UNRESTR,PayPal fees,OFFICE/GENERAL ADMINISTRATIVE EXPENSES:PayPal Fees,PayPal Bank 3,$1.37 ,"$937,448.02 "
PayPal Bank 3,9/22/23,Deposit,87K2960894702960P,04 PAYPAL GENERAL UNRESTR,"Subject: GeneralPage
Note: Maria’s Birthday
Transaction ID: 87K2960894702960P
https://www.paypal.com/activity/payment/87K2960894702960P",PayPal Bank 3,--,$50.00 ,"$937,498.02 "
Donations directed by individuals,9/22/23,Deposit,87K2960894702960P,04 PAYPAL GENERAL UNRESTR,Support Ukraine - Support Ukraine,Contributed income:Donations directed by individuals,PayPal Bank 3,$51.99 ,"$937,550.01 "
PayPal Fees,9/22/23,Deposit,87K2960894702960P,04 PAYPAL GENERAL UNRESTR,PayPal fees,OFFICE/GENERAL ADMINISTRATIVE EXPENSES:PayPal Fees,PayPal Bank 3,$1.99 ,"$937,552.00 "
PayPal Bank 3,9/22/23,Deposit,5N977942PY4161037,04 PAYPAL GENERAL UNRESTR,"Subject: GeneralPage
Transaction ID: 5N977942PY4161037
https://www.paypal.com/activity/payment/5N977942PY4161037",PayPal Bank 3,--,$100.00 ,"$937,652.00 "
Donations directed by individuals,9/22/23,Deposit,5N977942PY4161037,04 PAYPAL GENERAL UNRESTR,Support Ukraine - Support Ukraine,Contributed income:Donations directed by individuals,PayPal Bank 3,$103.48 ,"$937,755.48 "
PayPal Fees,9/22/23,Deposit,5N977942PY4161037,04 PAYPAL GENERAL UNRESTR,PayPal fees,OFFICE/GENERAL ADMINISTRATIVE EXPENSES:PayPal Fees,PayPal Bank 3,$3.48 ,"$937,758.96 "
PayPal Bank 3,9/22/23,Deposit,2FA85591YB177193A,04 PAYPAL GENERAL UNRESTR,"Subject: GeneralPage
Transaction ID: 2FA85591YB177193A
https://www.paypal.com/activity/payment/2FA85591YB177193A",PayPal Bank 3,--,$29.53 ,"$937,788.49 "
Donations directed by individuals,9/22/23,Deposit,2FA85591YB177193A,04 PAYPAL GENERAL UNRESTR,Support Ukraine - Support Ukraine,Contributed income:Donations directed by individuals,PayPal Bank 3,$31.40 ,"$937,819.89 "
PayPal Fees,9/22/23,Deposit,2FA85591YB177193A,04 PAYPAL GENERAL UNRESTR,PayPal fees,OFFICE/GENERAL ADMINISTRATIVE EXPENSES:PayPal Fees,PayPal Bank 3,$1.87 ,"$937,821.76 "
PayPal Bank 3,9/22/23,Deposit,5P261190TU2175050,04 PAYPAL GENERAL UNRESTR,"Subject: GeneralPage
Transaction ID: 5P261190TU2175050
https://www.paypal.com/activity/payment/5P261190TU2175050",PayPal Bank 3,--,$30.00 ,"$937,851.76 "
Donations directed by individuals,9/22/23,Deposit,5P261190TU2175050,04 PAYPAL GENERAL UNRESTR,Support Ukraine - Support Ukraine,Contributed income:Donations directed by individuals,PayPal Bank 3,$31.40 ,"$937,883.16 "
PayPal Fees,9/22/23,Deposit,5P261190TU2175050,04 PAYPAL GENERAL UNRESTR,PayPal fees,OFFICE/GENERAL ADMINISTRATIVE EXPENSES:PayPal Fees,PayPal Bank 3,$1.40 ,"$937,884.56 "
PayPal Bank 3,9/22/23,Deposit,84B4026584145823F,04 PAYPAL GENERAL UNRESTR,"Subject: GeneralPage
Note: З днем народження, Маріє�
Transaction ID: 84B4026584145823F
https://www.paypal.com/activity/payment/84B4026584145823F",PayPal Bank 3,--,$18.63 ,"$937,903.19 "
Donations directed by individuals,9/22/23,Deposit,84B4026584145823F,04 PAYPAL GENERAL UNRESTR,Support Ukraine - Support Ukraine,Contributed income:Donations directed by individuals,PayPal Bank 3,$20.00 ,"$937,923.19 "
PayPal Fees,9/22/23,Deposit,84B4026584145823F,04 PAYPAL GENERAL UNRESTR,PayPal fees,OFFICE/GENERAL ADMINISTRATIVE EXPENSES:PayPal Fees,PayPal Bank 3,$1.37 ,"$937,924.56 "
PayPal Bank 3,9/22/23,Deposit,5R515091H4526010V,04 PAYPAL GENERAL UNRESTR,"Subject: GeneralPage
Transaction ID: 5R515091H4526010V
https://www.paypal.com/activity/payment/5R515091H4526010V",PayPal Bank 3,--,$98.45 ,"$938,023.01 "
Donations directed by individuals,9/22/23,Deposit,5R515091H4526010V,04 PAYPAL GENERAL UNRESTR,Support Ukraine - Support Ukraine,Contributed income:Donations directed by individuals,PayPal Bank 3,$103.48 ,"$938,126.49 "
PayPal Fees,9/22/23,Deposit,5R515091H4526010V,04 PAYPAL GENERAL UNRESTR,PayPal fees,OFFICE/GENERAL ADMINISTRATIVE EXPENSES:PayPal Fees,PayPal Bank 3,$5.03 ,"$938,131.52 "
PayPal Bank 3,9/22/23,Deposit,2GY76190804963441,04 PAYPAL GENERAL UNRESTR,"Subject: GeneralPage
Note: З Днем Народження, Маріє!
Transaction ID: 2GY76190804963441
https://www.paypal.com/activity/payment/2GY76190804963441",PayPal Bank 3,--,$47.31 ,"$938,178.83 "
Donations directed by individuals,9/22/23,Deposit,2GY76190804963441,04 PAYPAL GENERAL UNRESTR,Support Ukraine - Support Ukraine,Contributed income:Donations directed by individuals,PayPal Bank 3,$50.00 ,"$938,228.83 "
PayPal Fees,9/22/23,Deposit,2GY76190804963441,04 PAYPAL GENERAL UNRESTR,PayPal fees,OFFICE/GENERAL ADMINISTRATIVE EXPENSES:PayPal Fees,PayPal Bank 3,$2.69 ,"$938,231.52 "
PayPal Bank 3,9/22/23,Deposit,07B83020J87413610,07 1000 DRONES RESTR,"Subject: 1000DRONES
Transaction ID: 07B83020J87413610
https://www.paypal.com/activity/payment/07B83020J87413610",PayPal Bank 3,--,$23.79 ,"$938,255.31 "
Donations directed by individuals,9/22/23,Deposit,07B83020J87413610,07 1000 DRONES RESTR,1000 DRONES FOR UKRAINE - 1000 DRONES FOR UKRAINE,Contributed income:Donations directed by individuals,PayPal Bank 3,$25.00 ,"$938,280.31 "
PayPal Fees,9/22/23,Deposit,07B83020J87413610,07 1000 DRONES RESTR,PayPal fees,OFFICE/GENERAL ADMINISTRATIVE EXPENSES:PayPal Fees,PayPal Bank 3,$1.21 ,"$938,281.52 "
PayPal Bank 3,9/22/23,Deposit,6HX35211GM001514D,07 1000 DRONES RESTR,"Subject: 1000DRONES
Transaction ID: 6HX35211GM001514D
https://www.paypal.com/activity/payment/6HX35211GM001514D",PayPal Bank 3,--,$28.64 ,"$938,310.16 "
Donations directed by individuals,9/22/23,Deposit,6HX35211GM001514D,07 1000 DRONES RESTR,1000 DRONES FOR UKRAINE - 1000 DRONES FOR UKRAINE,Contributed income:Donations directed by individuals,PayPal Bank 3,$30.00 ,"$938,340.16 "
PayPal Fees,9/22/23,Deposit,6HX35211GM001514D,07 1000 DRONES RESTR,PayPal fees,OFFICE/GENERAL ADMINISTRATIVE EXPENSES:PayPal Fees,PayPal Bank 3,$1.36 ,"$938,341.52 "
PayPal Bank 3,9/22/23,Deposit,9FE93419AS622841C,04 PAYPAL GENERAL UNRESTR,"Subject: GeneralPage
Transaction ID: 9FE93419AS622841C
https://www.paypal.com/activity/payment/9FE93419AS622841C",PayPal Bank 3,--,$50.00 ,"$938,391.52 "
Donations directed by individuals,9/22/23,Deposit,9FE93419AS622841C,04 PAYPAL GENERAL UNRESTR,Support Ukraine - Support Ukraine,Contributed income:Donations directed by individuals,PayPal Bank 3,$51.99 ,"$938,443.51 "
PayPal Fees,9/22/23,Deposit,9FE93419AS622841C,04 PAYPAL GENERAL UNRESTR,PayPal fees,OFFICE/GENERAL ADMINISTRATIVE EXPENSES:PayPal Fees,PayPal Bank 3,$1.99 ,"$938,445.50 "
PayPal Bank 3,9/22/23,Deposit,5DM79677J8665364E,04 PAYPAL GENERAL UNRESTR,"Subject: GeneralPage
Transaction ID: 5DM79677J8665364E
https://www.paypal.com/activity/payment/5DM79677J8665364E",PayPal Bank 3,--,$50.00 ,"$938,495.50 "
Donations directed by individuals,9/22/23,Deposit,5DM79677J8665364E,04 PAYPAL GENERAL UNRESTR,Support Ukraine - Support Ukraine,Contributed income:Donations directed by individuals,PayPal Bank 3,$51.99 ,"$938,547.49 "
PayPal Fees,9/22/23,Deposit,5DM79677J8665364E,04 PAYPAL GENERAL UNRESTR,PayPal fees,OFFICE/GENERAL ADMINISTRATIVE EXPENSES:PayPal Fees,PayPal Bank 3,$1.99 ,"$938,549.48 "
PayPal Bank 3,9/22/23,Deposit,2GS02792JA6671926,04 PAYPAL GENERAL UNRESTR,"Subject: GeneralPage
Note: Happy Birthday, Mariya!
Transaction ID: 2GS02792JA6671926
https://www.paypal.com/activity/payment/2GS02792JA6671926",PayPal Bank 3,--,$96.62 ,"$938,646.10 "
Donations directed by individuals,9/22/23,Deposit,2GS02792JA6671926,04 PAYPAL GENERAL UNRESTR,Support Ukraine - Support Ukraine,Contributed income:Donations directed by individuals,PayPal Bank 3,$100.00 ,"$938,746.10 "
PayPal Fees,9/22/23,Deposit,2GS02792JA6671926,04 PAYPAL GENERAL UNRESTR,PayPal fees,OFFICE/GENERAL ADMINISTRATIVE EXPENSES:PayPal Fees,PayPal Bank 3,$3.38 ,"$938,749.48 "
PayPal Bank 3,9/22/23,Deposit,12J68024CC9628533,04 PAYPAL GENERAL UNRESTR,"Subject: GeneralPage
Transaction ID: 12J68024CC9628533
https://www.paypal.com/activity/payment/12J68024CC9628533",PayPal Bank 3,--,$300.00 ,"$939,049.48 "
Donations directed by individuals,9/22/23,Deposit,12J68024CC9628533,04 PAYPAL GENERAL UNRESTR,Support Ukraine - Support Ukraine,Contributed income:Donations directed by individuals,PayPal Bank 3,$309.43 ,"$939,358.91 "
PayPal Fees,9/22/23,Deposit,12J68024CC9628533,04 PAYPAL GENERAL UNRESTR,PayPal fees,OFFICE/GENERAL ADMINISTRATIVE EXPENSES:PayPal Fees,PayPal Bank 3,$9.43 ,"$939,368.34 "
PayPal Bank 3,9/22/23,Deposit,0XG47317GP206745Y,07 1000 DRONES RESTR,"Subject: 1000DRONES
Transaction ID: 0XG47317GP206745Y
https://www.paypal.com/activity/payment/0XG47317GP206745Y",PayPal Bank 3,--,$9.22 ,"$939,377.56 "
Donations directed by individuals,9/22/23,Deposit,0XG47317GP206745Y,07 1000 DRONES RESTR,1000 DRONES FOR UKRAINE - 1000 DRONES FOR UKRAINE,Contributed income:Donations directed by individuals,PayPal Bank 3,$10.00 ,"$939,387.56 "
PayPal Fees,9/22/23,Deposit,0XG47317GP206745Y,07 1000 DRONES RESTR,PayPal fees,OFFICE/GENERAL ADMINISTRATIVE EXPENSES:PayPal Fees,PayPal Bank 3,$0.78 ,"$939,388.34 "
PayPal Bank 3,9/22/23,Deposit,67S940159X641740R,07 1000 DRONES RESTR,"Subject: 1000DRONES
Transaction ID: 67S940159X641740R
https://www.paypal.com/activity/payment/67S940159X641740R",PayPal Bank 3,--,$100.00 ,"$939,488.34 "
Donations directed by individuals,9/22/23,Deposit,67S940159X641740R,07 1000 DRONES RESTR,1000 DRONES FOR UKRAINE - 1000 DRONES FOR UKRAINE,Contributed income:Donations directed by individuals,PayPal Bank 3,$103.48 ,"$939,591.82 "
PayPal Fees,9/22/23,Deposit,67S940159X641740R,07 1000 DRONES RESTR,PayPal fees,OFFICE/GENERAL ADMINISTRATIVE EXPENSES:PayPal Fees,PayPal Bank 3,$3.48 ,"$939,595.30 "
PayPal Bank 3,9/22/23,Deposit,06D890035U0349250,11 VETERANIUS RESTR,"Subject: Veteranius
Transaction ID: 06D890035U0349250
https://www.paypal.com/activity/payment/06D890035U0349250",PayPal Bank 3,--,$20.00 ,"$939,615.30 "
Donations directed by individuals,9/22/23,Deposit,06D890035U0349250,11 VETERANIUS RESTR,Veteranius - helping veterans to learn and gain experience in IT. - Veteranius - helping veterans to learn and gain experience in IT.,Contributed income:Donations directed by individuals,PayPal Bank 3,$21.10 ,"$939,636.40 "
PayPal Fees,9/22/23,Deposit,06D890035U0349250,11 VETERANIUS RESTR,PayPal fees,OFFICE/GENERAL ADMINISTRATIVE EXPENSES:PayPal Fees,PayPal Bank 3,$1.10 ,"$939,637.50 "
PayPal Bank 3,9/22/23,Deposit,56X641800X209802N,07 1000 DRONES RESTR,"Subject: 1000DRONES
Transaction ID: 56X641800X209802N
https://www.paypal.com/activity/payment/56X641800X209802N",PayPal Bank 3,--,$25.00 ,"$939,662.50 "
Donations directed by individuals,9/22/23,Deposit,56X641800X209802N,07 1000 DRONES RESTR,1000 DRONES FOR UKRAINE - 1000 DRONES FOR UKRAINE,Contributed income:Donations directed by individuals,PayPal Bank 3,$26.25 ,"$939,688.75 "
PayPal Fees,9/22/23,Deposit,56X641800X209802N,07 1000 DRONES RESTR,PayPal fees,OFFICE/GENERAL ADMINISTRATIVE EXPENSES:PayPal Fees,PayPal Bank 3,$1.25 ,"$939,690.00 "
PayPal Bank 3,9/22/23,Deposit,0UP65208G74811534,07 1000 DRONES RESTR,"Subject: 1000DRONES
Transaction ID: 0UP65208G74811534
https://www.paypal.com/activity/payment/0UP65208G74811534",PayPal Bank 3,--,$30.00 ,"$939,720.00 "
Donations directed by individuals,9/22/23,Deposit,0UP65208G74811534,07 1000 DRONES RESTR,1000 DRONES FOR UKRAINE - 1000 DRONES FOR UKRAINE,Contributed income:Donations directed by individuals,PayPal Bank 3,$31.40 ,"$939,751.40 "
PayPal Fees,9/22/23,Deposit,0UP65208G74811534,07 1000 DRONES RESTR,PayPal fees,OFFICE/GENERAL ADMINISTRATIVE EXPENSES:PayPal Fees,PayPal Bank 3,$1.40 ,"$939,752.80 "
PayPal Bank 3,9/22/23,Deposit,1NC80872ET105824Y,04 PAYPAL GENERAL UNRESTR,"Subject: GeneralPage
Transaction ID: 1NC80872ET105824Y
https://www.paypal.com/activity/payment/1NC80872ET105824Y",PayPal Bank 3,--,$40.00 ,"$939,792.80 "
Donations directed by individuals,9/22/23,Deposit,1NC80872ET105824Y,04 PAYPAL GENERAL UNRESTR,Support Ukraine - Support Ukraine,Contributed income:Donations directed by individuals,PayPal Bank 3,$41.69 ,"$939,834.49 "
PayPal Fees,9/22/23,Deposit,1NC80872ET105824Y,04 PAYPAL GENERAL UNRESTR,PayPal fees,OFFICE/GENERAL ADMINISTRATIVE EXPENSES:PayPal Fees,PayPal Bank 3,$1.69 ,"$939,836.18 "
PayPal Bank 3,9/22/23,Deposit,3WN68147UY468705T,04 PAYPAL GENERAL UNRESTR,"Transaction ID: 3WN68147UY468705T
https://www.paypal.com/activity/payment/3WN68147UY468705T",PayPal Bank 3,--,$97.01 ,"$939,933.19 "
Donations directed by individuals,9/22/23,Deposit,3WN68147UY468705T,04 PAYPAL GENERAL UNRESTR,Money in to PayPal,Contributed income:Donations directed by individuals,PayPal Bank 3,$100.00 ,"$940,033.19 "
PayPal Fees,9/22/23,Deposit,3WN68147UY468705T,04 PAYPAL GENERAL UNRESTR,PayPal fees,OFFICE/GENERAL ADMINISTRATIVE EXPENSES:PayPal Fees,PayPal Bank 3,$2.99 ,"$940,036.18 "
PayPal Bank 3,9/22/23,Deposit,78N06797HL9738248,04 PAYPAL GENERAL UNRESTR,"Subject: GeneralPage
Transaction ID: 78N06797HL9738248
https://www.paypal.com/activity/payment/78N06797HL9738248",PayPal Bank 3,--,$117.54 ,"$940,153.72 "
Donations directed by individuals,9/22/23,Deposit,78N06797HL9738248,04 PAYPAL GENERAL UNRESTR,Support Ukraine - Support Ukraine,Contributed income:Donations directed by individuals,PayPal Bank 3,$123.45 ,"$940,277.17 "
PayPal Fees,9/22/23,Deposit,78N06797HL9738248,04 PAYPAL GENERAL UNRESTR,PayPal fees,OFFICE/GENERAL ADMINISTRATIVE EXPENSES:PayPal Fees,PayPal Bank 3,$5.91 ,"$940,283.08 "
PayPal Bank 3,9/22/23,Deposit,2HV800517G1396703,04 PAYPAL GENERAL UNRESTR,"Subject: Support Ukraine
Transaction ID: 2HV800517G1396703
https://www.paypal.com/activity/payment/2HV800517G1396703",PayPal Bank 3,--,$24.61 ,"$940,307.69 "
Donations directed by individuals,9/22/23,Deposit,2HV800517G1396703,04 PAYPAL GENERAL UNRESTR,Money in to PayPal,Contributed income:Donations directed by individuals,PayPal Bank 3,$26.25 ,"$940,333.94 "
PayPal Fees,9/22/23,Deposit,2HV800517G1396703,04 PAYPAL GENERAL UNRESTR,PayPal fees,OFFICE/GENERAL ADMINISTRATIVE EXPENSES:PayPal Fees,PayPal Bank 3,$1.64 ,"$940,335.58 "
PayPal Bank 3,9/22/23,Deposit,0VN21464SA872642W,07 1000 DRONES RESTR,"Subject: 1000DRONES
Transaction ID: 0VN21464SA872642W
https://www.paypal.com/activity/payment/0VN21464SA872642W",PayPal Bank 3,--,$9.22 ,"$940,344.80 "
Donations directed by individuals,9/22/23,Deposit,0VN21464SA872642W,07 1000 DRONES RESTR,1000 DRONES FOR UKRAINE - 1000 DRONES FOR UKRAINE,Contributed income:Donations directed by individuals,PayPal Bank 3,$10.00 ,"$940,354.80 "
PayPal Fees,9/22/23,Deposit,0VN21464SA872642W,07 1000 DRONES RESTR,PayPal fees,OFFICE/GENERAL ADMINISTRATIVE EXPENSES:PayPal Fees,PayPal Bank 3,$0.78 ,"$940,355.58 "
PayPal Bank 3,9/22/23,Deposit,8M187574AT955184R,07 1000 DRONES RESTR,"Subject: 1000DRONES
Transaction ID: 8M187574AT955184R
https://www.paypal.com/activity/payment/8M187574AT955184R",PayPal Bank 3,--,$48.06 ,"$940,403.64 "
Donations directed by individuals,9/22/23,Deposit,8M187574AT955184R,07 1000 DRONES RESTR,1000 DRONES FOR UKRAINE - 1000 DRONES FOR UKRAINE,Contributed income:Donations directed by individuals,PayPal Bank 3,$50.00 ,"$940,453.64 "
PayPal Fees,9/22/23,Deposit,8M187574AT955184R,07 1000 DRONES RESTR,PayPal fees,OFFICE/GENERAL ADMINISTRATIVE EXPENSES:PayPal Fees,PayPal Bank 3,$1.94 ,"$940,455.58 "
PayPal Bank 3,9/22/23,Deposit,5NM78294ND926014Y,04 PAYPAL GENERAL UNRESTR,"Subject: GeneralPage
Transaction ID: 5NM78294ND926014Y
https://www.paypal.com/activity/payment/5NM78294ND926014Y",PayPal Bank 3,--,$9.22 ,"$940,464.80 "
Donations directed by individuals,9/22/23,Deposit,5NM78294ND926014Y,04 PAYPAL GENERAL UNRESTR,Support Ukraine - Support Ukraine,Contributed income:Donations directed by individuals,PayPal Bank 3,$10.00 ,"$940,474.80 "
PayPal Fees,9/22/23,Deposit,5NM78294ND926014Y,04 PAYPAL GENERAL UNRESTR,PayPal fees,OFFICE/GENERAL ADMINISTRATIVE EXPENSES:PayPal Fees,PayPal Bank 3,$0.78 ,"$940,475.58 "
PayPal Bank 3,9/22/23,Deposit,5GG81457KB005354U,04 PAYPAL GENERAL UNRESTR,"Transaction ID: 5GG81457KB005354U
https://www.paypal.com/activity/payment/5GG81457KB005354U",PayPal Bank 3,--,$97.01 ,"$940,572.59 "
Donations directed by individuals,9/22/23,Deposit,5GG81457KB005354U,04 PAYPAL GENERAL UNRESTR,Money in to PayPal,Contributed income:Donations directed by individuals,PayPal Bank 3,$100.00 ,"$940,672.59 "
PayPal Fees,9/22/23,Deposit,5GG81457KB005354U,04 PAYPAL GENERAL UNRESTR,PayPal fees,OFFICE/GENERAL ADMINISTRATIVE EXPENSES:PayPal Fees,PayPal Bank 3,$2.99 ,"$940,675.58 "
PayPal Bank 3,9/22/23,Deposit,3R269255CE9352018,04 PAYPAL GENERAL UNRESTR,"Transaction ID: 3R269255CE9352018
https://www.paypal.com/activity/payment/3R269255CE9352018",PayPal Bank 3,--,$48.50 ,"$940,724.08 "
Donations directed by individuals,9/22/23,Deposit,3R269255CE9352018,04 PAYPAL GENERAL UNRESTR,Money in to PayPal,Contributed income:Donations directed by individuals,PayPal Bank 3,$50.00 ,"$940,774.08 "
PayPal Fees,9/22/23,Deposit,3R269255CE9352018,04 PAYPAL GENERAL UNRESTR,PayPal fees,OFFICE/GENERAL ADMINISTRATIVE EXPENSES:PayPal Fees,PayPal Bank 3,$1.50 ,"$940,775.58 "
PayPal Bank 3,9/22/23,Deposit,07247303RU098864Y,11 VETERANIUS RESTR,"Subject: Veteranius
Transaction ID: 07247303RU098864Y
https://www.paypal.com/activity/payment/07247303RU098864Y",PayPal Bank 3,--,$9.22 ,"$940,784.80 "
Donations directed by individuals,9/22/23,Deposit,07247303RU098864Y,11 VETERANIUS RESTR,Veteranius - helping veterans to learn and gain experience in IT. - Veteranius - helping veterans to learn and gain experience in IT.,Contributed income:Donations directed by individuals,PayPal Bank 3,$10.00 ,"$940,794.80 "
PayPal Fees,9/22/23,Deposit,07247303RU098864Y,11 VETERANIUS RESTR,PayPal fees,OFFICE/GENERAL ADMINISTRATIVE EXPENSES:PayPal Fees,PayPal Bank 3,$0.78 ,"$940,795.58 "
PayPal Bank 3,9/22/23,Deposit,21Y17337NP859472P,04 PAYPAL GENERAL UNRESTR,"Transaction ID: 21Y17337NP859472P
https://www.paypal.com/activity/payment/21Y17337NP859472P",PayPal Bank 3,--,$97.01 ,"$940,892.59 "
Donations directed by individuals,9/22/23,Deposit,21Y17337NP859472P,04 PAYPAL GENERAL UNRESTR,Money in to PayPal,Contributed income:Donations directed by individuals,PayPal Bank 3,$100.00 ,"$940,992.59 "
PayPal Fees,9/22/23,Deposit,21Y17337NP859472P,04 PAYPAL GENERAL UNRESTR,PayPal fees,OFFICE/GENERAL ADMINISTRATIVE EXPENSES:PayPal Fees,PayPal Bank 3,$2.99 ,"$940,995.58 "
PayPal Bank 3,9/22/23,Deposit,7RH29875DF462440D,07 1000 DRONES RESTR,"Subject: 1000DRONES
Transaction ID: 7RH29875DF462440D
https://www.paypal.com/activity/payment/7RH29875DF462440D",PayPal Bank 3,--,$18.93 ,"$941,014.51 "
Donations directed by individuals,9/22/23,Deposit,7RH29875DF462440D,07 1000 DRONES RESTR,1000 DRONES FOR UKRAINE - 1000 DRONES FOR UKRAINE,Contributed income:Donations directed by individuals,PayPal Bank 3,$20.00 ,"$941,034.51 "
PayPal Fees,9/22/23,Deposit,7RH29875DF462440D,07 1000 DRONES RESTR,PayPal fees,OFFICE/GENERAL ADMINISTRATIVE EXPENSES:PayPal Fees,PayPal Bank 3,$1.07 ,"$941,035.58 "
PayPal Bank 3,9/22/23,Deposit,1L8260455P948205B,07 1000 DRONES RESTR,"Subject: 1000DRONES
Transaction ID: 1L8260455P948205B
https://www.paypal.com/activity/payment/1L8260455P948205B",PayPal Bank 3,--,$28.64 ,"$941,064.22 "
Donations directed by individuals,9/22/23,Deposit,1L8260455P948205B,07 1000 DRONES RESTR,1000 DRONES FOR UKRAINE - 1000 DRONES FOR UKRAINE,Contributed income:Donations directed by individuals,PayPal Bank 3,$30.00 ,"$941,094.22 "
PayPal Fees,9/22/23,Deposit,1L8260455P948205B,07 1000 DRONES RESTR,PayPal fees,OFFICE/GENERAL ADMINISTRATIVE EXPENSES:PayPal Fees,PayPal Bank 3,$1.36 ,"$941,095.58 "
PayPal Bank 3,9/22/23,Deposit,54706032TL125061W,04 PAYPAL GENERAL UNRESTR,"Transaction ID: 54706032TL125061W
https://www.paypal.com/activity/payment/54706032TL125061W",PayPal Bank 3,--,$19.40 ,"$941,114.98 "
Donations directed by individuals,9/22/23,Deposit,54706032TL125061W,04 PAYPAL GENERAL UNRESTR,Money in to PayPal,Contributed income:Donations directed by individuals,PayPal Bank 3,$20.00 ,"$941,134.98 "
PayPal Fees,9/22/23,Deposit,54706032TL125061W,04 PAYPAL GENERAL UNRESTR,PayPal fees,OFFICE/GENERAL ADMINISTRATIVE EXPENSES:PayPal Fees,PayPal Bank 3,$0.60 ,"$941,135.58 "
PayPal Bank 3,9/22/23,Deposit,68645106W9868733U,04 PAYPAL GENERAL UNRESTR,"Note: For Ukraine
Transaction ID: 68645106W9868733U
https://www.paypal.com/activity/payment/68645106W9868733U",PayPal Bank 3,--,$38.80 ,"$941,174.38 "
Donations directed by individuals,9/22/23,Deposit,68645106W9868733U,04 PAYPAL GENERAL UNRESTR,Money in to PayPal,Contributed income:Donations directed by individuals,PayPal Bank 3,$40.00 ,"$941,214.38 "
PayPal Fees,9/22/23,Deposit,68645106W9868733U,04 PAYPAL GENERAL UNRESTR,PayPal fees,OFFICE/GENERAL ADMINISTRATIVE EXPENSES:PayPal Fees,PayPal Bank 3,$1.20 ,"$941,215.58 "
PayPal Bank 3,9/22/23,Deposit,7SD35651VG565081S,04 PAYPAL GENERAL UNRESTR,"Subject: Support Ukraine
Transaction ID: 7SD35651VG565081S
https://www.paypal.com/activity/payment/7SD35651VG565081S",PayPal Bank 3,--,$50.00 ,"$941,265.58 "
Donations directed by individuals,9/22/23,Deposit,7SD35651VG565081S,04 PAYPAL GENERAL UNRESTR,Money in to PayPal,Contributed income:Donations directed by individuals,PayPal Bank 3,$51.99 ,"$941,317.57 "
PayPal Fees,9/22/23,Deposit,7SD35651VG565081S,04 PAYPAL GENERAL UNRESTR,PayPal fees,OFFICE/GENERAL ADMINISTRATIVE EXPENSES:PayPal Fees,PayPal Bank 3,$1.99 ,"$941,319.56 "
PayPal Bank 3,9/22/23,Deposit,0EX88649X7733440Y,04 PAYPAL GENERAL UNRESTR,"Subject: GeneralPage
Transaction ID: 0EX88649X7733440Y
https://www.paypal.com/activity/payment/0EX88649X7733440Y",PayPal Bank 3,--,$10.00 ,"$941,329.56 "
Donations directed by individuals,9/22/23,Deposit,0EX88649X7733440Y,04 PAYPAL GENERAL UNRESTR,Support Ukraine - Support Ukraine,Contributed income:Donations directed by individuals,PayPal Bank 3,$10.80 ,"$941,340.36 "
PayPal Fees,9/22/23,Deposit,0EX88649X7733440Y,04 PAYPAL GENERAL UNRESTR,PayPal fees,OFFICE/GENERAL ADMINISTRATIVE EXPENSES:PayPal Fees,PayPal Bank 3,$0.80 ,"$941,341.16 "
PayPal Bank 3,9/22/23,Deposit,8G441278KX555713M,07 1000 DRONES RESTR,"Subject: 1000DRONES
Transaction ID: 8G441278KX555713M
https://www.paypal.com/activity/payment/8G441278KX555713M",PayPal Bank 3,--,$96.62 ,"$941,437.78 "
Donations directed by individuals,9/22/23,Deposit,8G441278KX555713M,07 1000 DRONES RESTR,1000 DRONES FOR UKRAINE - 1000 DRONES FOR UKRAINE,Contributed income:Donations directed by individuals,PayPal Bank 3,$100.00 ,"$941,537.78 "
PayPal Fees,9/22/23,Deposit,8G441278KX555713M,07 1000 DRONES RESTR,PayPal fees,OFFICE/GENERAL ADMINISTRATIVE EXPENSES:PayPal Fees,PayPal Bank 3,$3.38 ,"$941,541.16 "
PayPal Bank 3,9/22/23,Deposit,80Y31158HF387350F,04 PAYPAL GENERAL UNRESTR,"Subject: GeneralPage
Transaction ID: 80Y31158HF387350F
https://www.paypal.com/activity/payment/80Y31158HF387350F",PayPal Bank 3,--,$10.00 ,"$941,551.16 "
Donations directed by individuals,9/22/23,Deposit,80Y31158HF387350F,04 PAYPAL GENERAL UNRESTR,Support Ukraine - Support Ukraine,Contributed income:Donations directed by individuals,PayPal Bank 3,$10.80 ,"$941,561.96 "
PayPal Fees,9/22/23,Deposit,80Y31158HF387350F,04 PAYPAL GENERAL UNRESTR,PayPal fees,OFFICE/GENERAL ADMINISTRATIVE EXPENSES:PayPal Fees,PayPal Bank 3,$0.80 ,"$941,562.76 "
PayPal Bank 3,9/22/23,Deposit,40M38986H3646794J,07 1000 DRONES RESTR,"Subject: 1000DRONES
Transaction ID: 40M38986H3646794J
https://www.paypal.com/activity/payment/40M38986H3646794J",PayPal Bank 3,--,$20.00 ,"$941,582.76 "
Donations directed by individuals,9/22/23,Deposit,40M38986H3646794J,07 1000 DRONES RESTR,1000 DRONES FOR UKRAINE - 1000 DRONES FOR UKRAINE,Contributed income:Donations directed by individuals,PayPal Bank 3,$21.10 ,"$941,603.86 "
PayPal Fees,9/22/23,Deposit,40M38986H3646794J,07 1000 DRONES RESTR,PayPal fees,OFFICE/GENERAL ADMINISTRATIVE EXPENSES:PayPal Fees,PayPal Bank 3,$1.10 ,"$941,604.96 "
PayPal Bank 3,9/22/23,Deposit,4881252501302524F,07 1000 DRONES RESTR,"Subject: 1000DRONES
Transaction ID: 4881252501302524F
https://www.paypal.com/activity/payment/4881252501302524F",PayPal Bank 3,--,$9.22 ,"$941,614.18 "
Donations directed by individuals,9/22/23,Deposit,4881252501302524F,07 1000 DRONES RESTR,1000 DRONES FOR UKRAINE - 1000 DRONES FOR UKRAINE,Contributed income:Donations directed by individuals,PayPal Bank 3,$10.00 ,"$941,624.18 "
PayPal Fees,9/22/23,Deposit,4881252501302524F,07 1000 DRONES RESTR,PayPal fees,OFFICE/GENERAL ADMINISTRATIVE EXPENSES:PayPal Fees,PayPal Bank 3,$0.78 ,"$941,624.96 "
PayPal Bank 3,9/22/23,Deposit,2MM55629VA1674223,04 PAYPAL GENERAL UNRESTR,"Subject: GeneralPage
Transaction ID: 2MM55629VA1674223
https://www.paypal.com/activity/payment/2MM55629VA1674223",PayPal Bank 3,--,$96.62 ,"$941,721.58 "
Donations directed by individuals,9/22/23,Deposit,2MM55629VA1674223,04 PAYPAL GENERAL UNRESTR,Support Ukraine - Support Ukraine,Contributed income:Donations directed by individuals,PayPal Bank 3,$100.00 ,"$941,821.58 "
PayPal Fees,9/22/23,Deposit,2MM55629VA1674223,04 PAYPAL GENERAL UNRESTR,PayPal fees,OFFICE/GENERAL ADMINISTRATIVE EXPENSES:PayPal Fees,PayPal Bank 3,$3.38 ,"$941,824.96 "
PayPal Bank 3,9/22/23,Deposit,17G71747SC544061J,04 PAYPAL GENERAL UNRESTR,"Subject: GeneralPage
Transaction ID: 17G71747SC544061J
https://www.paypal.com/activity/payment/17G71747SC544061J",PayPal Bank 3,--,$9.84 ,"$941,834.80 "
Donations directed by individuals,9/22/23,Deposit,17G71747SC544061J,04 PAYPAL GENERAL UNRESTR,Support Ukraine - Support Ukraine,Contributed income:Donations directed by individuals,PayPal Bank 3,$10.80 ,"$941,845.60 "
PayPal Fees,9/22/23,Deposit,17G71747SC544061J,04 PAYPAL GENERAL UNRESTR,PayPal fees,OFFICE/GENERAL ADMINISTRATIVE EXPENSES:PayPal Fees,PayPal Bank 3,$0.96 ,"$941,846.56 "
PayPal Bank 3,9/22/23,Deposit,9BP75565MD6309947,04 PAYPAL GENERAL UNRESTR,"Subject: GeneralPage
Transaction ID: 9BP75565MD6309947
https://www.paypal.com/activity/payment/9BP75565MD6309947",PayPal Bank 3,--,$9.84 ,"$941,856.40 "
Donations directed by individuals,9/22/23,Deposit,9BP75565MD6309947,04 PAYPAL GENERAL UNRESTR,Support Ukraine - Support Ukraine,Contributed income:Donations directed by individuals,PayPal Bank 3,$10.80 ,"$941,867.20 "
PayPal Fees,9/22/23,Deposit,9BP75565MD6309947,04 PAYPAL GENERAL UNRESTR,PayPal fees,OFFICE/GENERAL ADMINISTRATIVE EXPENSES:PayPal Fees,PayPal Bank 3,$0.96 ,"$941,868.16 "
PayPal Bank 3,9/22/23,Deposit,18N475688M130574D,04 PAYPAL GENERAL UNRESTR,"Subject: GeneralPage
Transaction ID: 18N475688M130574D
https://www.paypal.com/activity/payment/18N475688M130574D",PayPal Bank 3,--,$19.17 ,"$941,887.33 "
Donations directed by individuals,9/22/23,Deposit,18N475688M130574D,04 PAYPAL GENERAL UNRESTR,Support Ukraine - Support Ukraine,Contributed income:Donations directed by individuals,PayPal Bank 3,$20.24 ,"$941,907.57 "
PayPal Fees,9/22/23,Deposit,18N475688M130574D,04 PAYPAL GENERAL UNRESTR,PayPal fees,OFFICE/GENERAL ADMINISTRATIVE EXPENSES:PayPal Fees,PayPal Bank 3,$1.07 ,"$941,908.64 "
PayPal Bank 3,9/22/23,Deposit,142680755U317423S,04 PAYPAL GENERAL UNRESTR,"Subject: GeneralPage
Transaction ID: 142680755U317423S
https://www.paypal.com/activity/payment/142680755U317423S",PayPal Bank 3,--,$23.79 ,"$941,932.43 "
Donations directed by individuals,9/22/23,Deposit,142680755U317423S,04 PAYPAL GENERAL UNRESTR,Support Ukraine - Support Ukraine,Contributed income:Donations directed by individuals,PayPal Bank 3,$25.00 ,"$941,957.43 "
PayPal Fees,9/22/23,Deposit,142680755U317423S,04 PAYPAL GENERAL UNRESTR,PayPal fees,OFFICE/GENERAL ADMINISTRATIVE EXPENSES:PayPal Fees,PayPal Bank 3,$1.21 ,"$941,958.64 "
PayPal Bank 3,9/22/23,Deposit,2F131387GJ6017710,04 PAYPAL GENERAL UNRESTR,"Subject: GeneralPage
Transaction ID: 2F131387GJ6017710
https://www.paypal.com/activity/payment/2F131387GJ6017710",PayPal Bank 3,--,$100.00 ,"$942,058.64 "
Donations directed by individuals,9/22/23,Deposit,2F131387GJ6017710,04 PAYPAL GENERAL UNRESTR,Support Ukraine - Support Ukraine,Contributed income:Donations directed by individuals,PayPal Bank 3,$103.48 ,"$942,162.12 "
PayPal Fees,9/22/23,Deposit,2F131387GJ6017710,04 PAYPAL GENERAL UNRESTR,PayPal fees,OFFICE/GENERAL ADMINISTRATIVE EXPENSES:PayPal Fees,PayPal Bank 3,$3.48 ,"$942,165.60 "
PayPal Bank 3,9/22/23,Deposit,8WF43927VV960394B,04 PAYPAL GENERAL UNRESTR,"Subject: GeneralPage
Transaction ID: 8WF43927VV960394B
https://www.paypal.com/activity/payment/8WF43927VV960394B",PayPal Bank 3,--,$95.12 ,"$942,260.72 "
Donations directed by individuals,9/22/23,Deposit,8WF43927VV960394B,04 PAYPAL GENERAL UNRESTR,Support Ukraine - Support Ukraine,Contributed income:Donations directed by individuals,PayPal Bank 3,$100.00 ,"$942,360.72 "
PayPal Fees,9/22/23,Deposit,8WF43927VV960394B,04 PAYPAL GENERAL UNRESTR,PayPal fees,OFFICE/GENERAL ADMINISTRATIVE EXPENSES:PayPal Fees,PayPal Bank 3,$4.88 ,"$942,365.60 "
PayPal Bank 3,9/22/23,Deposit,9DX55998C4076842J,04 PAYPAL GENERAL UNRESTR,"Subject: GeneralPage
Note: Dlja Peremohy Ukrajni
Transaction ID: 9DX55998C4076842J
https://www.paypal.com/activity/payment/9DX55998C4076842J",PayPal Bank 3,--,$246.13 ,"$942,611.73 "
Donations directed by individuals,9/22/23,Deposit,9DX55998C4076842J,04 PAYPAL GENERAL UNRESTR,Support Ukraine - Support Ukraine,Contributed income:Donations directed by individuals,PayPal Bank 3,$257.94 ,"$942,869.67 "
PayPal Fees,9/22/23,Deposit,9DX55998C4076842J,04 PAYPAL GENERAL UNRESTR,PayPal fees,OFFICE/GENERAL ADMINISTRATIVE EXPENSES:PayPal Fees,PayPal Bank 3,$11.81 ,"$942,881.48 "
PayPal Bank 3,9/22/23,Deposit,8RF82337DK472105E,04 PAYPAL GENERAL UNRESTR,"Subject: GeneralPage
Note: Ukraine Strong
Transaction ID: 8RF82337DK472105E
https://www.paypal.com/activity/payment/8RF82337DK472105E",PayPal Bank 3,--,$200.00 ,"$943,081.48 "
Donations directed by individuals,9/22/23,Deposit,8RF82337DK472105E,04 PAYPAL GENERAL UNRESTR,Support Ukraine - Support Ukraine,Contributed income:Donations directed by individuals,PayPal Bank 3,$206.46 ,"$943,287.94 "
PayPal Fees,9/22/23,Deposit,8RF82337DK472105E,04 PAYPAL GENERAL UNRESTR,PayPal fees,OFFICE/GENERAL ADMINISTRATIVE EXPENSES:PayPal Fees,PayPal Bank 3,$6.46 ,"$943,294.40 "
PayPal Bank 3,9/22/23,Deposit,92849379NY251523H,04 PAYPAL GENERAL UNRESTR,"Subject: GeneralPage
Note: Liuti ptashky
Transaction ID: 92849379NY251523H
https://www.paypal.com/activity/payment/92849379NY251523H",PayPal Bank 3,--,$44.29 ,"$943,338.69 "
Donations directed by individuals,9/22/23,Deposit,92849379NY251523H,04 PAYPAL GENERAL UNRESTR,Support Ukraine - Support Ukraine,Contributed income:Donations directed by individuals,PayPal Bank 3,$46.84 ,"$943,385.53 "
PayPal Fees,9/22/23,Deposit,92849379NY251523H,04 PAYPAL GENERAL UNRESTR,PayPal fees,OFFICE/GENERAL ADMINISTRATIVE EXPENSES:PayPal Fees,PayPal Bank 3,$2.55 ,"$943,388.08 "
PayPal Bank 3,9/22/23,Deposit,24H05466E78915840,04 PAYPAL GENERAL UNRESTR,"Subject: GeneralPage
Transaction ID: 24H05466E78915840
https://www.paypal.com/activity/payment/24H05466E78915840",PayPal Bank 3,--,$95.12 ,"$943,483.20 "
Donations directed by individuals,9/22/23,Deposit,24H05466E78915840,04 PAYPAL GENERAL UNRESTR,Support Ukraine - Support Ukraine,Contributed income:Donations directed by individuals,PayPal Bank 3,$100.00 ,"$943,583.20 "
PayPal Fees,9/22/23,Deposit,24H05466E78915840,04 PAYPAL GENERAL UNRESTR,PayPal fees,OFFICE/GENERAL ADMINISTRATIVE EXPENSES:PayPal Fees,PayPal Bank 3,$4.88 ,"$943,588.08 "
PayPal Bank 3,9/22/23,Deposit,59V91817VH0167112,04 PAYPAL GENERAL UNRESTR,"Subject: GeneralPage
Transaction ID: 59V91817VH0167112
https://www.paypal.com/activity/payment/59V91817VH0167112",PayPal Bank 3,--,$29.53 ,"$943,617.61 "
Donations directed by individuals,9/22/23,Deposit,59V91817VH0167112,04 PAYPAL GENERAL UNRESTR,Support Ukraine - Support Ukraine,Contributed income:Donations directed by individuals,PayPal Bank 3,$31.40 ,"$943,649.01 "
PayPal Fees,9/22/23,Deposit,59V91817VH0167112,04 PAYPAL GENERAL UNRESTR,PayPal fees,OFFICE/GENERAL ADMINISTRATIVE EXPENSES:PayPal Fees,PayPal Bank 3,$1.87 ,"$943,650.88 "
PayPal Bank 3,9/22/23,Deposit,8YG04764AJ853973H,04 PAYPAL GENERAL UNRESTR,"Subject: GeneralPage
Transaction ID: 8YG04764AJ853973H
https://www.paypal.com/activity/payment/8YG04764AJ853973H",PayPal Bank 3,--,$96.62 ,"$943,747.50 "
Donations directed by individuals,9/22/23,Deposit,8YG04764AJ853973H,04 PAYPAL GENERAL UNRESTR,Support Ukraine - Support Ukraine,Contributed income:Donations directed by individuals,PayPal Bank 3,$100.00 ,"$943,847.50 "
PayPal Fees,9/22/23,Deposit,8YG04764AJ853973H,04 PAYPAL GENERAL UNRESTR,PayPal fees,OFFICE/GENERAL ADMINISTRATIVE EXPENSES:PayPal Fees,PayPal Bank 3,$3.38 ,"$943,850.88 "
PayPal Bank 3,9/22/23,Deposit,35828543NT836045K,08 VICTORY DRONES RESTR,"Subject: VICTORY DRONES
Transaction ID: 35828543NT836045K
https://www.paypal.com/activity/payment/35828543NT836045K",PayPal Bank 3,--,$100.00 ,"$943,950.88 "
Donations directed by individuals,9/22/23,Deposit,35828543NT836045K,08 VICTORY DRONES RESTR,Money in to PayPal,Contributed income:Donations directed by individuals,PayPal Bank 3,$103.48 ,"$944,054.36 "
PayPal Fees,9/22/23,Deposit,35828543NT836045K,08 VICTORY DRONES RESTR,PayPal fees,OFFICE/GENERAL ADMINISTRATIVE EXPENSES:PayPal Fees,PayPal Bank 3,$3.48 ,"$944,057.84 "
PayPal Bank 3,9/22/23,Deposit,8UW05977A31013801,04 PAYPAL GENERAL UNRESTR,"Subject: GeneralPage
Transaction ID: 8UW05977A31013801
https://www.paypal.com/activity/payment/8UW05977A31013801",PayPal Bank 3,--,$24.61 ,"$944,082.45 "
Donations directed by individuals,9/22/23,Deposit,8UW05977A31013801,04 PAYPAL GENERAL UNRESTR,Support Ukraine - Support Ukraine,Contributed income:Donations directed by individuals,PayPal Bank 3,$26.25 ,"$944,108.70 "
PayPal Fees,9/22/23,Deposit,8UW05977A31013801,04 PAYPAL GENERAL UNRESTR,PayPal fees,OFFICE/GENERAL ADMINISTRATIVE EXPENSES:PayPal Fees,PayPal Bank 3,$1.64 ,"$944,110.34 "
PayPal Bank 3,9/22/23,Deposit,1YX81155BH655573G,04 PAYPAL GENERAL UNRESTR,"Subject: Support Ukraine
Transaction ID: 1YX81155BH655573G
https://www.paypal.com/activity/payment/1YX81155BH655573G",PayPal Bank 3,--,$9.84 ,"$944,120.18 "
Donations directed by individuals,9/22/23,Deposit,1YX81155BH655573G,04 PAYPAL GENERAL UNRESTR,Money in to PayPal,Contributed income:Donations directed by individuals,PayPal Bank 3,$10.80 ,"$944,130.98 "
PayPal Fees,9/22/23,Deposit,1YX81155BH655573G,04 PAYPAL GENERAL UNRESTR,PayPal fees,OFFICE/GENERAL ADMINISTRATIVE EXPENSES:PayPal Fees,PayPal Bank 3,$0.96 ,"$944,131.94 "
PayPal Bank 3,9/22/23,Deposit,0GR32832JG003733X,04 PAYPAL GENERAL UNRESTR,"Subject: GeneralPage
Transaction ID: 0GR32832JG003733X
https://www.paypal.com/activity/payment/0GR32832JG003733X",PayPal Bank 3,--,$18.63 ,"$944,150.57 "
Donations directed by individuals,9/22/23,Deposit,0GR32832JG003733X,04 PAYPAL GENERAL UNRESTR,Support Ukraine - Support Ukraine,Contributed income:Donations directed by individuals,PayPal Bank 3,$20.00 ,"$944,170.57 "
PayPal Fees,9/22/23,Deposit,0GR32832JG003733X,04 PAYPAL GENERAL UNRESTR,PayPal fees,OFFICE/GENERAL ADMINISTRATIVE EXPENSES:PayPal Fees,PayPal Bank 3,$1.37 ,"$944,171.94 "
PayPal Bank 3,9/22/23,Deposit,0FX81998NC559001L,04 PAYPAL GENERAL UNRESTR,"Subject: GeneralPage
Transaction ID: 0FX81998NC559001L
https://www.paypal.com/activity/payment/0FX81998NC559001L",PayPal Bank 3,--,$100.00 ,"$944,271.94 "
Donations directed by individuals,9/22/23,Deposit,0FX81998NC559001L,04 PAYPAL GENERAL UNRESTR,Support Ukraine - Support Ukraine,Contributed income:Donations directed by individuals,PayPal Bank 3,$103.48 ,"$944,375.42 "
PayPal Fees,9/22/23,Deposit,0FX81998NC559001L,04 PAYPAL GENERAL UNRESTR,PayPal fees,OFFICE/GENERAL ADMINISTRATIVE EXPENSES:PayPal Fees,PayPal Bank 3,$3.48 ,"$944,378.90 "
PayPal Bank 3,9/22/23,Deposit,26U48349N8691404V,07 1000 DRONES RESTR,"Subject: 1000DRONES
Transaction ID: 26U48349N8691404V
https://www.paypal.com/activity/payment/26U48349N8691404V",PayPal Bank 3,--,$100.00 ,"$944,478.90 "
Donations directed by individuals,9/22/23,Deposit,26U48349N8691404V,07 1000 DRONES RESTR,1000 DRONES FOR UKRAINE - 1000 DRONES FOR UKRAINE,Contributed income:Donations directed by individuals,PayPal Bank 3,$103.48 ,"$944,582.38 "
PayPal Fees,9/22/23,Deposit,26U48349N8691404V,07 1000 DRONES RESTR,PayPal fees,OFFICE/GENERAL ADMINISTRATIVE EXPENSES:PayPal Fees,PayPal Bank 3,$3.48 ,"$944,585.86 "
PayPal Bank 3,9/22/23,Deposit,0U202243C1725713D,04 PAYPAL GENERAL UNRESTR,"Subject: GeneralPage
Transaction ID: 0U202243C1725713D
https://www.paypal.com/activity/payment/0U202243C1725713D",PayPal Bank 3,--,$71.22 ,"$944,657.08 "
Donations directed by individuals,9/22/23,Deposit,0U202243C1725713D,04 PAYPAL GENERAL UNRESTR,Support Ukraine - Support Ukraine,Contributed income:Donations directed by individuals,PayPal Bank 3,$75.00 ,"$944,732.08 "
PayPal Fees,9/22/23,Deposit,0U202243C1725713D,04 PAYPAL GENERAL UNRESTR,PayPal fees,OFFICE/GENERAL ADMINISTRATIVE EXPENSES:PayPal Fees,PayPal Bank 3,$3.78 ,"$944,735.86 "
PayPal Bank 3,9/22/23,Deposit,7KC66483C6871271C,04 PAYPAL GENERAL UNRESTR,"Subject: GeneralPage
Transaction ID: 7KC66483C6871271C
https://www.paypal.com/activity/payment/7KC66483C6871271C",PayPal Bank 3,--,$96.62 ,"$944,832.48 "
Donations directed by individuals,9/22/23,Deposit,7KC66483C6871271C,04 PAYPAL GENERAL UNRESTR,Support Ukraine - Support Ukraine,Contributed income:Donations directed by individuals,PayPal Bank 3,$100.00 ,"$944,932.48 "
PayPal Fees,9/22/23,Deposit,7KC66483C6871271C,04 PAYPAL GENERAL UNRESTR,PayPal fees,OFFICE/GENERAL ADMINISTRATIVE EXPENSES:PayPal Fees,PayPal Bank 3,$3.38 ,"$944,935.86 "
PayPal Bank 3,9/22/23,Deposit,4EY366765W4879742,04 PAYPAL GENERAL UNRESTR,"Subject: Support Ukraine
Transaction ID: 4EY366765W4879742
https://www.paypal.com/activity/payment/4EY366765W4879742",PayPal Bank 3,--,$29.53 ,"$944,965.39 "
Donations directed by individuals,9/22/23,Deposit,4EY366765W4879742,04 PAYPAL GENERAL UNRESTR,Money in to PayPal,Contributed income:Donations directed by individuals,PayPal Bank 3,$31.40 ,"$944,996.79 "
PayPal Fees,9/22/23,Deposit,4EY366765W4879742,04 PAYPAL GENERAL UNRESTR,PayPal fees,OFFICE/GENERAL ADMINISTRATIVE EXPENSES:PayPal Fees,PayPal Bank 3,$1.87 ,"$944,998.66 "
PayPal Bank 3,9/22/23,Deposit,7RX28609RA4921907,04 PAYPAL GENERAL UNRESTR,"Subject: GeneralPage
Transaction ID: 7RX28609RA4921907
https://www.paypal.com/activity/payment/7RX28609RA4921907",PayPal Bank 3,--,$50.00 ,"$945,048.66 "
Donations directed by individuals,9/22/23,Deposit,7RX28609RA4921907,04 PAYPAL GENERAL UNRESTR,Support Ukraine - Support Ukraine,Contributed income:Donations directed by individuals,PayPal Bank 3,$51.99 ,"$945,100.65 "
PayPal Fees,9/22/23,Deposit,7RX28609RA4921907,04 PAYPAL GENERAL UNRESTR,PayPal fees,OFFICE/GENERAL ADMINISTRATIVE EXPENSES:PayPal Fees,PayPal Bank 3,$1.99 ,"$945,102.64 "
PayPal Bank 3,9/22/23,Deposit,67G33827KT8589325,04 PAYPAL GENERAL UNRESTR,"Subject: GeneralPage
Transaction ID: 67G33827KT8589325
https://www.paypal.com/activity/payment/67G33827KT8589325",PayPal Bank 3,--,$98.45 ,"$945,201.09 "
Donations directed by individuals,9/22/23,Deposit,67G33827KT8589325,04 PAYPAL GENERAL UNRESTR,Support Ukraine - Support Ukraine,Contributed income:Donations directed by individuals,PayPal Bank 3,$103.48 ,"$945,304.57 "
PayPal Fees,9/22/23,Deposit,67G33827KT8589325,04 PAYPAL GENERAL UNRESTR,PayPal fees,OFFICE/GENERAL ADMINISTRATIVE EXPENSES:PayPal Fees,PayPal Bank 3,$5.03 ,"$945,309.60 "
PayPal Bank 3,9/22/23,Deposit,1K318917DR530935J,04 PAYPAL GENERAL UNRESTR,"Subject: GeneralPage
Transaction ID: 1K318917DR530935J
https://www.paypal.com/activity/payment/1K318917DR530935J",PayPal Bank 3,--,$190.73 ,"$945,500.33 "
Donations directed by individuals,9/22/23,Deposit,1K318917DR530935J,04 PAYPAL GENERAL UNRESTR,Support Ukraine - Support Ukraine,Contributed income:Donations directed by individuals,PayPal Bank 3,$200.00 ,"$945,700.33 "
PayPal Fees,9/22/23,Deposit,1K318917DR530935J,04 PAYPAL GENERAL UNRESTR,PayPal fees,OFFICE/GENERAL ADMINISTRATIVE EXPENSES:PayPal Fees,PayPal Bank 3,$9.27 ,"$945,709.60 "
PayPal Bank 3,9/22/23,Deposit,4WY14105S32898233,07 1000 DRONES RESTR,"Subject: 1000DRONES
Transaction ID: 4WY14105S32898233
https://www.paypal.com/activity/payment/4WY14105S32898233",PayPal Bank 3,--,$250.00 ,"$945,959.60 "
Donations directed by individuals,9/22/23,Deposit,4WY14105S32898233,07 1000 DRONES RESTR,1000 DRONES FOR UKRAINE - 1000 DRONES FOR UKRAINE,Contributed income:Donations directed by individuals,PayPal Bank 3,$257.94 ,"$946,217.54 "
PayPal Fees,9/22/23,Deposit,4WY14105S32898233,07 1000 DRONES RESTR,PayPal fees,OFFICE/GENERAL ADMINISTRATIVE EXPENSES:PayPal Fees,PayPal Bank 3,$7.94 ,"$946,225.48 "
PayPal Bank 3,9/22/23,Deposit,9BY59096T6696433B,04 PAYPAL GENERAL UNRESTR,"Subject: GeneralPage
Transaction ID: 9BY59096T6696433B
https://www.paypal.com/activity/payment/9BY59096T6696433B",PayPal Bank 3,--,$47.31 ,"$946,272.79 "
Donations directed by individuals,9/22/23,Deposit,9BY59096T6696433B,04 PAYPAL GENERAL UNRESTR,Support Ukraine - Support Ukraine,Contributed income:Donations directed by individuals,PayPal Bank 3,$50.00 ,"$946,322.79 "
PayPal Fees,9/22/23,Deposit,9BY59096T6696433B,04 PAYPAL GENERAL UNRESTR,PayPal fees,OFFICE/GENERAL ADMINISTRATIVE EXPENSES:PayPal Fees,PayPal Bank 3,$2.69 ,"$946,325.48 "
PayPal Bank 3,9/22/23,Deposit,5L035265W54789510,04 PAYPAL GENERAL UNRESTR,"Subject: Support Ukraine
Transaction ID: 5L035265W54789510
https://www.paypal.com/activity/payment/5L035265W54789510",PayPal Bank 3,--,$4.29 ,"$946,329.77 "
Donations directed by individuals,9/22/23,Deposit,5L035265W54789510,04 PAYPAL GENERAL UNRESTR,Money in to PayPal,Contributed income:Donations directed by individuals,PayPal Bank 3,$5.00 ,"$946,334.77 "
PayPal Fees,9/22/23,Deposit,5L035265W54789510,04 PAYPAL GENERAL UNRESTR,PayPal fees,OFFICE/GENERAL ADMINISTRATIVE EXPENSES:PayPal Fees,PayPal Bank 3,$0.71 ,"$946,335.48 "
PayPal Bank 3,9/22/23,Deposit,83P51623JL6917910,04 PAYPAL GENERAL UNRESTR,"Subject: GeneralPage
Transaction ID: 83P51623JL6917910
https://www.paypal.com/activity/payment/83P51623JL6917910",PayPal Bank 3,--,$9.22 ,"$946,344.70 "
Donations directed by individuals,9/22/23,Deposit,83P51623JL6917910,04 PAYPAL GENERAL UNRESTR,Support Ukraine - Support Ukraine,Contributed income:Donations directed by individuals,PayPal Bank 3,$10.00 ,"$946,354.70 "
PayPal Fees,9/22/23,Deposit,83P51623JL6917910,04 PAYPAL GENERAL UNRESTR,PayPal fees,OFFICE/GENERAL ADMINISTRATIVE EXPENSES:PayPal Fees,PayPal Bank 3,$0.78 ,"$946,355.48 "
PayPal Bank 3,9/22/23,Deposit,0J522931637712152,04 PAYPAL GENERAL UNRESTR,"Subject: GeneralPage
Note: За каховську ГЕС
Transaction ID: 0J522931637712152
https://www.paypal.com/activity/payment/0J522931637712152",PayPal Bank 3,--,$47.31 ,"$946,402.79 "
Donations directed by individuals,9/22/23,Deposit,0J522931637712152,04 PAYPAL GENERAL UNRESTR,Support Ukraine - Support Ukraine,Contributed income:Donations directed by individuals,PayPal Bank 3,$50.00 ,"$946,452.79 "
PayPal Fees,9/22/23,Deposit,0J522931637712152,04 PAYPAL GENERAL UNRESTR,PayPal fees,OFFICE/GENERAL ADMINISTRATIVE EXPENSES:PayPal Fees,PayPal Bank 3,$2.69 ,"$946,455.48 "
PayPal Bank 3,9/22/23,Deposit,7P867305A14479716,04 PAYPAL GENERAL UNRESTR,"Subject: GeneralPage
Transaction ID: 7P867305A14479716
https://www.paypal.com/activity/payment/7P867305A14479716",PayPal Bank 3,--,$96.62 ,"$946,552.10 "
Donations directed by individuals,9/22/23,Deposit,7P867305A14479716,04 PAYPAL GENERAL UNRESTR,Support Ukraine - Support Ukraine,Contributed income:Donations directed by individuals,PayPal Bank 3,$100.00 ,"$946,652.10 "
PayPal Fees,9/22/23,Deposit,7P867305A14479716,04 PAYPAL GENERAL UNRESTR,PayPal fees,OFFICE/GENERAL ADMINISTRATIVE EXPENSES:PayPal Fees,PayPal Bank 3,$3.38 ,"$946,655.48 "
PayPal Bank 3,9/22/23,Deposit,5L101891VF097534J,04 PAYPAL GENERAL UNRESTR,"Subject: GeneralPage
Transaction ID: 5L101891VF097534J
https://www.paypal.com/activity/payment/5L101891VF097534J",PayPal Bank 3,--,$19.68 ,"$946,675.16 "
Donations directed by individuals,9/22/23,Deposit,5L101891VF097534J,04 PAYPAL GENERAL UNRESTR,Support Ukraine - Support Ukraine,Contributed income:Donations directed by individuals,PayPal Bank 3,$21.10 ,"$946,696.26 "
PayPal Fees,9/22/23,Deposit,5L101891VF097534J,04 PAYPAL GENERAL UNRESTR,PayPal fees,OFFICE/GENERAL ADMINISTRATIVE EXPENSES:PayPal Fees,PayPal Bank 3,$1.42 ,"$946,697.68 "
PayPal Bank 3,9/22/23,Deposit,9J277679X1559944P,04 PAYPAL GENERAL UNRESTR,"Subject: GeneralPage
Transaction ID: 9J277679X1559944P
https://www.paypal.com/activity/payment/9J277679X1559944P",PayPal Bank 3,--,$48.06 ,"$946,745.74 "
Donations directed by individuals,9/22/23,Deposit,9J277679X1559944P,04 PAYPAL GENERAL UNRESTR,Support Ukraine - Support Ukraine,Contributed income:Donations directed by individuals,PayPal Bank 3,$50.00 ,"$946,795.74 "
PayPal Fees,9/22/23,Deposit,9J277679X1559944P,04 PAYPAL GENERAL UNRESTR,PayPal fees,OFFICE/GENERAL ADMINISTRATIVE EXPENSES:PayPal Fees,PayPal Bank 3,$1.94 ,"$946,797.68 "
PayPal Bank 3,9/22/23,Deposit,27D61325PF315034M,04 PAYPAL GENERAL UNRESTR,"Subject: Support Ukraine
Transaction ID: 27D61325PF315034M
https://www.paypal.com/activity/payment/27D61325PF315034M",PayPal Bank 3,--,$68.35 ,"$946,866.03 "
Donations directed by individuals,9/22/23,Deposit,27D61325PF315034M,04 PAYPAL GENERAL UNRESTR,Money in to PayPal,Contributed income:Donations directed by individuals,PayPal Bank 3,$72.00 ,"$946,938.03 "
PayPal Fees,9/22/23,Deposit,27D61325PF315034M,04 PAYPAL GENERAL UNRESTR,PayPal fees,OFFICE/GENERAL ADMINISTRATIVE EXPENSES:PayPal Fees,PayPal Bank 3,$3.65 ,"$946,941.68 "
PayPal Bank 3,9/22/23,Deposit,3D615411NC328620N,04 PAYPAL GENERAL UNRESTR,"Subject: GeneralPage
Transaction ID: 3D615411NC328620N
https://www.paypal.com/activity/payment/3D615411NC328620N",PayPal Bank 3,--,$286.34 ,"$947,228.02 "
Donations directed by individuals,9/22/23,Deposit,3D615411NC328620N,04 PAYPAL GENERAL UNRESTR,Support Ukraine - Support Ukraine,Contributed income:Donations directed by individuals,PayPal Bank 3,$300.00 ,"$947,528.02 "
PayPal Fees,9/22/23,Deposit,3D615411NC328620N,04 PAYPAL GENERAL UNRESTR,PayPal fees,OFFICE/GENERAL ADMINISTRATIVE EXPENSES:PayPal Fees,PayPal Bank 3,$13.66 ,"$947,541.68 "
PayPal Bank 3,9/22/23,Deposit,9SM04788L8134264T,04 PAYPAL GENERAL UNRESTR,"Subject: GeneralPage
Transaction ID: 9SM04788L8134264T
https://www.paypal.com/activity/payment/9SM04788L8134264T",PayPal Bank 3,--,$19.68 ,"$947,561.36 "
Donations directed by individuals,9/22/23,Deposit,9SM04788L8134264T,04 PAYPAL GENERAL UNRESTR,Support Ukraine - Support Ukraine,Contributed income:Donations directed by individuals,PayPal Bank 3,$21.10 ,"$947,582.46 "
PayPal Fees,9/22/23,Deposit,9SM04788L8134264T,04 PAYPAL GENERAL UNRESTR,PayPal fees,OFFICE/GENERAL ADMINISTRATIVE EXPENSES:PayPal Fees,PayPal Bank 3,$1.42 ,"$947,583.88 "
PayPal Bank 3,9/22/23,Deposit,3VR31857FX327203W,04 PAYPAL GENERAL UNRESTR,"Subject: GeneralPage
Transaction ID: 3VR31857FX327203W
https://www.paypal.com/activity/payment/3VR31857FX327203W",PayPal Bank 3,--,$23.79 ,"$947,607.67 "
Donations directed by individuals,9/22/23,Deposit,3VR31857FX327203W,04 PAYPAL GENERAL UNRESTR,Support Ukraine - Support Ukraine,Contributed income:Donations directed by individuals,PayPal Bank 3,$25.00 ,"$947,632.67 "
PayPal Fees,9/22/23,Deposit,3VR31857FX327203W,04 PAYPAL GENERAL UNRESTR,PayPal fees,OFFICE/GENERAL ADMINISTRATIVE EXPENSES:PayPal Fees,PayPal Bank 3,$1.21 ,"$947,633.88 "
PayPal Bank 3,9/22/23,Deposit,9J065511F7745160A,04 PAYPAL GENERAL UNRESTR,"Subject: GeneralPage
Transaction ID: 9J065511F7745160A
https://www.paypal.com/activity/payment/9J065511F7745160A",PayPal Bank 3,--,$98.45 ,"$947,732.33 "
Donations directed by individuals,9/22/23,Deposit,9J065511F7745160A,04 PAYPAL GENERAL UNRESTR,Support Ukraine - Support Ukraine,Contributed income:Donations directed by individuals,PayPal Bank 3,$103.48 ,"$947,835.81 "
PayPal Fees,9/22/23,Deposit,9J065511F7745160A,04 PAYPAL GENERAL UNRESTR,PayPal fees,OFFICE/GENERAL ADMINISTRATIVE EXPENSES:PayPal Fees,PayPal Bank 3,$5.03 ,"$947,840.84 "
PayPal Bank 3,9/22/23,Deposit,89M850298K897471M,04 PAYPAL GENERAL UNRESTR,"Subject: GeneralPage
Transaction ID: 89M850298K897471M
https://www.paypal.com/activity/payment/89M850298K897471M",PayPal Bank 3,--,$96.62 ,"$947,937.46 "
Donations directed by individuals,9/22/23,Deposit,89M850298K897471M,04 PAYPAL GENERAL UNRESTR,Support Ukraine - Support Ukraine,Contributed income:Donations directed by individuals,PayPal Bank 3,$100.00 ,"$948,037.46 "
PayPal Fees,9/22/23,Deposit,89M850298K897471M,04 PAYPAL GENERAL UNRESTR,PayPal fees,OFFICE/GENERAL ADMINISTRATIVE EXPENSES:PayPal Fees,PayPal Bank 3,$3.38 ,"$948,040.84 "
PayPal Bank 3,9/22/23,Deposit,7VG756597L8435920,08 VICTORY DRONES RESTR,"Subject: VictoryDrones
Transaction ID: 7VG756597L8435920
https://www.paypal.com/activity/payment/7VG756597L8435920",PayPal Bank 3,--,$49.22 ,"$948,090.06 "
Donations directed by individuals,9/22/23,Deposit,7VG756597L8435920,08 VICTORY DRONES RESTR,VICTORY DRONES - VICTORY DRONES,Contributed income:Donations directed by individuals,PayPal Bank 3,$51.99 ,"$948,142.05 "
PayPal Fees,9/22/23,Deposit,7VG756597L8435920,08 VICTORY DRONES RESTR,PayPal fees,OFFICE/GENERAL ADMINISTRATIVE EXPENSES:PayPal Fees,PayPal Bank 3,$2.77 ,"$948,144.82 "
PayPal Bank 3,9/22/23,Deposit,38V95782FA5982300,08 VICTORY DRONES RESTR,"Subject: VictoryDrones
Transaction ID: 38V95782FA5982300
https://www.paypal.com/activity/payment/38V95782FA5982300",PayPal Bank 3,--,$98.45 ,"$948,243.27 "
Donations directed by individuals,9/22/23,Deposit,38V95782FA5982300,08 VICTORY DRONES RESTR,VICTORY DRONES - VICTORY DRONES,Contributed income:Donations directed by individuals,PayPal Bank 3,$103.48 ,"$948,346.75 "
PayPal Fees,9/22/23,Deposit,38V95782FA5982300,08 VICTORY DRONES RESTR,PayPal fees,OFFICE/GENERAL ADMINISTRATIVE EXPENSES:PayPal Fees,PayPal Bank 3,$5.03 ,"$948,351.78 "
PayPal Bank 3,9/22/23,Deposit,9AX00673K1318502G,04 PAYPAL GENERAL UNRESTR,"Subject: GeneralPage
Transaction ID: 9AX00673K1318502G
https://www.paypal.com/activity/payment/9AX00673K1318502G",PayPal Bank 3,--,$19.68 ,"$948,371.46 "
Donations directed by individuals,9/22/23,Deposit,9AX00673K1318502G,04 PAYPAL GENERAL UNRESTR,Support Ukraine - Support Ukraine,Contributed income:Donations directed by individuals,PayPal Bank 3,$21.10 ,"$948,392.56 "
PayPal Fees,9/22/23,Deposit,9AX00673K1318502G,04 PAYPAL GENERAL UNRESTR,PayPal fees,OFFICE/GENERAL ADMINISTRATIVE EXPENSES:PayPal Fees,PayPal Bank 3,$1.42 ,"$948,393.98 "
PayPal Bank 3,9/22/23,Deposit,3CR08406DR816450K,04 PAYPAL GENERAL UNRESTR,"Subject: Support Ukraine
Transaction ID: 3CR08406DR816450K
https://www.paypal.com/activity/payment/3CR08406DR816450K",PayPal Bank 3,--,$50.00 ,"$948,443.98 "
Donations directed by individuals,9/22/23,Deposit,3CR08406DR816450K,04 PAYPAL GENERAL UNRESTR,Money in to PayPal,Contributed income:Donations directed by individuals,PayPal Bank 3,$51.99 ,"$948,495.97 "
PayPal Fees,9/22/23,Deposit,3CR08406DR816450K,04 PAYPAL GENERAL UNRESTR,PayPal fees,OFFICE/GENERAL ADMINISTRATIVE EXPENSES:PayPal Fees,PayPal Bank 3,$1.99 ,"$948,497.96 "
PayPal Bank 3,9/22/23,Deposit,8ED51655T7716144C,04 PAYPAL GENERAL UNRESTR,"Subject: GeneralPage
Transaction ID: 8ED51655T7716144C
https://www.paypal.com/activity/payment/8ED51655T7716144C",PayPal Bank 3,--,$14.76 ,"$948,512.72 "
Donations directed by individuals,9/22/23,Deposit,8ED51655T7716144C,04 PAYPAL GENERAL UNRESTR,Support Ukraine - Support Ukraine,Contributed income:Donations directed by individuals,PayPal Bank 3,$15.95 ,"$948,528.67 "
PayPal Fees,9/22/23,Deposit,8ED51655T7716144C,04 PAYPAL GENERAL UNRESTR,PayPal fees,OFFICE/GENERAL ADMINISTRATIVE EXPENSES:PayPal Fees,PayPal Bank 3,$1.19 ,"$948,529.86 "
PayPal Bank 3,9/22/23,Deposit,5TY49338M5779122C,04 PAYPAL GENERAL UNRESTR,"Subject: GeneralPage
Transaction ID: 5TY49338M5779122C
https://www.paypal.com/activity/payment/5TY49338M5779122C",PayPal Bank 3,--,$9.84 ,"$948,539.70 "
Donations directed by individuals,9/22/23,Deposit,5TY49338M5779122C,04 PAYPAL GENERAL UNRESTR,Support Ukraine - Support Ukraine,Contributed income:Donations directed by individuals,PayPal Bank 3,$10.80 ,"$948,550.50 "
PayPal Fees,9/22/23,Deposit,5TY49338M5779122C,04 PAYPAL GENERAL UNRESTR,PayPal fees,OFFICE/GENERAL ADMINISTRATIVE EXPENSES:PayPal Fees,PayPal Bank 3,$0.96 ,"$948,551.46 "
PayPal Bank 3,9/22/23,Deposit,6UY42366219720415,04 PAYPAL GENERAL UNRESTR,"Subject: GeneralPage
Note: Хай пташки літають!
Transaction ID: 6UY42366219720415
https://www.paypal.com/activity/payment/6UY42366219720415",PayPal Bank 3,--,$18.63 ,"$948,570.09 "
Donations directed by individuals,9/22/23,Deposit,6UY42366219720415,04 PAYPAL GENERAL UNRESTR,Support Ukraine - Support Ukraine,Contributed income:Donations directed by individuals,PayPal Bank 3,$20.00 ,"$948,590.09 "
PayPal Fees,9/22/23,Deposit,6UY42366219720415,04 PAYPAL GENERAL UNRESTR,PayPal fees,OFFICE/GENERAL ADMINISTRATIVE EXPENSES:PayPal Fees,PayPal Bank 3,$1.37 ,"$948,591.46 "
PayPal Bank 3,9/22/23,Deposit,853452347D162280C,04 PAYPAL GENERAL UNRESTR,"Subject: GeneralPage
Transaction ID: 853452347D162280C
https://www.paypal.com/activity/payment/853452347D162280C",PayPal Bank 3,--,$49.22 ,"$948,640.68 "
Donations directed by individuals,9/22/23,Deposit,853452347D162280C,04 PAYPAL GENERAL UNRESTR,Support Ukraine - Support Ukraine,Contributed income:Donations directed by individuals,PayPal Bank 3,$51.99 ,"$948,692.67 "
PayPal Fees,9/22/23,Deposit,853452347D162280C,04 PAYPAL GENERAL UNRESTR,PayPal fees,OFFICE/GENERAL ADMINISTRATIVE EXPENSES:PayPal Fees,PayPal Bank 3,$2.77 ,"$948,695.44 "
PayPal Bank 3,9/22/23,Deposit,7B004459K71430428,04 PAYPAL GENERAL UNRESTR,"Subject: GeneralPage
Note: For drones
Transaction ID: 7B004459K71430428
https://www.paypal.com/activity/payment/7B004459K71430428",PayPal Bank 3,--,$9.07 ,"$948,704.51 "
Donations directed by individuals,9/22/23,Deposit,7B004459K71430428,04 PAYPAL GENERAL UNRESTR,Support Ukraine - Support Ukraine,Contributed income:Donations directed by individuals,PayPal Bank 3,$10.00 ,"$948,714.51 "
PayPal Fees,9/22/23,Deposit,7B004459K71430428,04 PAYPAL GENERAL UNRESTR,PayPal fees,OFFICE/GENERAL ADMINISTRATIVE EXPENSES:PayPal Fees,PayPal Bank 3,$0.93 ,"$948,715.44 "
PayPal Bank 3,9/22/23,Deposit,87U90035DD569521H,04 PAYPAL GENERAL UNRESTR,"Subject: GeneralPage
Transaction ID: 87U90035DD569521H
https://www.paypal.com/activity/payment/87U90035DD569521H",PayPal Bank 3,--,$95.12 ,"$948,810.56 "
Donations directed by individuals,9/22/23,Deposit,87U90035DD569521H,04 PAYPAL GENERAL UNRESTR,Support Ukraine - Support Ukraine,Contributed income:Donations directed by individuals,PayPal Bank 3,$100.00 ,"$948,910.56 "
PayPal Fees,9/22/23,Deposit,87U90035DD569521H,04 PAYPAL GENERAL UNRESTR,PayPal fees,OFFICE/GENERAL ADMINISTRATIVE EXPENSES:PayPal Fees,PayPal Bank 3,$4.88 ,"$948,915.44 "
PayPal Bank 3,9/22/23,Deposit,97145798B2760835A,04 PAYPAL GENERAL UNRESTR,"Subject: GeneralPage
Transaction ID: 97145798B2760835A
https://www.paypal.com/activity/payment/97145798B2760835A",PayPal Bank 3,--,$18.76 ,"$948,934.20 "
Donations directed by individuals,9/22/23,Deposit,97145798B2760835A,04 PAYPAL GENERAL UNRESTR,Support Ukraine - Support Ukraine,Contributed income:Donations directed by individuals,PayPal Bank 3,$20.13 ,"$948,954.33 "
PayPal Fees,9/22/23,Deposit,97145798B2760835A,04 PAYPAL GENERAL UNRESTR,PayPal fees,OFFICE/GENERAL ADMINISTRATIVE EXPENSES:PayPal Fees,PayPal Bank 3,$1.37 ,"$948,955.70 "
PayPal Bank 3,9/22/23,Deposit,2PP205596H2017815,04 PAYPAL GENERAL UNRESTR,"Subject: GeneralPage
Transaction ID: 2PP205596H2017815
https://www.paypal.com/activity/payment/2PP205596H2017815",PayPal Bank 3,--,$98.45 ,"$949,054.15 "
Donations directed by individuals,9/22/23,Deposit,2PP205596H2017815,04 PAYPAL GENERAL UNRESTR,Support Ukraine - Support Ukraine,Contributed income:Donations directed by individuals,PayPal Bank 3,$103.48 ,"$949,157.63 "
PayPal Fees,9/22/23,Deposit,2PP205596H2017815,04 PAYPAL GENERAL UNRESTR,PayPal fees,OFFICE/GENERAL ADMINISTRATIVE EXPENSES:PayPal Fees,PayPal Bank 3,$5.03 ,"$949,162.66 "
PayPal Bank 3,9/22/23,Deposit,5SJ16692JX3980733,04 PAYPAL GENERAL UNRESTR,"Subject: GeneralPage
Transaction ID: 5SJ16692JX3980733
https://www.paypal.com/activity/payment/5SJ16692JX3980733",PayPal Bank 3,--,$95.12 ,"$949,257.78 "
Donations directed by individuals,9/22/23,Deposit,5SJ16692JX3980733,04 PAYPAL GENERAL UNRESTR,Support Ukraine - Support Ukraine,Contributed income:Donations directed by individuals,PayPal Bank 3,$100.00 ,"$949,357.78 "
PayPal Fees,9/22/23,Deposit,5SJ16692JX3980733,04 PAYPAL GENERAL UNRESTR,PayPal fees,OFFICE/GENERAL ADMINISTRATIVE EXPENSES:PayPal Fees,PayPal Bank 3,$4.88 ,"$949,362.66 "
PayPal Bank 3,9/22/23,Deposit,414303331B325381E,04 PAYPAL GENERAL UNRESTR,"Subject: GeneralPage
Transaction ID: 414303331B325381E
https://www.paypal.com/activity/payment/414303331B325381E",PayPal Bank 3,--,$49.22 ,"$949,411.88 "
Donations directed by individuals,9/22/23,Deposit,414303331B325381E,04 PAYPAL GENERAL UNRESTR,Support Ukraine - Support Ukraine,Contributed income:Donations directed by individuals,PayPal Bank 3,$51.99 ,"$949,463.87 "
PayPal Fees,9/22/23,Deposit,414303331B325381E,04 PAYPAL GENERAL UNRESTR,PayPal fees,OFFICE/GENERAL ADMINISTRATIVE EXPENSES:PayPal Fees,PayPal Bank 3,$2.77 ,"$949,466.64 "
PayPal Bank 3,9/22/23,Deposit,56912678J0340682A,04 PAYPAL GENERAL UNRESTR,"Subject: GeneralPage
Transaction ID: 56912678J0340682A
https://www.paypal.com/activity/payment/56912678J0340682A",PayPal Bank 3,--,$29.53 ,"$949,496.17 "
Donations directed by individuals,9/22/23,Deposit,56912678J0340682A,04 PAYPAL GENERAL UNRESTR,Support Ukraine - Support Ukraine,Contributed income:Donations directed by individuals,PayPal Bank 3,$31.40 ,"$949,527.57 "
PayPal Fees,9/22/23,Deposit,56912678J0340682A,04 PAYPAL GENERAL UNRESTR,PayPal fees,OFFICE/GENERAL ADMINISTRATIVE EXPENSES:PayPal Fees,PayPal Bank 3,$1.87 ,"$949,529.44 "
PayPal Bank 3,9/22/23,Deposit,8AU693557U5823319,04 PAYPAL GENERAL UNRESTR,"Subject: GeneralPage
Transaction ID: 8AU693557U5823319
https://www.paypal.com/activity/payment/8AU693557U5823319",PayPal Bank 3,--,$23.41 ,"$949,552.85 "
Donations directed by individuals,9/22/23,Deposit,8AU693557U5823319,04 PAYPAL GENERAL UNRESTR,Support Ukraine - Support Ukraine,Contributed income:Donations directed by individuals,PayPal Bank 3,$25.00 ,"$949,577.85 "
PayPal Fees,9/22/23,Deposit,8AU693557U5823319,04 PAYPAL GENERAL UNRESTR,PayPal fees,OFFICE/GENERAL ADMINISTRATIVE EXPENSES:PayPal Fees,PayPal Bank 3,$1.59 ,"$949,579.44 "
PayPal Bank 3,9/22/23,Deposit,1PU57320VG757193X,04 PAYPAL GENERAL UNRESTR,"Subject: GeneralPage
Transaction ID: 1PU57320VG757193X
https://www.paypal.com/activity/payment/1PU57320VG757193X",PayPal Bank 3,--,$193.73 ,"$949,773.17 "
Donations directed by individuals,9/22/23,Deposit,1PU57320VG757193X,04 PAYPAL GENERAL UNRESTR,Support Ukraine - Support Ukraine,Contributed income:Donations directed by individuals,PayPal Bank 3,$200.00 ,"$949,973.17 "
PayPal Fees,9/22/23,Deposit,1PU57320VG757193X,04 PAYPAL GENERAL UNRESTR,PayPal fees,OFFICE/GENERAL ADMINISTRATIVE EXPENSES:PayPal Fees,PayPal Bank 3,$6.27 ,"$949,979.44 "
PayPal Bank 3,9/22/23,Deposit,9HF07209AB748654D,04 PAYPAL GENERAL UNRESTR,"Subject: GeneralPage
Transaction ID: 9HF07209AB748654D
https://www.paypal.com/activity/payment/9HF07209AB748654D",PayPal Bank 3,--,$13.85 ,"$949,993.29 "
Donations directed by individuals,9/22/23,Deposit,9HF07209AB748654D,04 PAYPAL GENERAL UNRESTR,Support Ukraine - Support Ukraine,Contributed income:Donations directed by individuals,PayPal Bank 3,$15.00 ,"$950,008.29 "
PayPal Fees,9/22/23,Deposit,9HF07209AB748654D,04 PAYPAL GENERAL UNRESTR,PayPal fees,OFFICE/GENERAL ADMINISTRATIVE EXPENSES:PayPal Fees,PayPal Bank 3,$1.15 ,"$950,009.44 "
PayPal Bank 3,9/22/23,Deposit,3UE288781G148082U,08 VICTORY DRONES RESTR,"Subject: VictoryDrones
Note: На люті пташки! Дякую за працю!
Transaction ID: 3UE288781G148082U
https://www.paypal.com/activity/payment/3UE288781G148082U",PayPal Bank 3,--,$95.12 ,"$950,104.56 "
Donations directed by individuals,9/22/23,Deposit,3UE288781G148082U,08 VICTORY DRONES RESTR,VICTORY DRONES - VICTORY DRONES,Contributed income:Donations directed by individuals,PayPal Bank 3,$100.00 ,"$950,204.56 "
PayPal Fees,9/22/23,Deposit,3UE288781G148082U,08 VICTORY DRONES RESTR,PayPal fees,OFFICE/GENERAL ADMINISTRATIVE EXPENSES:PayPal Fees,PayPal Bank 3,$4.88 ,"$950,209.44 "
PayPal Bank 3,9/22/23,Deposit,3MC108999N613834D,04 PAYPAL GENERAL UNRESTR,"Subject: GeneralPage
Transaction ID: 3MC108999N613834D
https://www.paypal.com/activity/payment/3MC108999N613834D",PayPal Bank 3,--,$95.12 ,"$950,304.56 "
Donations directed by individuals,9/22/23,Deposit,3MC108999N613834D,04 PAYPAL GENERAL UNRESTR,Support Ukraine - Support Ukraine,Contributed income:Donations directed by individuals,PayPal Bank 3,$100.00 ,"$950,404.56 "
PayPal Fees,9/22/23,Deposit,3MC108999N613834D,04 PAYPAL GENERAL UNRESTR,PayPal fees,OFFICE/GENERAL ADMINISTRATIVE EXPENSES:PayPal Fees,PayPal Bank 3,$4.88 ,"$950,409.44 "
PayPal Bank 3,9/22/23,Deposit,46P43942CU036045U,04 PAYPAL GENERAL UNRESTR,"Subject: GeneralPage
Transaction ID: 46P43942CU036045U
https://www.paypal.com/activity/payment/46P43942CU036045U",PayPal Bank 3,--,$10.00 ,"$950,419.44 "
Donations directed by individuals,9/22/23,Deposit,46P43942CU036045U,04 PAYPAL GENERAL UNRESTR,Support Ukraine - Support Ukraine,Contributed income:Donations directed by individuals,PayPal Bank 3,$10.80 ,"$950,430.24 "
PayPal Fees,9/22/23,Deposit,46P43942CU036045U,04 PAYPAL GENERAL UNRESTR,PayPal fees,OFFICE/GENERAL ADMINISTRATIVE EXPENSES:PayPal Fees,PayPal Bank 3,$0.80 ,"$950,431.04 "
PayPal Bank 3,9/22/23,Deposit,90K96459BH218545B,04 PAYPAL GENERAL UNRESTR,"Subject: Support Ukraine
Transaction ID: 90K96459BH218545B
https://www.paypal.com/activity/payment/90K96459BH218545B",PayPal Bank 3,--,$190.73 ,"$950,621.77 "
Donations directed by individuals,9/22/23,Deposit,90K96459BH218545B,04 PAYPAL GENERAL UNRESTR,Money in to PayPal,Contributed income:Donations directed by individuals,PayPal Bank 3,$200.00 ,"$950,821.77 "
PayPal Fees,9/22/23,Deposit,90K96459BH218545B,04 PAYPAL GENERAL UNRESTR,PayPal fees,OFFICE/GENERAL ADMINISTRATIVE EXPENSES:PayPal Fees,PayPal Bank 3,$9.27 ,"$950,831.04 "
PayPal Bank 3,9/22/23,Deposit,72T026395J0754219,04 PAYPAL GENERAL UNRESTR,"Subject: GeneralPage
Note: На пташечки
Transaction ID: 72T026395J0754219
https://www.paypal.com/activity/payment/72T026395J0754219",PayPal Bank 3,--,$50.00 ,"$950,881.04 "
Donations directed by individuals,9/22/23,Deposit,72T026395J0754219,04 PAYPAL GENERAL UNRESTR,Support Ukraine - Support Ukraine,Contributed income:Donations directed by individuals,PayPal Bank 3,$51.99 ,"$950,933.03 "
PayPal Fees,9/22/23,Deposit,72T026395J0754219,04 PAYPAL GENERAL UNRESTR,PayPal fees,OFFICE/GENERAL ADMINISTRATIVE EXPENSES:PayPal Fees,PayPal Bank 3,$1.99 ,"$950,935.02 "
PayPal Bank 3,9/22/23,Deposit,6PH47666TJ3417207,04 PAYPAL GENERAL UNRESTR,"Subject: GeneralPage
Transaction ID: 6PH47666TJ3417207
https://www.paypal.com/activity/payment/6PH47666TJ3417207",PayPal Bank 3,--,$50.00 ,"$950,985.02 "
Donations directed by individuals,9/22/23,Deposit,6PH47666TJ3417207,04 PAYPAL GENERAL UNRESTR,Support Ukraine - Support Ukraine,Contributed income:Donations directed by individuals,PayPal Bank 3,$51.99 ,"$951,037.01 "
PayPal Fees,9/22/23,Deposit,6PH47666TJ3417207,04 PAYPAL GENERAL UNRESTR,PayPal fees,OFFICE/GENERAL ADMINISTRATIVE EXPENSES:PayPal Fees,PayPal Bank 3,$1.99 ,"$951,039.00 "
PayPal Bank 3,9/22/23,Deposit,2KA19732R7523321V,04 PAYPAL GENERAL UNRESTR,"Subject: GeneralPage
Transaction ID: 2KA19732R7523321V
https://www.paypal.com/activity/payment/2KA19732R7523321V",PayPal Bank 3,--,$96.62 ,"$951,135.62 "
Donations directed by individuals,9/22/23,Deposit,2KA19732R7523321V,04 PAYPAL GENERAL UNRESTR,Support Ukraine - Support Ukraine,Contributed income:Donations directed by individuals,PayPal Bank 3,$100.00 ,"$951,235.62 "
PayPal Fees,9/22/23,Deposit,2KA19732R7523321V,04 PAYPAL GENERAL UNRESTR,PayPal fees,OFFICE/GENERAL ADMINISTRATIVE EXPENSES:PayPal Fees,PayPal Bank 3,$3.38 ,"$951,239.00 "
PayPal Bank 3,9/22/23,Deposit,5DB37045AL169863W,04 PAYPAL GENERAL UNRESTR,"Subject: GeneralPage
Note: Help for Ukraine - drones or radio
Transaction ID: 5DB37045AL169863W
https://www.paypal.com/activity/payment/5DB37045AL169863W",PayPal Bank 3,--,$95.12 ,"$951,334.12 "
Donations directed by individuals,9/22/23,Deposit,5DB37045AL169863W,04 PAYPAL GENERAL UNRESTR,Support Ukraine - Support Ukraine,Contributed income:Donations directed by individuals,PayPal Bank 3,$100.00 ,"$951,434.12 "
PayPal Fees,9/22/23,Deposit,5DB37045AL169863W,04 PAYPAL GENERAL UNRESTR,PayPal fees,OFFICE/GENERAL ADMINISTRATIVE EXPENSES:PayPal Fees,PayPal Bank 3,$4.88 ,"$951,439.00 "
PayPal Bank 3,9/22/23,Deposit,58A88861VY7752320,04 PAYPAL GENERAL UNRESTR,"Subject: GeneralPage
Transaction ID: 58A88861VY7752320
https://www.paypal.com/activity/payment/58A88861VY7752320",PayPal Bank 3,--,$9.84 ,"$951,448.84 "
Donations directed by individuals,9/22/23,Deposit,58A88861VY7752320,04 PAYPAL GENERAL UNRESTR,Support Ukraine - Support Ukraine,Contributed income:Donations directed by individuals,PayPal Bank 3,$10.80 ,"$951,459.64 "
PayPal Fees,9/22/23,Deposit,58A88861VY7752320,04 PAYPAL GENERAL UNRESTR,PayPal fees,OFFICE/GENERAL ADMINISTRATIVE EXPENSES:PayPal Fees,PayPal Bank 3,$0.96 ,"$951,460.60 "
PayPal Bank 3,9/22/23,Deposit,9F6850864E080283U,04 PAYPAL GENERAL UNRESTR,"Subject: GeneralPage
Note: Slava Ukraine ❤️
Transaction ID: 9F6850864E080283U
https://www.paypal.com/activity/payment/9F6850864E080283U",PayPal Bank 3,--,$18.93 ,"$951,479.53 "
Donations directed by individuals,9/22/23,Deposit,9F6850864E080283U,04 PAYPAL GENERAL UNRESTR,Support Ukraine - Support Ukraine,Contributed income:Donations directed by individuals,PayPal Bank 3,$20.00 ,"$951,499.53 "
PayPal Fees,9/22/23,Deposit,9F6850864E080283U,04 PAYPAL GENERAL UNRESTR,PayPal fees,OFFICE/GENERAL ADMINISTRATIVE EXPENSES:PayPal Fees,PayPal Bank 3,$1.07 ,"$951,500.60 "
PayPal Bank 3,9/22/23,Deposit,70E00914XW750962K,04 PAYPAL GENERAL UNRESTR,"Subject: GeneralPage
Transaction ID: 70E00914XW750962K
https://www.paypal.com/activity/payment/70E00914XW750962K",PayPal Bank 3,--,$24.61 ,"$951,525.21 "
Donations directed by individuals,9/22/23,Deposit,70E00914XW750962K,04 PAYPAL GENERAL UNRESTR,Support Ukraine - Support Ukraine,Contributed income:Donations directed by individuals,PayPal Bank 3,$26.25 ,"$951,551.46 "
PayPal Fees,9/22/23,Deposit,70E00914XW750962K,04 PAYPAL GENERAL UNRESTR,PayPal fees,OFFICE/GENERAL ADMINISTRATIVE EXPENSES:PayPal Fees,PayPal Bank 3,$1.64 ,"$951,553.10 "
PayPal Bank 3,9/22/23,Deposit,5M177173B1671941H,04 PAYPAL GENERAL UNRESTR,"Subject: GeneralPage
Transaction ID: 5M177173B1671941H
https://www.paypal.com/activity/payment/5M177173B1671941H",PayPal Bank 3,--,$13.85 ,"$951,566.95 "
Donations directed by individuals,9/22/23,Deposit,5M177173B1671941H,04 PAYPAL GENERAL UNRESTR,Support Ukraine - Support Ukraine,Contributed income:Donations directed by individuals,PayPal Bank 3,$15.00 ,"$951,581.95 "
PayPal Fees,9/22/23,Deposit,5M177173B1671941H,04 PAYPAL GENERAL UNRESTR,PayPal fees,OFFICE/GENERAL ADMINISTRATIVE EXPENSES:PayPal Fees,PayPal Bank 3,$1.15 ,"$951,583.10 "
PayPal Bank 3,9/22/23,Deposit,4RV58857WK9494144,04 PAYPAL GENERAL UNRESTR,"Subject: GeneralPage
Transaction ID: 4RV58857WK9494144
https://www.paypal.com/activity/payment/4RV58857WK9494144",PayPal Bank 3,--,$24.61 ,"$951,607.71 "
Donations directed by individuals,9/22/23,Deposit,4RV58857WK9494144,04 PAYPAL GENERAL UNRESTR,Support Ukraine - Support Ukraine,Contributed income:Donations directed by individuals,PayPal Bank 3,$26.25 ,"$951,633.96 "
PayPal Fees,9/22/23,Deposit,4RV58857WK9494144,04 PAYPAL GENERAL UNRESTR,PayPal fees,OFFICE/GENERAL ADMINISTRATIVE EXPENSES:PayPal Fees,PayPal Bank 3,$1.64 ,"$951,635.60 "
PayPal Bank 3,9/22/23,Deposit,9ND56190CP450130E,04 PAYPAL GENERAL UNRESTR,"Subject: GeneralPage
Transaction ID: 9ND56190CP450130E
https://www.paypal.com/activity/payment/9ND56190CP450130E",PayPal Bank 3,--,$47.31 ,"$951,682.91 "
Donations directed by individuals,9/22/23,Deposit,9ND56190CP450130E,04 PAYPAL GENERAL UNRESTR,Support Ukraine - Support Ukraine,Contributed income:Donations directed by individuals,PayPal Bank 3,$50.00 ,"$951,732.91 "
PayPal Fees,9/22/23,Deposit,9ND56190CP450130E,04 PAYPAL GENERAL UNRESTR,PayPal fees,OFFICE/GENERAL ADMINISTRATIVE EXPENSES:PayPal Fees,PayPal Bank 3,$2.69 ,"$951,735.60 "
PayPal Bank 3,9/22/23,Deposit,0LL03304GU8545620,04 PAYPAL GENERAL UNRESTR,"Subject: Support Ukraine
Transaction ID: 0LL03304GU8545620
https://www.paypal.com/activity/payment/0LL03304GU8545620",PayPal Bank 3,--,$18.63 ,"$951,754.23 "
Donations directed by individuals,9/22/23,Deposit,0LL03304GU8545620,04 PAYPAL GENERAL UNRESTR,Money in to PayPal,Contributed income:Donations directed by individuals,PayPal Bank 3,$20.00 ,"$951,774.23 "
PayPal Fees,9/22/23,Deposit,0LL03304GU8545620,04 PAYPAL GENERAL UNRESTR,PayPal fees,OFFICE/GENERAL ADMINISTRATIVE EXPENSES:PayPal Fees,PayPal Bank 3,$1.37 ,"$951,775.60 "
PayPal Bank 3,9/22/23,Deposit,2EA43382GT479102T,04 PAYPAL GENERAL UNRESTR,"Subject: GeneralPage
Transaction ID: 2EA43382GT479102T
https://www.paypal.com/activity/payment/2EA43382GT479102T",PayPal Bank 3,--,$246.13 ,"$952,021.73 "
Donations directed by individuals,9/22/23,Deposit,2EA43382GT479102T,04 PAYPAL GENERAL UNRESTR,Support Ukraine - Support Ukraine,Contributed income:Donations directed by individuals,PayPal Bank 3,$257.94 ,"$952,279.67 "
PayPal Fees,9/22/23,Deposit,2EA43382GT479102T,04 PAYPAL GENERAL UNRESTR,PayPal fees,OFFICE/GENERAL ADMINISTRATIVE EXPENSES:PayPal Fees,PayPal Bank 3,$11.81 ,"$952,291.48 "
PayPal Bank 3,9/22/23,Deposit,8SA8264220360823G,04 PAYPAL GENERAL UNRESTR,"Subject: GeneralPage
Transaction ID: 8SA8264220360823G
https://www.paypal.com/activity/payment/8SA8264220360823G",PayPal Bank 3,--,$95.12 ,"$952,386.60 "
Donations directed by individuals,9/22/23,Deposit,8SA8264220360823G,04 PAYPAL GENERAL UNRESTR,Support Ukraine - Support Ukraine,Contributed income:Donations directed by individuals,PayPal Bank 3,$100.00 ,"$952,486.60 "
PayPal Fees,9/22/23,Deposit,8SA8264220360823G,04 PAYPAL GENERAL UNRESTR,PayPal fees,OFFICE/GENERAL ADMINISTRATIVE EXPENSES:PayPal Fees,PayPal Bank 3,$4.88 ,"$952,491.48 "
PayPal Bank 3,9/22/23,Deposit,87L899984U9956309,04 PAYPAL GENERAL UNRESTR,"Subject: GeneralPage
Transaction ID: 87L899984U9956309
https://www.paypal.com/activity/payment/87L899984U9956309",PayPal Bank 3,--,$9.07 ,"$952,500.55 "
Donations directed by individuals,9/22/23,Deposit,87L899984U9956309,04 PAYPAL GENERAL UNRESTR,Support Ukraine - Support Ukraine,Contributed income:Donations directed by individuals,PayPal Bank 3,$10.00 ,"$952,510.55 "
PayPal Fees,9/22/23,Deposit,87L899984U9956309,04 PAYPAL GENERAL UNRESTR,PayPal fees,OFFICE/GENERAL ADMINISTRATIVE EXPENSES:PayPal Fees,PayPal Bank 3,$0.93 ,"$952,511.48 "
PayPal Bank 3,9/22/23,Deposit,3EE149827L948903F,04 PAYPAL GENERAL UNRESTR,"Subject: Support Ukraine
Transaction ID: 3EE149827L948903F
https://www.paypal.com/activity/payment/3EE149827L948903F",PayPal Bank 3,--,$47.31 ,"$952,558.79 "
Donations directed by individuals,9/22/23,Deposit,3EE149827L948903F,04 PAYPAL GENERAL UNRESTR,Money in to PayPal,Contributed income:Donations directed by individuals,PayPal Bank 3,$50.00 ,"$952,608.79 "
PayPal Fees,9/22/23,Deposit,3EE149827L948903F,04 PAYPAL GENERAL UNRESTR,PayPal fees,OFFICE/GENERAL ADMINISTRATIVE EXPENSES:PayPal Fees,PayPal Bank 3,$2.69 ,"$952,611.48 "
PayPal Bank 3,9/22/23,Deposit,3MH71497NY926132G,04 PAYPAL GENERAL UNRESTR,"Subject: GeneralPage
Transaction ID: 3MH71497NY926132G
https://www.paypal.com/activity/payment/3MH71497NY926132G",PayPal Bank 3,--,$193.73 ,"$952,805.21 "
Donations directed by individuals,9/22/23,Deposit,3MH71497NY926132G,04 PAYPAL GENERAL UNRESTR,Support Ukraine - Support Ukraine,Contributed income:Donations directed by individuals,PayPal Bank 3,$200.00 ,"$953,005.21 "
PayPal Fees,9/22/23,Deposit,3MH71497NY926132G,04 PAYPAL GENERAL UNRESTR,PayPal fees,OFFICE/GENERAL ADMINISTRATIVE EXPENSES:PayPal Fees,PayPal Bank 3,$6.27 ,"$953,011.48 "
PayPal Bank 3,9/22/23,Deposit,3Y275421TU271090K,09 MSU RESTR,"Subject: MobileShowers
Transaction ID: 3Y275421TU271090K
https://www.paypal.com/activity/payment/3Y275421TU271090K",PayPal Bank 3,--,$100.00 ,"$953,111.48 "
Donations directed by individuals,9/22/23,Deposit,3Y275421TU271090K,09 MSU RESTR,Mobile Shower/Laundry Units - Mobile Shower/Laundry Units,Contributed income:Donations directed by individuals,PayPal Bank 3,$103.48 ,"$953,214.96 "
PayPal Fees,9/22/23,Deposit,3Y275421TU271090K,09 MSU RESTR,PayPal fees,OFFICE/GENERAL ADMINISTRATIVE EXPENSES:PayPal Fees,PayPal Bank 3,$3.48 ,"$953,218.44 "
PayPal Bank 3,9/22/23,Deposit,933013636F959612X,04 PAYPAL GENERAL UNRESTR,"Subject: Support Ukraine
Transaction ID: 933013636F959612X
https://www.paypal.com/activity/payment/933013636F959612X",PayPal Bank 3,--,$23.41 ,"$953,241.85 "
Donations directed by individuals,9/22/23,Deposit,933013636F959612X,04 PAYPAL GENERAL UNRESTR,Money in to PayPal,Contributed income:Donations directed by individuals,PayPal Bank 3,$25.00 ,"$953,266.85 "
PayPal Fees,9/22/23,Deposit,933013636F959612X,04 PAYPAL GENERAL UNRESTR,PayPal fees,OFFICE/GENERAL ADMINISTRATIVE EXPENSES:PayPal Fees,PayPal Bank 3,$1.59 ,"$953,268.44 "
PayPal Bank 3,9/22/23,Deposit,4YG83299GG0176530,09 MSU RESTR,"Subject: GeneralPage
Transaction ID: 4YG83299GG0176530
https://www.paypal.com/activity/payment/4YG83299GG0176530",PayPal Bank 3,--,$48.06 ,"$953,316.50 "
Donations directed by individuals,9/22/23,Deposit,4YG83299GG0176530,09 MSU RESTR,Support Ukraine - Support Ukraine,Contributed income:Donations directed by individuals,PayPal Bank 3,$50.00 ,"$953,366.50 "
PayPal Fees,9/22/23,Deposit,4YG83299GG0176530,09 MSU RESTR,PayPal fees,OFFICE/GENERAL ADMINISTRATIVE EXPENSES:PayPal Fees,PayPal Bank 3,$1.94 ,"$953,368.44 "
PayPal Bank 3,9/22/23,Deposit,38N23025HS018782L,04 PAYPAL GENERAL UNRESTR,"Subject: GeneralPage
Note: Слава Україні!
Transaction ID: 38N23025HS018782L
https://www.paypal.com/activity/payment/38N23025HS018782L",PayPal Bank 3,--,$50.00 ,"$953,418.44 "
Donations directed by individuals,9/22/23,Deposit,38N23025HS018782L,04 PAYPAL GENERAL UNRESTR,Support Ukraine - Support Ukraine,Contributed income:Donations directed by individuals,PayPal Bank 3,$51.99 ,"$953,470.43 "
PayPal Fees,9/22/23,Deposit,38N23025HS018782L,04 PAYPAL GENERAL UNRESTR,PayPal fees,OFFICE/GENERAL ADMINISTRATIVE EXPENSES:PayPal Fees,PayPal Bank 3,$1.99 ,"$953,472.42 "
PayPal Bank 3,9/22/23,Deposit,43X98245N2932501D,04 PAYPAL GENERAL UNRESTR,"Subject: Support Ukraine
Transaction ID: 43X98245N2932501D
https://www.paypal.com/activity/payment/43X98245N2932501D",PayPal Bank 3,--,$4.91 ,"$953,477.33 "
Donations directed by individuals,9/22/23,Deposit,43X98245N2932501D,04 PAYPAL GENERAL UNRESTR,Money in to PayPal,Contributed income:Donations directed by individuals,PayPal Bank 3,$5.65 ,"$953,482.98 "
PayPal Fees,9/22/23,Deposit,43X98245N2932501D,04 PAYPAL GENERAL UNRESTR,PayPal fees,OFFICE/GENERAL ADMINISTRATIVE EXPENSES:PayPal Fees,PayPal Bank 3,$0.74 ,"$953,483.72 "
PayPal Bank 3,9/22/23,Deposit,23R43660FN024563C,04 PAYPAL GENERAL UNRESTR,"Subject: GeneralPage
Transaction ID: 23R43660FN024563C
https://www.paypal.com/activity/payment/23R43660FN024563C",PayPal Bank 3,--,$49.22 ,"$953,532.94 "
Donations directed by individuals,9/22/23,Deposit,23R43660FN024563C,04 PAYPAL GENERAL UNRESTR,Support Ukraine - Support Ukraine,Contributed income:Donations directed by individuals,PayPal Bank 3,$51.99 ,"$953,584.93 "
PayPal Fees,9/22/23,Deposit,23R43660FN024563C,04 PAYPAL GENERAL UNRESTR,PayPal fees,OFFICE/GENERAL ADMINISTRATIVE EXPENSES:PayPal Fees,PayPal Bank 3,$2.77 ,"$953,587.70 "
PayPal Bank 3,9/22/23,Deposit,3VK61968UR1073010,04 PAYPAL GENERAL UNRESTR,"Subject: GeneralPage
Transaction ID: 3VK61968UR1073010
https://www.paypal.com/activity/payment/3VK61968UR1073010",PayPal Bank 3,--,$190.73 ,"$953,778.43 "
Donations directed by individuals,9/22/23,Deposit,3VK61968UR1073010,04 PAYPAL GENERAL UNRESTR,Support Ukraine - Support Ukraine,Contributed income:Donations directed by individuals,PayPal Bank 3,$200.00 ,"$953,978.43 "
PayPal Fees,9/22/23,Deposit,3VK61968UR1073010,04 PAYPAL GENERAL UNRESTR,PayPal fees,OFFICE/GENERAL ADMINISTRATIVE EXPENSES:PayPal Fees,PayPal Bank 3,$9.27 ,"$953,987.70 "
PayPal Bank 3,9/22/23,Deposit,1A210650DX088314C,07 1000 DRONES RESTR,"Subject: 1000DRONES
Transaction ID: 1A210650DX088314C
https://www.paypal.com/activity/payment/1A210650DX088314C",PayPal Bank 3,--,$50.00 ,"$954,037.70 "
Donations directed by individuals,9/22/23,Deposit,1A210650DX088314C,07 1000 DRONES RESTR,1000 DRONES FOR UKRAINE - 1000 DRONES FOR UKRAINE,Contributed income:Donations directed by individuals,PayPal Bank 3,$51.99 ,"$954,089.69 "
PayPal Fees,9/22/23,Deposit,1A210650DX088314C,07 1000 DRONES RESTR,PayPal fees,OFFICE/GENERAL ADMINISTRATIVE EXPENSES:PayPal Fees,PayPal Bank 3,$1.99 ,"$954,091.68 "
PayPal Bank 3,9/22/23,Deposit,4TJ49546GW744433W,04 PAYPAL GENERAL UNRESTR,"Subject: GeneralPage
Transaction ID: 4TJ49546GW744433W
https://www.paypal.com/activity/payment/4TJ49546GW744433W",PayPal Bank 3,--,$104.68 ,"$954,196.36 "
Donations directed by individuals,9/22/23,Deposit,4TJ49546GW744433W,04 PAYPAL GENERAL UNRESTR,Support Ukraine - Support Ukraine,Contributed income:Donations directed by individuals,PayPal Bank 3,$110.00 ,"$954,306.36 "
PayPal Fees,9/22/23,Deposit,4TJ49546GW744433W,04 PAYPAL GENERAL UNRESTR,PayPal fees,OFFICE/GENERAL ADMINISTRATIVE EXPENSES:PayPal Fees,PayPal Bank 3,$5.32 ,"$954,311.68 "
PayPal Bank 3,9/22/23,Deposit,3R024815SV016750A,07 1000 DRONES RESTR,"Subject: 1000DRONES
Transaction ID: 3R024815SV016750A
https://www.paypal.com/activity/payment/3R024815SV016750A",PayPal Bank 3,--,$485.06 ,"$954,796.74 "
Donations directed by individuals,9/22/23,Deposit,3R024815SV016750A,07 1000 DRONES RESTR,1000 DRONES FOR UKRAINE - 1000 DRONES FOR UKRAINE,Contributed income:Donations directed by individuals,PayPal Bank 3,$500.00 ,"$955,296.74 "
PayPal Fees,9/22/23,Deposit,3R024815SV016750A,07 1000 DRONES RESTR,PayPal fees,OFFICE/GENERAL ADMINISTRATIVE EXPENSES:PayPal Fees,PayPal Bank 3,$14.94 ,"$955,311.68 "
PayPal Bank 3,9/22/23,Deposit,8YG70447UN707292J,04 PAYPAL GENERAL UNRESTR,"Subject: GeneralPage
Transaction ID: 8YG70447UN707292J
https://www.paypal.com/activity/payment/8YG70447UN707292J",PayPal Bank 3,--,$98.45 ,"$955,410.13 "
Donations directed by individuals,9/22/23,Deposit,8YG70447UN707292J,04 PAYPAL GENERAL UNRESTR,Support Ukraine - Support Ukraine,Contributed income:Donations directed by individuals,PayPal Bank 3,$103.48 ,"$955,513.61 "
PayPal Fees,9/22/23,Deposit,8YG70447UN707292J,04 PAYPAL GENERAL UNRESTR,PayPal fees,OFFICE/GENERAL ADMINISTRATIVE EXPENSES:PayPal Fees,PayPal Bank 3,$5.03 ,"$955,518.64 "
PayPal Bank 3,9/22/23,Deposit,94S80313GK159122L,07 1000 DRONES RESTR,"Subject: 1000DRONES
Transaction ID: 94S80313GK159122L
https://www.paypal.com/activity/payment/94S80313GK159122L",PayPal Bank 3,--,$30.00 ,"$955,548.64 "
Donations directed by individuals,9/22/23,Deposit,94S80313GK159122L,07 1000 DRONES RESTR,1000 DRONES FOR UKRAINE - 1000 DRONES FOR UKRAINE,Contributed income:Donations directed by individuals,PayPal Bank 3,$31.40 ,"$955,580.04 "
PayPal Fees,9/22/23,Deposit,94S80313GK159122L,07 1000 DRONES RESTR,PayPal fees,OFFICE/GENERAL ADMINISTRATIVE EXPENSES:PayPal Fees,PayPal Bank 3,$1.40 ,"$955,581.44 "
PayPal Bank 3,9/22/23,Deposit,5TP56504HG723925L,04 PAYPAL GENERAL UNRESTR,"Subject: GeneralPage
Note: На розйоб русні
Transaction ID: 5TP56504HG723925L
https://www.paypal.com/activity/payment/5TP56504HG723925L",PayPal Bank 3,--,$1.96 ,"$955,583.40 "
Donations directed by individuals,9/22/23,Deposit,5TP56504HG723925L,04 PAYPAL GENERAL UNRESTR,Support Ukraine - Support Ukraine,Contributed income:Donations directed by individuals,PayPal Bank 3,$2.56 ,"$955,585.96 "
PayPal Fees,9/22/23,Deposit,5TP56504HG723925L,04 PAYPAL GENERAL UNRESTR,PayPal fees,OFFICE/GENERAL ADMINISTRATIVE EXPENSES:PayPal Fees,PayPal Bank 3,$0.60 ,"$955,586.56 "
PayPal Bank 3,9/22/23,Deposit,1P586973JW076711V,04 PAYPAL GENERAL UNRESTR,"Subject: Support Ukraine
Transaction ID: 1P586973JW076711V
https://www.paypal.com/activity/payment/1P586973JW076711V",PayPal Bank 3,--,$50.00 ,"$955,636.56 "
Donations directed by individuals,9/22/23,Deposit,1P586973JW076711V,04 PAYPAL GENERAL UNRESTR,Money in to PayPal,Contributed income:Donations directed by individuals,PayPal Bank 3,$51.99 ,"$955,688.55 "
PayPal Fees,9/22/23,Deposit,1P586973JW076711V,04 PAYPAL GENERAL UNRESTR,PayPal fees,OFFICE/GENERAL ADMINISTRATIVE EXPENSES:PayPal Fees,PayPal Bank 3,$1.99 ,"$955,690.54 "
PayPal Bank 3,9/22/23,Deposit,1EN810864A212381U,04 PAYPAL GENERAL UNRESTR,"Subject: GeneralPage
Transaction ID: 1EN810864A212381U
https://www.paypal.com/activity/payment/1EN810864A212381U",PayPal Bank 3,--,$29.53 ,"$955,720.07 "
Donations directed by individuals,9/22/23,Deposit,1EN810864A212381U,04 PAYPAL GENERAL UNRESTR,Support Ukraine - Support Ukraine,Contributed income:Donations directed by individuals,PayPal Bank 3,$31.40 ,"$955,751.47 "
PayPal Fees,9/22/23,Deposit,1EN810864A212381U,04 PAYPAL GENERAL UNRESTR,PayPal fees,OFFICE/GENERAL ADMINISTRATIVE EXPENSES:PayPal Fees,PayPal Bank 3,$1.87 ,"$955,753.34 "
PayPal Bank 3,9/22/23,Deposit,9J793337BU701825D,04 PAYPAL GENERAL UNRESTR,"Subject: GeneralPage
Transaction ID: 9J793337BU701825D
https://www.paypal.com/activity/payment/9J793337BU701825D",PayPal Bank 3,--,$48.06 ,"$955,801.40 "
Donations directed by individuals,9/22/23,Deposit,9J793337BU701825D,04 PAYPAL GENERAL UNRESTR,Support Ukraine - Support Ukraine,Contributed income:Donations directed by individuals,PayPal Bank 3,$50.00 ,"$955,851.40 "
PayPal Fees,9/22/23,Deposit,9J793337BU701825D,04 PAYPAL GENERAL UNRESTR,PayPal fees,OFFICE/GENERAL ADMINISTRATIVE EXPENSES:PayPal Fees,PayPal Bank 3,$1.94 ,"$955,853.34 "
PayPal Bank 3,9/22/23,Deposit,0UG62099W7571541M,04 PAYPAL GENERAL UNRESTR,"Subject: GeneralPage
Transaction ID: 0UG62099W7571541M
https://www.paypal.com/activity/payment/0UG62099W7571541M",PayPal Bank 3,--,$96.62 ,"$955,949.96 "
Donations directed by individuals,9/22/23,Deposit,0UG62099W7571541M,04 PAYPAL GENERAL UNRESTR,Support Ukraine - Support Ukraine,Contributed income:Donations directed by individuals,PayPal Bank 3,$100.00 ,"$956,049.96 "
PayPal Fees,9/22/23,Deposit,0UG62099W7571541M,04 PAYPAL GENERAL UNRESTR,PayPal fees,OFFICE/GENERAL ADMINISTRATIVE EXPENSES:PayPal Fees,PayPal Bank 3,$3.38 ,"$956,053.34 "
PayPal Bank 3,9/22/23,Deposit,64926847BA042831F,07 1000 DRONES RESTR,"Subject: 1000DRONES
Transaction ID: 64926847BA042831F
https://www.paypal.com/activity/payment/64926847BA042831F",PayPal Bank 3,--,$100.00 ,"$956,153.34 "
Donations directed by individuals,9/22/23,Deposit,64926847BA042831F,07 1000 DRONES RESTR,1000 DRONES FOR UKRAINE - 1000 DRONES FOR UKRAINE,Contributed income:Donations directed by individuals,PayPal Bank 3,$103.48 ,"$956,256.82 "
PayPal Fees,9/22/23,Deposit,64926847BA042831F,07 1000 DRONES RESTR,PayPal fees,OFFICE/GENERAL ADMINISTRATIVE EXPENSES:PayPal Fees,PayPal Bank 3,$3.48 ,"$956,260.30 "
PayPal Bank 3,9/22/23,Deposit,1VY12512D1706093V,04 PAYPAL GENERAL UNRESTR,"Subject: Support Ukraine
Transaction ID: 1VY12512D1706093V
https://www.paypal.com/activity/payment/1VY12512D1706093V",PayPal Bank 3,--,$25.00 ,"$956,285.30 "
Donations directed by individuals,9/22/23,Deposit,1VY12512D1706093V,04 PAYPAL GENERAL UNRESTR,Money in to PayPal,Contributed income:Donations directed by individuals,PayPal Bank 3,$26.25 ,"$956,311.55 "
PayPal Fees,9/22/23,Deposit,1VY12512D1706093V,04 PAYPAL GENERAL UNRESTR,PayPal fees,OFFICE/GENERAL ADMINISTRATIVE EXPENSES:PayPal Fees,PayPal Bank 3,$1.25 ,"$956,312.80 "
PayPal Bank 3,9/22/23,Deposit,2V324450U79310835,04 PAYPAL GENERAL UNRESTR,"Subject: GeneralPage
Transaction ID: 2V324450U79310835
https://www.paypal.com/activity/payment/2V324450U79310835",PayPal Bank 3,--,$477.56 ,"$956,790.36 "
Donations directed by individuals,9/22/23,Deposit,2V324450U79310835,04 PAYPAL GENERAL UNRESTR,Support Ukraine - Support Ukraine,Contributed income:Donations directed by individuals,PayPal Bank 3,$500.00 ,"$957,290.36 "
PayPal Fees,9/22/23,Deposit,2V324450U79310835,04 PAYPAL GENERAL UNRESTR,PayPal fees,OFFICE/GENERAL ADMINISTRATIVE EXPENSES:PayPal Fees,PayPal Bank 3,$22.44 ,"$957,312.80 "
PayPal Bank 3,9/22/23,Deposit,9BE87499MP656021M,04 PAYPAL GENERAL UNRESTR,"Subject: GeneralPage
Transaction ID: 9BE87499MP656021M
https://www.paypal.com/activity/payment/9BE87499MP656021M",PayPal Bank 3,--,$18.63 ,"$957,331.43 "
Donations directed by individuals,9/22/23,Deposit,9BE87499MP656021M,04 PAYPAL GENERAL UNRESTR,Support Ukraine - Support Ukraine,Contributed income:Donations directed by individuals,PayPal Bank 3,$20.00 ,"$957,351.43 "
PayPal Fees,9/22/23,Deposit,9BE87499MP656021M,04 PAYPAL GENERAL UNRESTR,PayPal fees,OFFICE/GENERAL ADMINISTRATIVE EXPENSES:PayPal Fees,PayPal Bank 3,$1.37 ,"$957,352.80 "
PayPal Bank 3,9/22/23,Deposit,8CW76394AE185454U,04 PAYPAL GENERAL UNRESTR,"Subject: GeneralPage
Transaction ID: 8CW76394AE185454U
https://www.paypal.com/activity/payment/8CW76394AE185454U",PayPal Bank 3,--,$9.84 ,"$957,362.64 "
Donations directed by individuals,9/22/23,Deposit,8CW76394AE185454U,04 PAYPAL GENERAL UNRESTR,Support Ukraine - Support Ukraine,Contributed income:Donations directed by individuals,PayPal Bank 3,$10.80 ,"$957,373.44 "
PayPal Fees,9/22/23,Deposit,8CW76394AE185454U,04 PAYPAL GENERAL UNRESTR,PayPal fees,OFFICE/GENERAL ADMINISTRATIVE EXPENSES:PayPal Fees,PayPal Bank 3,$0.96 ,"$957,374.40 "
PayPal Bank 3,9/22/23,Deposit,12061336V30498904,04 PAYPAL GENERAL UNRESTR,"Subject: GeneralPage
Transaction ID: 12061336V30498904
https://www.paypal.com/activity/payment/12061336V30498904",PayPal Bank 3,--,$49.22 ,"$957,423.62 "
Donations directed by individuals,9/22/23,Deposit,12061336V30498904,04 PAYPAL GENERAL UNRESTR,Support Ukraine - Support Ukraine,Contributed income:Donations directed by individuals,PayPal Bank 3,$51.99 ,"$957,475.61 "
PayPal Fees,9/22/23,Deposit,12061336V30498904,04 PAYPAL GENERAL UNRESTR,PayPal fees,OFFICE/GENERAL ADMINISTRATIVE EXPENSES:PayPal Fees,PayPal Bank 3,$2.77 ,"$957,478.38 "
PayPal Bank 3,9/22/23,Deposit,4TC19961LB341443A,04 PAYPAL GENERAL UNRESTR,"Subject: GeneralPage
Transaction ID: 4TC19961LB341443A
https://www.paypal.com/activity/payment/4TC19961LB341443A",PayPal Bank 3,--,$95.12 ,"$957,573.50 "
Donations directed by individuals,9/22/23,Deposit,4TC19961LB341443A,04 PAYPAL GENERAL UNRESTR,Support Ukraine - Support Ukraine,Contributed income:Donations directed by individuals,PayPal Bank 3,$100.00 ,"$957,673.50 "
PayPal Fees,9/22/23,Deposit,4TC19961LB341443A,04 PAYPAL GENERAL UNRESTR,PayPal fees,OFFICE/GENERAL ADMINISTRATIVE EXPENSES:PayPal Fees,PayPal Bank 3,$4.88 ,"$957,678.38 "
PayPal Bank 3,9/22/23,Deposit,31Y41334UW849574P,07 1000 DRONES RESTR,"Subject: 1000DRONES
Note: Happy Birthday Dobrum Lyudyam :)
Transaction ID: 31Y41334UW849574P
https://www.paypal.com/activity/payment/31Y41334UW849574P",PayPal Bank 3,--,$40.00 ,"$957,718.38 "
Donations directed by individuals,9/22/23,Deposit,31Y41334UW849574P,07 1000 DRONES RESTR,1000 DRONES FOR UKRAINE - 1000 DRONES FOR UKRAINE,Contributed income:Donations directed by individuals,PayPal Bank 3,$41.69 ,"$957,760.07 "
PayPal Fees,9/22/23,Deposit,31Y41334UW849574P,07 1000 DRONES RESTR,PayPal fees,OFFICE/GENERAL ADMINISTRATIVE EXPENSES:PayPal Fees,PayPal Bank 3,$1.69 ,"$957,761.76 "
PayPal Bank 3,9/22/23,Deposit,7AE81890CU825733A,04 PAYPAL GENERAL UNRESTR,"Subject: GeneralPage
Transaction ID: 7AE81890CU825733A
https://www.paypal.com/activity/payment/7AE81890CU825733A",PayPal Bank 3,--,$100.00 ,"$957,861.76 "
Donations directed by individuals,9/22/23,Deposit,7AE81890CU825733A,04 PAYPAL GENERAL UNRESTR,Support Ukraine - Support Ukraine,Contributed income:Donations directed by individuals,PayPal Bank 3,$103.48 ,"$957,965.24 "
PayPal Fees,9/22/23,Deposit,7AE81890CU825733A,04 PAYPAL GENERAL UNRESTR,PayPal fees,OFFICE/GENERAL ADMINISTRATIVE EXPENSES:PayPal Fees,PayPal Bank 3,$3.48 ,"$957,968.72 "
PayPal Bank 3,9/22/23,Deposit,80X74463L92161906,07 1000 DRONES RESTR,"Subject: 1000DRONES
Note: For Alex Sin birthday
Transaction ID: 80X74463L92161906
https://www.paypal.com/activity/payment/80X74463L92161906",PayPal Bank 3,--,$23.79 ,"$957,992.51 "
Donations directed by individuals,9/22/23,Deposit,80X74463L92161906,07 1000 DRONES RESTR,1000 DRONES FOR UKRAINE - 1000 DRONES FOR UKRAINE,Contributed income:Donations directed by individuals,PayPal Bank 3,$25.00 ,"$958,017.51 "
PayPal Fees,9/22/23,Deposit,80X74463L92161906,07 1000 DRONES RESTR,PayPal fees,OFFICE/GENERAL ADMINISTRATIVE EXPENSES:PayPal Fees,PayPal Bank 3,$1.21 ,"$958,018.72 "
PayPal Bank 3,9/22/23,Deposit,4VP96622E72548730,04 PAYPAL GENERAL UNRESTR,"Subject: GeneralPage
Transaction ID: 4VP96622E72548730
https://www.paypal.com/activity/payment/4VP96622E72548730",PayPal Bank 3,--,$4.29 ,"$958,023.01 "
Donations directed by individuals,9/22/23,Deposit,4VP96622E72548730,04 PAYPAL GENERAL UNRESTR,Support Ukraine - Support Ukraine,Contributed income:Donations directed by individuals,PayPal Bank 3,$5.00 ,"$958,028.01 "
PayPal Fees,9/22/23,Deposit,4VP96622E72548730,04 PAYPAL GENERAL UNRESTR,PayPal fees,OFFICE/GENERAL ADMINISTRATIVE EXPENSES:PayPal Fees,PayPal Bank 3,$0.71 ,"$958,028.72 "
PayPal Bank 3,9/22/23,Deposit,44929002AD129390N,04 PAYPAL GENERAL UNRESTR,"Subject: GeneralPage
Transaction ID: 44929002AD129390N
https://www.paypal.com/activity/payment/44929002AD129390N",PayPal Bank 3,--,$190.73 ,"$958,219.45 "
Donations directed by individuals,9/22/23,Deposit,44929002AD129390N,04 PAYPAL GENERAL UNRESTR,Support Ukraine - Support Ukraine,Contributed income:Donations directed by individuals,PayPal Bank 3,$200.00 ,"$958,419.45 "
PayPal Fees,9/22/23,Deposit,44929002AD129390N,04 PAYPAL GENERAL UNRESTR,PayPal fees,OFFICE/GENERAL ADMINISTRATIVE EXPENSES:PayPal Fees,PayPal Bank 3,$9.27 ,"$958,428.72 "
PayPal Bank 3,9/22/23,Deposit,7UG99699TP456293N,04 PAYPAL GENERAL UNRESTR,"Subject: GeneralPage
Transaction ID: 7UG99699TP456293N
https://www.paypal.com/activity/payment/7UG99699TP456293N",PayPal Bank 3,--,$49.22 ,"$958,477.94 "
Donations directed by individuals,9/22/23,Deposit,7UG99699TP456293N,04 PAYPAL GENERAL UNRESTR,Support Ukraine - Support Ukraine,Contributed income:Donations directed by individuals,PayPal Bank 3,$51.99 ,"$958,529.93 "
PayPal Fees,9/22/23,Deposit,7UG99699TP456293N,04 PAYPAL GENERAL UNRESTR,PayPal fees,OFFICE/GENERAL ADMINISTRATIVE EXPENSES:PayPal Fees,PayPal Bank 3,$2.77 ,"$958,532.70 "
PayPal Bank 3,9/22/23,Deposit,1PY3008272369630N,07 1000 DRONES RESTR,"Subject: 1000DRONES
Transaction ID: 1PY3008272369630N
https://www.paypal.com/activity/payment/1PY3008272369630N",PayPal Bank 3,--,$19.68 ,"$958,552.38 "
Donations directed by individuals,9/22/23,Deposit,1PY3008272369630N,07 1000 DRONES RESTR,1000 DRONES FOR UKRAINE - 1000 DRONES FOR UKRAINE,Contributed income:Donations directed by individuals,PayPal Bank 3,$21.10 ,"$958,573.48 "
PayPal Fees,9/22/23,Deposit,1PY3008272369630N,07 1000 DRONES RESTR,PayPal fees,OFFICE/GENERAL ADMINISTRATIVE EXPENSES:PayPal Fees,PayPal Bank 3,$1.42 ,"$958,574.90 "
PayPal Bank 3,9/22/23,Deposit,7.73544E+16,08 VICTORY DRONES RESTR,"Subject: GeneralPage
Note: Для пташок.   Діаспора з Wilmington
Transaction ID: 77354439399152731
https://www.paypal.com/activity/payment/77354439399152731",PayPal Bank 3,--,$40.00 ,"$958,614.90 "
Donations directed by individuals,9/22/23,Deposit,7.73544E+16,08 VICTORY DRONES RESTR,Support Ukraine - Support Ukraine,Contributed income:Donations directed by individuals,PayPal Bank 3,$41.69 ,"$958,656.59 "
PayPal Fees,9/22/23,Deposit,7.73544E+16,08 VICTORY DRONES RESTR,PayPal fees,OFFICE/GENERAL ADMINISTRATIVE EXPENSES:PayPal Fees,PayPal Bank 3,$1.69 ,"$958,658.28 "
PayPal Bank 3,9/22/23,Deposit,7B674732TH0898947,04 PAYPAL GENERAL UNRESTR,"Subject: GeneralPage
Transaction ID: 7B674732TH0898947
https://www.paypal.com/activity/payment/7B674732TH0898947",PayPal Bank 3,--,$190.73 ,"$958,849.01 "
Donations directed by individuals,9/22/23,Deposit,7B674732TH0898947,04 PAYPAL GENERAL UNRESTR,Support Ukraine - Support Ukraine,Contributed income:Donations directed by individuals,PayPal Bank 3,$200.00 ,"$959,049.01 "
PayPal Fees,9/22/23,Deposit,7B674732TH0898947,04 PAYPAL GENERAL UNRESTR,PayPal fees,OFFICE/GENERAL ADMINISTRATIVE EXPENSES:PayPal Fees,PayPal Bank 3,$9.27 ,"$959,058.28 "
PayPal Bank 3,9/22/23,Deposit,2LK79528LY325854Y,04 PAYPAL GENERAL UNRESTR,"Subject: GeneralPage
Transaction ID: 2LK79528LY325854Y
https://www.paypal.com/activity/payment/2LK79528LY325854Y",PayPal Bank 3,--,$47.31 ,"$959,105.59 "
Donations directed by individuals,9/22/23,Deposit,2LK79528LY325854Y,04 PAYPAL GENERAL UNRESTR,Support Ukraine - Support Ukraine,Contributed income:Donations directed by individuals,PayPal Bank 3,$50.00 ,"$959,155.59 "
PayPal Fees,9/22/23,Deposit,2LK79528LY325854Y,04 PAYPAL GENERAL UNRESTR,PayPal fees,OFFICE/GENERAL ADMINISTRATIVE EXPENSES:PayPal Fees,PayPal Bank 3,$2.69 ,"$959,158.28 "
PayPal Bank 3,9/22/23,Deposit,9G934766W9725003J,07 1000 DRONES RESTR,"Subject: 1000DRONES
Transaction ID: 9G934766W9725003J
https://www.paypal.com/activity/payment/9G934766W9725003J",PayPal Bank 3,--,$50.00 ,"$959,208.28 "
Donations directed by individuals,9/22/23,Deposit,9G934766W9725003J,07 1000 DRONES RESTR,1000 DRONES FOR UKRAINE - 1000 DRONES FOR UKRAINE,Contributed income:Donations directed by individuals,PayPal Bank 3,$51.99 ,"$959,260.27 "
PayPal Fees,9/22/23,Deposit,9G934766W9725003J,07 1000 DRONES RESTR,PayPal fees,OFFICE/GENERAL ADMINISTRATIVE EXPENSES:PayPal Fees,PayPal Bank 3,$1.99 ,"$959,262.26 "
PayPal Bank 3,9/22/23,Deposit,9P575095S0707893U,08 VICTORY DRONES RESTR,"Subject: VictoryDrones
Transaction ID: 9P575095S0707893U
https://www.paypal.com/activity/payment/9P575095S0707893U",PayPal Bank 3,--,$98.45 ,"$959,360.71 "
Donations directed by individuals,9/22/23,Deposit,9P575095S0707893U,08 VICTORY DRONES RESTR,VICTORY DRONES - VICTORY DRONES,Contributed income:Donations directed by individuals,PayPal Bank 3,$103.48 ,"$959,464.19 "
PayPal Fees,9/22/23,Deposit,9P575095S0707893U,08 VICTORY DRONES RESTR,PayPal fees,OFFICE/GENERAL ADMINISTRATIVE EXPENSES:PayPal Fees,PayPal Bank 3,$5.03 ,"$959,469.22 "
PayPal Bank 3,9/22/23,Deposit,6G954126L3575832M,04 PAYPAL GENERAL UNRESTR,"Subject: GeneralPage
Transaction ID: 6G954126L3575832M
https://www.paypal.com/activity/payment/6G954126L3575832M",PayPal Bank 3,--,$14.76 ,"$959,483.98 "
Donations directed by individuals,9/22/23,Deposit,6G954126L3575832M,04 PAYPAL GENERAL UNRESTR,Support Ukraine - Support Ukraine,Contributed income:Donations directed by individuals,PayPal Bank 3,$15.95 ,"$959,499.93 "
PayPal Fees,9/22/23,Deposit,6G954126L3575832M,04 PAYPAL GENERAL UNRESTR,PayPal fees,OFFICE/GENERAL ADMINISTRATIVE EXPENSES:PayPal Fees,PayPal Bank 3,$1.19 ,"$959,501.12 "
PayPal Bank 3,9/22/23,Deposit,3KR46468JV4599338,04 PAYPAL GENERAL UNRESTR,"Subject: GeneralPage
Note: На захист неньки і смерть ворогам
Transaction ID: 3KR46468JV4599338
https://www.paypal.com/activity/payment/3KR46468JV4599338",PayPal Bank 3,--,$286.34 ,"$959,787.46 "
Donations directed by individuals,9/22/23,Deposit,3KR46468JV4599338,04 PAYPAL GENERAL UNRESTR,Support Ukraine - Support Ukraine,Contributed income:Donations directed by individuals,PayPal Bank 3,$300.00 ,"$960,087.46 "
PayPal Fees,9/22/23,Deposit,3KR46468JV4599338,04 PAYPAL GENERAL UNRESTR,PayPal fees,OFFICE/GENERAL ADMINISTRATIVE EXPENSES:PayPal Fees,PayPal Bank 3,$13.66 ,"$960,101.12 "
PayPal Bank 3,9/22/23,Deposit,90G567415Y0551113,04 PAYPAL GENERAL UNRESTR,"Subject: GeneralPage
Transaction ID: 90G567415Y0551113
https://www.paypal.com/activity/payment/90G567415Y0551113",PayPal Bank 3,--,$492.26 ,"$960,593.38 "
Donations directed by individuals,9/22/23,Deposit,90G567415Y0551113,04 PAYPAL GENERAL UNRESTR,Support Ukraine - Support Ukraine,Contributed income:Donations directed by individuals,PayPal Bank 3,$515.38 ,"$961,108.76 "
PayPal Fees,9/22/23,Deposit,90G567415Y0551113,04 PAYPAL GENERAL UNRESTR,PayPal fees,OFFICE/GENERAL ADMINISTRATIVE EXPENSES:PayPal Fees,PayPal Bank 3,$23.12 ,"$961,131.88 "
PayPal Bank 3,9/22/23,Deposit,2GG145851S285642R,04 PAYPAL GENERAL UNRESTR,"Subject: Support Ukraine
Transaction ID: 2GG145851S285642R
https://www.paypal.com/activity/payment/2GG145851S285642R",PayPal Bank 3,--,$20.75 ,"$961,152.63 "
Donations directed by individuals,9/22/23,Deposit,2GG145851S285642R,04 PAYPAL GENERAL UNRESTR,Money in to PayPal,Contributed income:Donations directed by individuals,PayPal Bank 3,$22.22 ,"$961,174.85 "
PayPal Fees,9/22/23,Deposit,2GG145851S285642R,04 PAYPAL GENERAL UNRESTR,PayPal fees,OFFICE/GENERAL ADMINISTRATIVE EXPENSES:PayPal Fees,PayPal Bank 3,$1.47 ,"$961,176.32 "
PayPal Bank 3,9/22/23,Deposit,5RK9538353502761E,07 1000 DRONES RESTR,"Subject: 1000DRONES
Transaction ID: 5RK9538353502761E
https://www.paypal.com/activity/payment/5RK9538353502761E",PayPal Bank 3,--,$20.00 ,"$961,196.32 "
Donations directed by individuals,9/22/23,Deposit,5RK9538353502761E,07 1000 DRONES RESTR,1000 DRONES FOR UKRAINE - 1000 DRONES FOR UKRAINE,Contributed income:Donations directed by individuals,PayPal Bank 3,$21.10 ,"$961,217.42 "
PayPal Fees,9/22/23,Deposit,5RK9538353502761E,07 1000 DRONES RESTR,PayPal fees,OFFICE/GENERAL ADMINISTRATIVE EXPENSES:PayPal Fees,PayPal Bank 3,$1.10 ,"$961,218.52 "
PayPal Bank 3,9/22/23,Deposit,5EW10668BX6467119,04 PAYPAL GENERAL UNRESTR,"Subject: GeneralPage
Transaction ID: 5EW10668BX6467119
https://www.paypal.com/activity/payment/5EW10668BX6467119",PayPal Bank 3,--,$196.91 ,"$961,415.43 "
Donations directed by individuals,9/22/23,Deposit,5EW10668BX6467119,04 PAYPAL GENERAL UNRESTR,Support Ukraine - Support Ukraine,Contributed income:Donations directed by individuals,PayPal Bank 3,$206.46 ,"$961,621.89 "
PayPal Fees,9/22/23,Deposit,5EW10668BX6467119,04 PAYPAL GENERAL UNRESTR,PayPal fees,OFFICE/GENERAL ADMINISTRATIVE EXPENSES:PayPal Fees,PayPal Bank 3,$9.55 ,"$961,631.44 "
PayPal Bank 3,9/22/23,Deposit,41790330R17771809,07 1000 DRONES RESTR,"Subject: 1000DRONES
Transaction ID: 41790330R17771809
https://www.paypal.com/activity/payment/41790330R17771809",PayPal Bank 3,--,$49.22 ,"$961,680.66 "
Donations directed by individuals,9/22/23,Deposit,41790330R17771809,07 1000 DRONES RESTR,1000 DRONES FOR UKRAINE - 1000 DRONES FOR UKRAINE,Contributed income:Donations directed by individuals,PayPal Bank 3,$51.99 ,"$961,732.65 "
PayPal Fees,9/22/23,Deposit,41790330R17771809,07 1000 DRONES RESTR,PayPal fees,OFFICE/GENERAL ADMINISTRATIVE EXPENSES:PayPal Fees,PayPal Bank 3,$2.77 ,"$961,735.42 "
PayPal Bank 3,9/22/23,Deposit,0UB37905AY493961X,04 PAYPAL GENERAL UNRESTR,"Subject: GeneralPage
Transaction ID: 0UB37905AY493961X
https://www.paypal.com/activity/payment/0UB37905AY493961X",PayPal Bank 3,--,$295.36 ,"$962,030.78 "
Donations directed by individuals,9/22/23,Deposit,0UB37905AY493961X,04 PAYPAL GENERAL UNRESTR,Support Ukraine - Support Ukraine,Contributed income:Donations directed by individuals,PayPal Bank 3,$309.43 ,"$962,340.21 "
PayPal Fees,9/22/23,Deposit,0UB37905AY493961X,04 PAYPAL GENERAL UNRESTR,PayPal fees,OFFICE/GENERAL ADMINISTRATIVE EXPENSES:PayPal Fees,PayPal Bank 3,$14.07 ,"$962,354.28 "
PayPal Bank 3,9/22/23,Deposit,2A623416958046331,04 PAYPAL GENERAL UNRESTR,"Subject: GeneralPage
Transaction ID: 2A623416958046331
https://www.paypal.com/activity/payment/2A623416958046331",PayPal Bank 3,--,$98.45 ,"$962,452.73 "
Donations directed by individuals,9/22/23,Deposit,2A623416958046331,04 PAYPAL GENERAL UNRESTR,Support Ukraine - Support Ukraine,Contributed income:Donations directed by individuals,PayPal Bank 3,$103.48 ,"$962,556.21 "
PayPal Fees,9/22/23,Deposit,2A623416958046331,04 PAYPAL GENERAL UNRESTR,PayPal fees,OFFICE/GENERAL ADMINISTRATIVE EXPENSES:PayPal Fees,PayPal Bank 3,$5.03 ,"$962,561.24 "
PayPal Bank 3,9/22/23,Deposit,6JT50752VR228990E,04 PAYPAL GENERAL UNRESTR,"Subject: GeneralPage
Transaction ID: 6JT50752VR228990E
https://www.paypal.com/activity/payment/6JT50752VR228990E",PayPal Bank 3,--,$49.22 ,"$962,610.46 "
Donations directed by individuals,9/22/23,Deposit,6JT50752VR228990E,04 PAYPAL GENERAL UNRESTR,Support Ukraine - Support Ukraine,Contributed income:Donations directed by individuals,PayPal Bank 3,$51.99 ,"$962,662.45 "
PayPal Fees,9/22/23,Deposit,6JT50752VR228990E,04 PAYPAL GENERAL UNRESTR,PayPal fees,OFFICE/GENERAL ADMINISTRATIVE EXPENSES:PayPal Fees,PayPal Bank 3,$2.77 ,"$962,665.22 "
PayPal Bank 3,9/22/23,Deposit,76427796F4886732T,04 PAYPAL GENERAL UNRESTR,"Subject: GeneralPage
Transaction ID: 76427796F4886732T
https://www.paypal.com/activity/payment/76427796F4886732T",PayPal Bank 3,--,$19.68 ,"$962,684.90 "
Donations directed by individuals,9/22/23,Deposit,76427796F4886732T,04 PAYPAL GENERAL UNRESTR,Support Ukraine - Support Ukraine,Contributed income:Donations directed by individuals,PayPal Bank 3,$21.10 ,"$962,706.00 "
PayPal Fees,9/22/23,Deposit,76427796F4886732T,04 PAYPAL GENERAL UNRESTR,PayPal fees,OFFICE/GENERAL ADMINISTRATIVE EXPENSES:PayPal Fees,PayPal Bank 3,$1.42 ,"$962,707.42 "
PayPal Bank 3,9/22/23,Deposit,40R47565WH287543R,07 1000 DRONES RESTR,"Subject: 1000DRONES
Transaction ID: 40R47565WH287543R
https://www.paypal.com/activity/payment/40R47565WH287543R",PayPal Bank 3,--,$25.00 ,"$962,732.42 "
Donations directed by individuals,9/22/23,Deposit,40R47565WH287543R,07 1000 DRONES RESTR,1000 DRONES FOR UKRAINE - 1000 DRONES FOR UKRAINE,Contributed income:Donations directed by individuals,PayPal Bank 3,$26.25 ,"$962,758.67 "
PayPal Fees,9/22/23,Deposit,40R47565WH287543R,07 1000 DRONES RESTR,PayPal fees,OFFICE/GENERAL ADMINISTRATIVE EXPENSES:PayPal Fees,PayPal Bank 3,$1.25 ,"$962,759.92 "
PayPal Bank 3,9/22/23,Deposit,04M605240N4612641,07 1000 DRONES RESTR,"Subject: 1000DRONES
Transaction ID: 04M605240N4612641
https://www.paypal.com/activity/payment/04M605240N4612641",PayPal Bank 3,--,$50.00 ,"$962,809.92 "
Donations directed by individuals,9/22/23,Deposit,04M605240N4612641,07 1000 DRONES RESTR,1000 DRONES FOR UKRAINE - 1000 DRONES FOR UKRAINE,Contributed income:Donations directed by individuals,PayPal Bank 3,$51.99 ,"$962,861.91 "
PayPal Fees,9/22/23,Deposit,04M605240N4612641,07 1000 DRONES RESTR,PayPal fees,OFFICE/GENERAL ADMINISTRATIVE EXPENSES:PayPal Fees,PayPal Bank 3,$1.99 ,"$962,863.90 "
PayPal Bank 3,9/22/23,Deposit,5F331525YL878060N,07 1000 DRONES RESTR,"Subject: 1000DRONES
Note: До перемоги .   Захисти вас Господь
Transaction ID: 5F331525YL878060N
https://www.paypal.com/activity/payment/5F331525YL878060N",PayPal Bank 3,--,$20.54 ,"$962,884.44 "
Donations directed by individuals,9/22/23,Deposit,5F331525YL878060N,07 1000 DRONES RESTR,1000 DRONES FOR UKRAINE - 1000 DRONES FOR UKRAINE,Contributed income:Donations directed by individuals,PayPal Bank 3,$22.00 ,"$962,906.44 "
PayPal Fees,9/22/23,Deposit,5F331525YL878060N,07 1000 DRONES RESTR,PayPal fees,OFFICE/GENERAL ADMINISTRATIVE EXPENSES:PayPal Fees,PayPal Bank 3,$1.46 ,"$962,907.90 "
PayPal Bank 3,9/22/23,Deposit,2YV724471U767473C,04 PAYPAL GENERAL UNRESTR,"Subject: GeneralPage
Transaction ID: 2YV724471U767473C
https://www.paypal.com/activity/payment/2YV724471U767473C",PayPal Bank 3,--,$9.84 ,"$962,917.74 "
Donations directed by individuals,9/22/23,Deposit,2YV724471U767473C,04 PAYPAL GENERAL UNRESTR,Support Ukraine - Support Ukraine,Contributed income:Donations directed by individuals,PayPal Bank 3,$10.80 ,"$962,928.54 "
PayPal Fees,9/22/23,Deposit,2YV724471U767473C,04 PAYPAL GENERAL UNRESTR,PayPal fees,OFFICE/GENERAL ADMINISTRATIVE EXPENSES:PayPal Fees,PayPal Bank 3,$0.96 ,"$962,929.50 "
PayPal Bank 3,9/22/23,Deposit,2N036370EX9879348,04 PAYPAL GENERAL UNRESTR,"Subject: GeneralPage
Transaction ID: 2N036370EX9879348
https://www.paypal.com/activity/payment/2N036370EX9879348",PayPal Bank 3,--,$85.00 ,"$963,014.50 "
Donations directed by individuals,9/22/23,Deposit,2N036370EX9879348,04 PAYPAL GENERAL UNRESTR,Support Ukraine - Support Ukraine,Contributed income:Donations directed by individuals,PayPal Bank 3,$88.03 ,"$963,102.53 "
PayPal Fees,9/22/23,Deposit,2N036370EX9879348,04 PAYPAL GENERAL UNRESTR,PayPal fees,OFFICE/GENERAL ADMINISTRATIVE EXPENSES:PayPal Fees,PayPal Bank 3,$3.03 ,"$963,105.56 "
PayPal Bank 3,9/22/23,Deposit,89M342361N1415036,07 1000 DRONES RESTR,"Subject: 1000DRONES
Note: Supplies for Ukrainian Heroes
Transaction ID: 89M342361N1415036
https://www.paypal.com/activity/payment/89M342361N1415036",PayPal Bank 3,--,$14.76 ,"$963,120.32 "
Donations directed by individuals,9/22/23,Deposit,89M342361N1415036,07 1000 DRONES RESTR,1000 DRONES FOR UKRAINE - 1000 DRONES FOR UKRAINE,Contributed income:Donations directed by individuals,PayPal Bank 3,$15.95 ,"$963,136.27 "
PayPal Fees,9/22/23,Deposit,89M342361N1415036,07 1000 DRONES RESTR,PayPal fees,OFFICE/GENERAL ADMINISTRATIVE EXPENSES:PayPal Fees,PayPal Bank 3,$1.19 ,"$963,137.46 "
PayPal Bank 3,9/22/23,Deposit,66H69369S39122140,07 1000 DRONES RESTR,"Subject: 1000DRONES
Transaction ID: 66H69369S39122140
https://www.paypal.com/activity/payment/66H69369S39122140",PayPal Bank 3,--,$48.06 ,"$963,185.52 "
Donations directed by individuals,9/22/23,Deposit,66H69369S39122140,07 1000 DRONES RESTR,1000 DRONES FOR UKRAINE - 1000 DRONES FOR UKRAINE,Contributed income:Donations directed by individuals,PayPal Bank 3,$50.00 ,"$963,235.52 "
PayPal Fees,9/22/23,Deposit,66H69369S39122140,07 1000 DRONES RESTR,PayPal fees,OFFICE/GENERAL ADMINISTRATIVE EXPENSES:PayPal Fees,PayPal Bank 3,$1.94 ,"$963,237.46 "
PayPal Bank 3,9/22/23,Deposit,66D03025GH5580734,07 1000 DRONES RESTR,"Subject: 1000DRONES
Transaction ID: 66D03025GH5580734
https://www.paypal.com/activity/payment/66D03025GH5580734",PayPal Bank 3,--,$9.22 ,"$963,246.68 "
Donations directed by individuals,9/22/23,Deposit,66D03025GH5580734,07 1000 DRONES RESTR,1000 DRONES FOR UKRAINE - 1000 DRONES FOR UKRAINE,Contributed income:Donations directed by individuals,PayPal Bank 3,$10.00 ,"$963,256.68 "
PayPal Fees,9/22/23,Deposit,66D03025GH5580734,07 1000 DRONES RESTR,PayPal fees,OFFICE/GENERAL ADMINISTRATIVE EXPENSES:PayPal Fees,PayPal Bank 3,$0.78 ,"$963,257.46 "
PayPal Bank 3,9/22/23,Deposit,42X80841FM761911U,07 1000 DRONES RESTR,"Subject: 1000DRONES
Transaction ID: 42X80841FM761911U
https://www.paypal.com/activity/payment/42X80841FM761911U",PayPal Bank 3,--,$5.00 ,"$963,262.46 "
Donations directed by individuals,9/22/23,Deposit,42X80841FM761911U,07 1000 DRONES RESTR,1000 DRONES FOR UKRAINE - 1000 DRONES FOR UKRAINE,Contributed income:Donations directed by individuals,PayPal Bank 3,$5.65 ,"$963,268.11 "
PayPal Fees,9/22/23,Deposit,42X80841FM761911U,07 1000 DRONES RESTR,PayPal fees,OFFICE/GENERAL ADMINISTRATIVE EXPENSES:PayPal Fees,PayPal Bank 3,$0.65 ,"$963,268.76 "
PayPal Bank 3,9/22/23,Deposit,29J78079EY463291S,04 PAYPAL GENERAL UNRESTR,"Subject: GeneralPage
Transaction ID: 29J78079EY463291S
https://www.paypal.com/activity/payment/29J78079EY463291S",PayPal Bank 3,--,$49.22 ,"$963,317.98 "
Donations directed by individuals,9/22/23,Deposit,29J78079EY463291S,04 PAYPAL GENERAL UNRESTR,Support Ukraine - Support Ukraine,Contributed income:Donations directed by individuals,PayPal Bank 3,$51.99 ,"$963,369.97 "
PayPal Fees,9/22/23,Deposit,29J78079EY463291S,04 PAYPAL GENERAL UNRESTR,PayPal fees,OFFICE/GENERAL ADMINISTRATIVE EXPENSES:PayPal Fees,PayPal Bank 3,$2.77 ,"$963,372.74 "
PayPal Bank 3,9/22/23,Deposit,62538682VW9006506,04 PAYPAL GENERAL UNRESTR,"Subject: GeneralPage
Transaction ID: 62538682VW9006506
https://www.paypal.com/activity/payment/62538682VW9006506",PayPal Bank 3,--,$96.62 ,"$963,469.36 "
Donations directed by individuals,9/22/23,Deposit,62538682VW9006506,04 PAYPAL GENERAL UNRESTR,Support Ukraine - Support Ukraine,Contributed income:Donations directed by individuals,PayPal Bank 3,$100.00 ,"$963,569.36 "
PayPal Fees,9/22/23,Deposit,62538682VW9006506,04 PAYPAL GENERAL UNRESTR,PayPal fees,OFFICE/GENERAL ADMINISTRATIVE EXPENSES:PayPal Fees,PayPal Bank 3,$3.38 ,"$963,572.74 "
PayPal Bank 3,9/22/23,Deposit,72565085SJ207243F,04 PAYPAL GENERAL UNRESTR,"Subject: Support Ukraine
Transaction ID: 72565085SJ207243F
https://www.paypal.com/activity/payment/72565085SJ207243F",PayPal Bank 3,--,$9.07 ,"$963,581.81 "
Donations directed by individuals,9/22/23,Deposit,72565085SJ207243F,04 PAYPAL GENERAL UNRESTR,Money in to PayPal,Contributed income:Donations directed by individuals,PayPal Bank 3,$10.00 ,"$963,591.81 "
PayPal Fees,9/22/23,Deposit,72565085SJ207243F,04 PAYPAL GENERAL UNRESTR,PayPal fees,OFFICE/GENERAL ADMINISTRATIVE EXPENSES:PayPal Fees,PayPal Bank 3,$0.93 ,"$963,592.74 "
PayPal Bank 3,9/22/23,Deposit,2C2669903U282674K,04 PAYPAL GENERAL UNRESTR,"Subject: Support Ukraine
Transaction ID: 2C2669903U282674K
https://www.paypal.com/activity/payment/2C2669903U282674K",PayPal Bank 3,--,$50.00 ,"$963,642.74 "
Donations directed by individuals,9/22/23,Deposit,2C2669903U282674K,04 PAYPAL GENERAL UNRESTR,Money in to PayPal,Contributed income:Donations directed by individuals,PayPal Bank 3,$51.99 ,"$963,694.73 "
PayPal Fees,9/22/23,Deposit,2C2669903U282674K,04 PAYPAL GENERAL UNRESTR,PayPal fees,OFFICE/GENERAL ADMINISTRATIVE EXPENSES:PayPal Fees,PayPal Bank 3,$1.99 ,"$963,696.72 "
PayPal Bank 3,9/22/23,Deposit,17C80770MV596380R,04 PAYPAL GENERAL UNRESTR,"Subject: Support Ukraine
Transaction ID: 17C80770MV596380R
https://www.paypal.com/activity/payment/17C80770MV596380R",PayPal Bank 3,--,$24.61 ,"$963,721.33 "
Donations directed by individuals,9/22/23,Deposit,17C80770MV596380R,04 PAYPAL GENERAL UNRESTR,Money in to PayPal,Contributed income:Donations directed by individuals,PayPal Bank 3,$26.25 ,"$963,747.58 "
PayPal Fees,9/22/23,Deposit,17C80770MV596380R,04 PAYPAL GENERAL UNRESTR,PayPal fees,OFFICE/GENERAL ADMINISTRATIVE EXPENSES:PayPal Fees,PayPal Bank 3,$1.64 ,"$963,749.22 "
PayPal Bank 3,9/22/23,Deposit,7D8785103J5355458,07 1000 DRONES RESTR,"Subject: 1000DRONES
Transaction ID: 7D8785103J5355458
https://www.paypal.com/activity/payment/7D8785103J5355458",PayPal Bank 3,--,$25.00 ,"$963,774.22 "
Donations directed by individuals,9/22/23,Deposit,7D8785103J5355458,07 1000 DRONES RESTR,1000 DRONES FOR UKRAINE - 1000 DRONES FOR UKRAINE,Contributed income:Donations directed by individuals,PayPal Bank 3,$26.25 ,"$963,800.47 "
PayPal Fees,9/22/23,Deposit,7D8785103J5355458,07 1000 DRONES RESTR,PayPal fees,OFFICE/GENERAL ADMINISTRATIVE EXPENSES:PayPal Fees,PayPal Bank 3,$1.25 ,"$963,801.72 "
PayPal Bank 3,9/22/23,Deposit,97L26642WD961411A,04 PAYPAL GENERAL UNRESTR,"Subject: GeneralPage
Transaction ID: 97L26642WD961411A
https://www.paypal.com/activity/payment/97L26642WD961411A",PayPal Bank 3,--,$50.00 ,"$963,851.72 "
Donations directed by individuals,9/22/23,Deposit,97L26642WD961411A,04 PAYPAL GENERAL UNRESTR,Support Ukraine - Support Ukraine,Contributed income:Donations directed by individuals,PayPal Bank 3,$51.99 ,"$963,903.71 "
PayPal Fees,9/22/23,Deposit,97L26642WD961411A,04 PAYPAL GENERAL UNRESTR,PayPal fees,OFFICE/GENERAL ADMINISTRATIVE EXPENSES:PayPal Fees,PayPal Bank 3,$1.99 ,"$963,905.70 "
PayPal Bank 3,9/22/23,Deposit,8W779099GE117983G,04 PAYPAL GENERAL UNRESTR,"Subject: GeneralPage
Transaction ID: 8W779099GE117983G
https://www.paypal.com/activity/payment/8W779099GE117983G",PayPal Bank 3,--,$95.12 ,"$964,000.82 "
Donations directed by individuals,9/22/23,Deposit,8W779099GE117983G,04 PAYPAL GENERAL UNRESTR,Support Ukraine - Support Ukraine,Contributed income:Donations directed by individuals,PayPal Bank 3,$100.00 ,"$964,100.82 "
PayPal Fees,9/22/23,Deposit,8W779099GE117983G,04 PAYPAL GENERAL UNRESTR,PayPal fees,OFFICE/GENERAL ADMINISTRATIVE EXPENSES:PayPal Fees,PayPal Bank 3,$4.88 ,"$964,105.70 "
PayPal Bank 3,9/22/23,Deposit,82A68234JB691554M,04 PAYPAL GENERAL UNRESTR,"Subject: GeneralPage
Transaction ID: 82A68234JB691554M
https://www.paypal.com/activity/payment/82A68234JB691554M",PayPal Bank 3,--,$196.91 ,"$964,302.61 "
Donations directed by individuals,9/22/23,Deposit,82A68234JB691554M,04 PAYPAL GENERAL UNRESTR,Support Ukraine - Support Ukraine,Contributed income:Donations directed by individuals,PayPal Bank 3,$206.46 ,"$964,509.07 "
PayPal Fees,9/22/23,Deposit,82A68234JB691554M,04 PAYPAL GENERAL UNRESTR,PayPal fees,OFFICE/GENERAL ADMINISTRATIVE EXPENSES:PayPal Fees,PayPal Bank 3,$9.55 ,"$964,518.62 "
PayPal Bank 3,9/22/23,Deposit,8TL226657H2113203,04 PAYPAL GENERAL UNRESTR,"Subject: GeneralPage
Transaction ID: 8TL226657H2113203
https://www.paypal.com/activity/payment/8TL226657H2113203",PayPal Bank 3,--,$102.45 ,"$964,621.07 "
Donations directed by individuals,9/22/23,Deposit,8TL226657H2113203,04 PAYPAL GENERAL UNRESTR,Support Ukraine - Support Ukraine,Contributed income:Donations directed by individuals,PayPal Bank 3,$106.00 ,"$964,727.07 "
PayPal Fees,9/22/23,Deposit,8TL226657H2113203,04 PAYPAL GENERAL UNRESTR,PayPal fees,OFFICE/GENERAL ADMINISTRATIVE EXPENSES:PayPal Fees,PayPal Bank 3,$3.55 ,"$964,730.62 "
PayPal Bank 3,9/22/23,Deposit,7TJ06042CE980661U,04 PAYPAL GENERAL UNRESTR,"Subject: GeneralPage
Transaction ID: 7TJ06042CE980661U
https://www.paypal.com/activity/payment/7TJ06042CE980661U",PayPal Bank 3,--,$96.62 ,"$964,827.24 "
Donations directed by individuals,9/22/23,Deposit,7TJ06042CE980661U,04 PAYPAL GENERAL UNRESTR,Support Ukraine - Support Ukraine,Contributed income:Donations directed by individuals,PayPal Bank 3,$100.00 ,"$964,927.24 "
PayPal Fees,9/22/23,Deposit,7TJ06042CE980661U,04 PAYPAL GENERAL UNRESTR,PayPal fees,OFFICE/GENERAL ADMINISTRATIVE EXPENSES:PayPal Fees,PayPal Bank 3,$3.38 ,"$964,930.62 "
PayPal Bank 3,9/22/23,Deposit,0YF09188L07121309,04 PAYPAL GENERAL UNRESTR,"Subject: Support Ukraine
Transaction ID: 0YF09188L07121309
https://www.paypal.com/activity/payment/0YF09188L07121309",PayPal Bank 3,--,$47.31 ,"$964,977.93 "
Donations directed by individuals,9/22/23,Deposit,0YF09188L07121309,04 PAYPAL GENERAL UNRESTR,Money in to PayPal,Contributed income:Donations directed by individuals,PayPal Bank 3,$50.00 ,"$965,027.93 "
PayPal Fees,9/22/23,Deposit,0YF09188L07121309,04 PAYPAL GENERAL UNRESTR,PayPal fees,OFFICE/GENERAL ADMINISTRATIVE EXPENSES:PayPal Fees,PayPal Bank 3,$2.69 ,"$965,030.62 "
PayPal Bank 3,9/22/23,Deposit,6XV42432H0870221R,04 PAYPAL GENERAL UNRESTR,"Subject: GeneralPage
Transaction ID: 6XV42432H0870221R
https://www.paypal.com/activity/payment/6XV42432H0870221R",PayPal Bank 3,--,$47.31 ,"$965,077.93 "
Donations directed by individuals,9/22/23,Deposit,6XV42432H0870221R,04 PAYPAL GENERAL UNRESTR,Support Ukraine - Support Ukraine,Contributed income:Donations directed by individuals,PayPal Bank 3,$50.00 ,"$965,127.93 "
PayPal Fees,9/22/23,Deposit,6XV42432H0870221R,04 PAYPAL GENERAL UNRESTR,PayPal fees,OFFICE/GENERAL ADMINISTRATIVE EXPENSES:PayPal Fees,PayPal Bank 3,$2.69 ,"$965,130.62 "
PayPal Bank 3,9/22/23,Deposit,99J37941UA659423P,04 PAYPAL GENERAL UNRESTR,"Subject: GeneralPage
Transaction ID: 99J37941UA659423P
https://www.paypal.com/activity/payment/99J37941UA659423P",PayPal Bank 3,--,$42.53 ,"$965,173.15 "
Donations directed by individuals,9/22/23,Deposit,99J37941UA659423P,04 PAYPAL GENERAL UNRESTR,Support Ukraine - Support Ukraine,Contributed income:Donations directed by individuals,PayPal Bank 3,$45.00 ,"$965,218.15 "
PayPal Fees,9/22/23,Deposit,99J37941UA659423P,04 PAYPAL GENERAL UNRESTR,PayPal fees,OFFICE/GENERAL ADMINISTRATIVE EXPENSES:PayPal Fees,PayPal Bank 3,$2.47 ,"$965,220.62 "
PayPal Bank 3,9/22/23,Deposit,5XV78737C3804783F,04 PAYPAL GENERAL UNRESTR,"Subject: GeneralPage
Transaction ID: 5XV78737C3804783F
https://www.paypal.com/activity/payment/5XV78737C3804783F",PayPal Bank 3,--,$295.36 ,"$965,515.98 "
Donations directed by individuals,9/22/23,Deposit,5XV78737C3804783F,04 PAYPAL GENERAL UNRESTR,Support Ukraine - Support Ukraine,Contributed income:Donations directed by individuals,PayPal Bank 3,$309.43 ,"$965,825.41 "
PayPal Fees,9/22/23,Deposit,5XV78737C3804783F,04 PAYPAL GENERAL UNRESTR,PayPal fees,OFFICE/GENERAL ADMINISTRATIVE EXPENSES:PayPal Fees,PayPal Bank 3,$14.07 ,"$965,839.48 "
PayPal Bank 3,9/22/23,Deposit,2LD77574LD387461G,04 PAYPAL GENERAL UNRESTR,"Subject: GeneralPage
Note: For Angry Birds.   From Sasha Dovzhyk.   Slava Ukraini! Martin Lohrer
Transaction ID: 2LD77574LD387461G
https://www.paypal.com/activity/payment/2LD77574LD387461G",PayPal Bank 3,--,$994.58 ,"$966,834.06 "
Donations directed by individuals,9/22/23,Deposit,2LD77574LD387461G,04 PAYPAL GENERAL UNRESTR,Support Ukraine - Support Ukraine,Contributed income:Donations directed by individuals,PayPal Bank 3,"$1,040.76 ","$967,874.82 "
PayPal Fees,9/22/23,Deposit,2LD77574LD387461G,04 PAYPAL GENERAL UNRESTR,PayPal fees,OFFICE/GENERAL ADMINISTRATIVE EXPENSES:PayPal Fees,PayPal Bank 3,$46.18 ,"$967,921.00 "
PayPal Bank 3,9/22/23,Deposit,98V909275B325961F,04 PAYPAL GENERAL UNRESTR,"Subject: GeneralPage
Note: Люті Пташки ��
Transaction ID: 98V909275B325961F
https://www.paypal.com/activity/payment/98V909275B325961F",PayPal Bank 3,--,$500.00 ,"$968,421.00 "
Donations directed by individuals,9/22/23,Deposit,98V909275B325961F,04 PAYPAL GENERAL UNRESTR,Support Ukraine - Support Ukraine,Contributed income:Donations directed by individuals,PayPal Bank 3,$515.38 ,"$968,936.38 "
PayPal Fees,9/22/23,Deposit,98V909275B325961F,04 PAYPAL GENERAL UNRESTR,PayPal fees,OFFICE/GENERAL ADMINISTRATIVE EXPENSES:PayPal Fees,PayPal Bank 3,$15.38 ,"$968,951.76 "
PayPal Bank 3,9/22/23,Deposit,4EX964657F3761311,04 PAYPAL GENERAL UNRESTR,"Subject: GeneralPage
Transaction ID: 4EX964657F3761311
https://www.paypal.com/activity/payment/4EX964657F3761311",PayPal Bank 3,--,$30.00 ,"$968,981.76 "
Donations directed by individuals,9/22/23,Deposit,4EX964657F3761311,04 PAYPAL GENERAL UNRESTR,Support Ukraine - Support Ukraine,Contributed income:Donations directed by individuals,PayPal Bank 3,$31.40 ,"$969,013.16 "
PayPal Fees,9/22/23,Deposit,4EX964657F3761311,04 PAYPAL GENERAL UNRESTR,PayPal fees,OFFICE/GENERAL ADMINISTRATIVE EXPENSES:PayPal Fees,PayPal Bank 3,$1.40 ,"$969,014.56 "
PayPal Bank 3,9/22/23,Deposit,3BE95191SX641741C,04 PAYPAL GENERAL UNRESTR,"Subject: GeneralPage
Transaction ID: 3BE95191SX641741C
https://www.paypal.com/activity/payment/3BE95191SX641741C",PayPal Bank 3,--,$14.76 ,"$969,029.32 "
Donations directed by individuals,9/22/23,Deposit,3BE95191SX641741C,04 PAYPAL GENERAL UNRESTR,Support Ukraine - Support Ukraine,Contributed income:Donations directed by individuals,PayPal Bank 3,$15.95 ,"$969,045.27 "
PayPal Fees,9/22/23,Deposit,3BE95191SX641741C,04 PAYPAL GENERAL UNRESTR,PayPal fees,OFFICE/GENERAL ADMINISTRATIVE EXPENSES:PayPal Fees,PayPal Bank 3,$1.19 ,"$969,046.46 "
PayPal Bank 3,9/22/23,Deposit,8VX5974100957144H,04 PAYPAL GENERAL UNRESTR,"Subject: GeneralPage
Transaction ID: 8VX5974100957144H
https://www.paypal.com/activity/payment/8VX5974100957144H",PayPal Bank 3,--,$47.31 ,"$969,093.77 "
Donations directed by individuals,9/22/23,Deposit,8VX5974100957144H,04 PAYPAL GENERAL UNRESTR,Support Ukraine - Support Ukraine,Contributed income:Donations directed by individuals,PayPal Bank 3,$50.00 ,"$969,143.77 "
PayPal Fees,9/22/23,Deposit,8VX5974100957144H,04 PAYPAL GENERAL UNRESTR,PayPal fees,OFFICE/GENERAL ADMINISTRATIVE EXPENSES:PayPal Fees,PayPal Bank 3,$2.69 ,"$969,146.46 "
PayPal Bank 3,9/22/23,Deposit,5BF57335UK302950T,04 PAYPAL GENERAL UNRESTR,"Subject: GeneralPage
Transaction ID: 5BF57335UK302950T
https://www.paypal.com/activity/payment/5BF57335UK302950T",PayPal Bank 3,--,$28.19 ,"$969,174.65 "
Donations directed by individuals,9/22/23,Deposit,5BF57335UK302950T,04 PAYPAL GENERAL UNRESTR,Support Ukraine - Support Ukraine,Contributed income:Donations directed by individuals,PayPal Bank 3,$30.00 ,"$969,204.65 "
PayPal Fees,9/22/23,Deposit,5BF57335UK302950T,04 PAYPAL GENERAL UNRESTR,PayPal fees,OFFICE/GENERAL ADMINISTRATIVE EXPENSES:PayPal Fees,PayPal Bank 3,$1.81 ,"$969,206.46 "
PayPal Bank 3,9/22/23,Deposit,88R72027XJ8218152,04 PAYPAL GENERAL UNRESTR,"Subject: GeneralPage
Transaction ID: 88R72027XJ8218152
https://www.paypal.com/activity/payment/88R72027XJ8218152",PayPal Bank 3,--,$96.62 ,"$969,303.08 "
Donations directed by individuals,9/22/23,Deposit,88R72027XJ8218152,04 PAYPAL GENERAL UNRESTR,Support Ukraine - Support Ukraine,Contributed income:Donations directed by individuals,PayPal Bank 3,$100.00 ,"$969,403.08 "
PayPal Fees,9/22/23,Deposit,88R72027XJ8218152,04 PAYPAL GENERAL UNRESTR,PayPal fees,OFFICE/GENERAL ADMINISTRATIVE EXPENSES:PayPal Fees,PayPal Bank 3,$3.38 ,"$969,406.46 "
PayPal Bank 3,9/22/23,Deposit,4MN32152SX955471L,04 PAYPAL GENERAL UNRESTR,"Subject: GeneralPage
Transaction ID: 4MN32152SX955471L
https://www.paypal.com/activity/payment/4MN32152SX955471L",PayPal Bank 3,--,$50.00 ,"$969,456.46 "
Donations directed by individuals,9/22/23,Deposit,4MN32152SX955471L,04 PAYPAL GENERAL UNRESTR,Support Ukraine - Support Ukraine,Contributed income:Donations directed by individuals,PayPal Bank 3,$51.99 ,"$969,508.45 "
PayPal Fees,9/22/23,Deposit,4MN32152SX955471L,04 PAYPAL GENERAL UNRESTR,PayPal fees,OFFICE/GENERAL ADMINISTRATIVE EXPENSES:PayPal Fees,PayPal Bank 3,$1.99 ,"$969,510.44 "
PayPal Bank 3,9/22/23,Deposit,70A72190YN600950P,04 PAYPAL GENERAL UNRESTR,"Subject: GeneralPage
Transaction ID: 70A72190YN600950P
https://www.paypal.com/activity/payment/70A72190YN600950P",PayPal Bank 3,--,$9.07 ,"$969,519.51 "
Donations directed by individuals,9/22/23,Deposit,70A72190YN600950P,04 PAYPAL GENERAL UNRESTR,Support Ukraine - Support Ukraine,Contributed income:Donations directed by individuals,PayPal Bank 3,$10.00 ,"$969,529.51 "
PayPal Fees,9/22/23,Deposit,70A72190YN600950P,04 PAYPAL GENERAL UNRESTR,PayPal fees,OFFICE/GENERAL ADMINISTRATIVE EXPENSES:PayPal Fees,PayPal Bank 3,$0.93 ,"$969,530.44 "
PayPal Bank 3,9/22/23,Deposit,2DY63223TM858493R,04 PAYPAL GENERAL UNRESTR,"Subject: GeneralPage
Transaction ID: 2DY63223TM858493R
https://www.paypal.com/activity/payment/2DY63223TM858493R",PayPal Bank 3,--,$20.00 ,"$969,550.44 "
Donations directed by individuals,9/22/23,Deposit,2DY63223TM858493R,04 PAYPAL GENERAL UNRESTR,Support Ukraine - Support Ukraine,Contributed income:Donations directed by individuals,PayPal Bank 3,$21.10 ,"$969,571.54 "
PayPal Fees,9/22/23,Deposit,2DY63223TM858493R,04 PAYPAL GENERAL UNRESTR,PayPal fees,OFFICE/GENERAL ADMINISTRATIVE EXPENSES:PayPal Fees,PayPal Bank 3,$1.10 ,"$969,572.64 "
PayPal Bank 3,9/22/23,Deposit,0FH76093L51733101,04 PAYPAL GENERAL UNRESTR,"Subject: GeneralPage
Transaction ID: 0FH76093L51733101
https://www.paypal.com/activity/payment/0FH76093L51733101",PayPal Bank 3,--,$98.45 ,"$969,671.09 "
Donations directed by individuals,9/22/23,Deposit,0FH76093L51733101,04 PAYPAL GENERAL UNRESTR,Support Ukraine - Support Ukraine,Contributed income:Donations directed by individuals,PayPal Bank 3,$103.48 ,"$969,774.57 "
PayPal Fees,9/22/23,Deposit,0FH76093L51733101,04 PAYPAL GENERAL UNRESTR,PayPal fees,OFFICE/GENERAL ADMINISTRATIVE EXPENSES:PayPal Fees,PayPal Bank 3,$5.03 ,"$969,779.60 "
PayPal Bank 3,9/22/23,Deposit,0CG2119248214310C,04 PAYPAL GENERAL UNRESTR,"Subject: GeneralPage
Transaction ID: 0CG2119248214310C
https://www.paypal.com/activity/payment/0CG2119248214310C",PayPal Bank 3,--,$95.12 ,"$969,874.72 "
Donations directed by individuals,9/22/23,Deposit,0CG2119248214310C,04 PAYPAL GENERAL UNRESTR,Support Ukraine - Support Ukraine,Contributed income:Donations directed by individuals,PayPal Bank 3,$100.00 ,"$969,974.72 "
PayPal Fees,9/22/23,Deposit,0CG2119248214310C,04 PAYPAL GENERAL UNRESTR,PayPal fees,OFFICE/GENERAL ADMINISTRATIVE EXPENSES:PayPal Fees,PayPal Bank 3,$4.88 ,"$969,979.60 "
PayPal Bank 3,9/22/23,Deposit,80A025750J500623F,04 PAYPAL GENERAL UNRESTR,"Subject: GeneralPage
Transaction ID: 80A025750J500623F
https://www.paypal.com/activity/payment/80A025750J500623F",PayPal Bank 3,--,$9.07 ,"$969,988.67 "
Donations directed by individuals,9/22/23,Deposit,80A025750J500623F,04 PAYPAL GENERAL UNRESTR,Support Ukraine - Support Ukraine,Contributed income:Donations directed by individuals,PayPal Bank 3,$10.00 ,"$969,998.67 "
PayPal Fees,9/22/23,Deposit,80A025750J500623F,04 PAYPAL GENERAL UNRESTR,PayPal fees,OFFICE/GENERAL ADMINISTRATIVE EXPENSES:PayPal Fees,PayPal Bank 3,$0.93 ,"$969,999.60 "
PayPal Bank 3,9/22/23,Deposit,4JL04943YH006240P,04 PAYPAL GENERAL UNRESTR,"Subject: GeneralPage
Transaction ID: 4JL04943YH006240P
https://www.paypal.com/activity/payment/4JL04943YH006240P",PayPal Bank 3,--,$14.76 ,"$970,014.36 "
Donations directed by individuals,9/22/23,Deposit,4JL04943YH006240P,04 PAYPAL GENERAL UNRESTR,Support Ukraine - Support Ukraine,Contributed income:Donations directed by individuals,PayPal Bank 3,$15.95 ,"$970,030.31 "
PayPal Fees,9/22/23,Deposit,4JL04943YH006240P,04 PAYPAL GENERAL UNRESTR,PayPal fees,OFFICE/GENERAL ADMINISTRATIVE EXPENSES:PayPal Fees,PayPal Bank 3,$1.19 ,"$970,031.50 "
PayPal Bank 3,9/22/23,Deposit,51M38814SL765063F,04 PAYPAL GENERAL UNRESTR,"Subject: GeneralPage
Transaction ID: 51M38814SL765063F
https://www.paypal.com/activity/payment/51M38814SL765063F",PayPal Bank 3,--,$300.00 ,"$970,331.50 "
Donations directed by individuals,9/22/23,Deposit,51M38814SL765063F,04 PAYPAL GENERAL UNRESTR,Support Ukraine - Support Ukraine,Contributed income:Donations directed by individuals,PayPal Bank 3,$309.43 ,"$970,640.93 "
PayPal Fees,9/22/23,Deposit,51M38814SL765063F,04 PAYPAL GENERAL UNRESTR,PayPal fees,OFFICE/GENERAL ADMINISTRATIVE EXPENSES:PayPal Fees,PayPal Bank 3,$9.43 ,"$970,650.36 "
PayPal Bank 3,9/22/23,Deposit,05499389C0518881F,04 PAYPAL GENERAL UNRESTR,"Subject: GeneralPage
Transaction ID: 05499389C0518881F
https://www.paypal.com/activity/payment/05499389C0518881F",PayPal Bank 3,--,$95.12 ,"$970,745.48 "
Donations directed by individuals,9/22/23,Deposit,05499389C0518881F,04 PAYPAL GENERAL UNRESTR,Support Ukraine - Support Ukraine,Contributed income:Donations directed by individuals,PayPal Bank 3,$100.00 ,"$970,845.48 "
PayPal Fees,9/22/23,Deposit,05499389C0518881F,04 PAYPAL GENERAL UNRESTR,PayPal fees,OFFICE/GENERAL ADMINISTRATIVE EXPENSES:PayPal Fees,PayPal Bank 3,$4.88 ,"$970,850.36 "
PayPal Bank 3,9/22/23,Deposit,1XT62662FB366225Y,04 PAYPAL GENERAL UNRESTR,"Subject: GeneralPage
Note: Ми переможемо.
Transaction ID: 1XT62662FB366225Y
https://www.paypal.com/activity/payment/1XT62662FB366225Y",PayPal Bank 3,--,$190.73 ,"$971,041.09 "
Donations directed by individuals,9/22/23,Deposit,1XT62662FB366225Y,04 PAYPAL GENERAL UNRESTR,Support Ukraine - Support Ukraine,Contributed income:Donations directed by individuals,PayPal Bank 3,$200.00 ,"$971,241.09 "
PayPal Fees,9/22/23,Deposit,1XT62662FB366225Y,04 PAYPAL GENERAL UNRESTR,PayPal fees,OFFICE/GENERAL ADMINISTRATIVE EXPENSES:PayPal Fees,PayPal Bank 3,$9.27 ,"$971,250.36 "
PayPal Bank 3,9/22/23,Deposit,0Y733672AJ748812W,08 VICTORY DRONES RESTR,"Subject: VICTORY DRONES
Transaction ID: 0Y733672AJ748812W
https://www.paypal.com/activity/payment/0Y733672AJ748812W",PayPal Bank 3,--,$100.00 ,"$971,350.36 "
Donations directed by individuals,9/22/23,Deposit,0Y733672AJ748812W,08 VICTORY DRONES RESTR,Money in to PayPal,Contributed income:Donations directed by individuals,PayPal Bank 3,$103.48 ,"$971,453.84 "
PayPal Fees,9/22/23,Deposit,0Y733672AJ748812W,08 VICTORY DRONES RESTR,PayPal fees,OFFICE/GENERAL ADMINISTRATIVE EXPENSES:PayPal Fees,PayPal Bank 3,$3.48 ,"$971,457.32 "
PayPal Bank 3,9/22/23,Deposit,7HB57059SM714743R,07 1000 DRONES RESTR,"Subject: 1000DRONES
Note: Слава героям
Transaction ID: 7HB57059SM714743R
https://www.paypal.com/activity/payment/7HB57059SM714743R",PayPal Bank 3,--,$50.00 ,"$971,507.32 "
Donations directed by individuals,9/22/23,Deposit,7HB57059SM714743R,07 1000 DRONES RESTR,1000 DRONES FOR UKRAINE - 1000 DRONES FOR UKRAINE,Contributed income:Donations directed by individuals,PayPal Bank 3,$51.99 ,"$971,559.31 "
PayPal Fees,9/22/23,Deposit,7HB57059SM714743R,07 1000 DRONES RESTR,PayPal fees,OFFICE/GENERAL ADMINISTRATIVE EXPENSES:PayPal Fees,PayPal Bank 3,$1.99 ,"$971,561.30 "
PayPal Bank 3,9/22/23,Deposit,22T99695A3220662T,04 PAYPAL GENERAL UNRESTR,"Subject: GeneralPage
Transaction ID: 22T99695A3220662T
https://www.paypal.com/activity/payment/22T99695A3220662T",PayPal Bank 3,--,$50.00 ,"$971,611.30 "
Donations directed by individuals,9/22/23,Deposit,22T99695A3220662T,04 PAYPAL GENERAL UNRESTR,Support Ukraine - Support Ukraine,Contributed income:Donations directed by individuals,PayPal Bank 3,$51.99 ,"$971,663.29 "
PayPal Fees,9/22/23,Deposit,22T99695A3220662T,04 PAYPAL GENERAL UNRESTR,PayPal fees,OFFICE/GENERAL ADMINISTRATIVE EXPENSES:PayPal Fees,PayPal Bank 3,$1.99 ,"$971,665.28 "
PayPal Bank 3,9/22/23,Deposit,6J042545AX873720B,04 PAYPAL GENERAL UNRESTR,"Subject: GeneralPage
Transaction ID: 6J042545AX873720B
https://www.paypal.com/activity/payment/6J042545AX873720B",PayPal Bank 3,--,$10.00 ,"$971,675.28 "
Donations directed by individuals,9/22/23,Deposit,6J042545AX873720B,04 PAYPAL GENERAL UNRESTR,Support Ukraine - Support Ukraine,Contributed income:Donations directed by individuals,PayPal Bank 3,$10.80 ,"$971,686.08 "
PayPal Fees,9/22/23,Deposit,6J042545AX873720B,04 PAYPAL GENERAL UNRESTR,PayPal fees,OFFICE/GENERAL ADMINISTRATIVE EXPENSES:PayPal Fees,PayPal Bank 3,$0.80 ,"$971,686.88 "
PayPal Bank 3,9/22/23,Deposit,7E143065673282902,04 PAYPAL GENERAL UNRESTR,"Subject: GeneralPage
Transaction ID: 7E143065673282902
https://www.paypal.com/activity/payment/7E143065673282902",PayPal Bank 3,--,$4.29 ,"$971,691.17 "
Donations directed by individuals,9/22/23,Deposit,7E143065673282902,04 PAYPAL GENERAL UNRESTR,Support Ukraine - Support Ukraine,Contributed income:Donations directed by individuals,PayPal Bank 3,$5.00 ,"$971,696.17 "
PayPal Fees,9/22/23,Deposit,7E143065673282902,04 PAYPAL GENERAL UNRESTR,PayPal fees,OFFICE/GENERAL ADMINISTRATIVE EXPENSES:PayPal Fees,PayPal Bank 3,$0.71 ,"$971,696.88 "
PayPal Bank 3,9/22/23,Deposit,3LT35620N3992273U,04 PAYPAL GENERAL UNRESTR,"Subject: GeneralPage
Transaction ID: 3LT35620N3992273U
https://www.paypal.com/activity/payment/3LT35620N3992273U",PayPal Bank 3,--,$19.68 ,"$971,716.56 "
Donations directed by individuals,9/22/23,Deposit,3LT35620N3992273U,04 PAYPAL GENERAL UNRESTR,Support Ukraine - Support Ukraine,Contributed income:Donations directed by individuals,PayPal Bank 3,$21.10 ,"$971,737.66 "
PayPal Fees,9/22/23,Deposit,3LT35620N3992273U,04 PAYPAL GENERAL UNRESTR,PayPal fees,OFFICE/GENERAL ADMINISTRATIVE EXPENSES:PayPal Fees,PayPal Bank 3,$1.42 ,"$971,739.08 "
PayPal Bank 3,9/22/23,Deposit,68E79011LT664441F,04 PAYPAL GENERAL UNRESTR,"Subject: GeneralPage
Transaction ID: 68E79011LT664441F
https://www.paypal.com/activity/payment/68E79011LT664441F",PayPal Bank 3,--,$9.84 ,"$971,748.92 "
Donations directed by individuals,9/22/23,Deposit,68E79011LT664441F,04 PAYPAL GENERAL UNRESTR,Support Ukraine - Support Ukraine,Contributed income:Donations directed by individuals,PayPal Bank 3,$10.80 ,"$971,759.72 "
PayPal Fees,9/22/23,Deposit,68E79011LT664441F,04 PAYPAL GENERAL UNRESTR,PayPal fees,OFFICE/GENERAL ADMINISTRATIVE EXPENSES:PayPal Fees,PayPal Bank 3,$0.96 ,"$971,760.68 "
PayPal Bank 3,9/22/23,Deposit,62U70074NG588442W,04 PAYPAL GENERAL UNRESTR,"Subject: Support Ukraine
Transaction ID: 62U70074NG588442W
https://www.paypal.com/activity/payment/62U70074NG588442W",PayPal Bank 3,--,$9.84 ,"$971,770.52 "
Donations directed by individuals,9/22/23,Deposit,62U70074NG588442W,04 PAYPAL GENERAL UNRESTR,Money in to PayPal,Contributed income:Donations directed by individuals,PayPal Bank 3,$10.80 ,"$971,781.32 "
PayPal Fees,9/22/23,Deposit,62U70074NG588442W,04 PAYPAL GENERAL UNRESTR,PayPal fees,OFFICE/GENERAL ADMINISTRATIVE EXPENSES:PayPal Fees,PayPal Bank 3,$0.96 ,"$971,782.28 "
PayPal Bank 3,9/22/23,Deposit,88R446250Y7316242,04 PAYPAL GENERAL UNRESTR,"Subject: Support Ukraine
Transaction ID: 88R446250Y7316242
https://www.paypal.com/activity/payment/88R446250Y7316242",PayPal Bank 3,--,$24.61 ,"$971,806.89 "
Donations directed by individuals,9/22/23,Deposit,88R446250Y7316242,04 PAYPAL GENERAL UNRESTR,Money in to PayPal,Contributed income:Donations directed by individuals,PayPal Bank 3,$26.25 ,"$971,833.14 "
PayPal Fees,9/22/23,Deposit,88R446250Y7316242,04 PAYPAL GENERAL UNRESTR,PayPal fees,OFFICE/GENERAL ADMINISTRATIVE EXPENSES:PayPal Fees,PayPal Bank 3,$1.64 ,"$971,834.78 "
PayPal Bank 3,9/22/23,Deposit,4DU45549MF817090U,04 PAYPAL GENERAL UNRESTR,"Subject: GeneralPage
Transaction ID: 4DU45549MF817090U
https://www.paypal.com/activity/payment/4DU45549MF817090U",PayPal Bank 3,--,$295.36 ,"$972,130.14 "
Donations directed by individuals,9/22/23,Deposit,4DU45549MF817090U,04 PAYPAL GENERAL UNRESTR,Support Ukraine - Support Ukraine,Contributed income:Donations directed by individuals,PayPal Bank 3,$309.43 ,"$972,439.57 "
PayPal Fees,9/22/23,Deposit,4DU45549MF817090U,04 PAYPAL GENERAL UNRESTR,PayPal fees,OFFICE/GENERAL ADMINISTRATIVE EXPENSES:PayPal Fees,PayPal Bank 3,$14.07 ,"$972,453.64 "
PayPal Bank 3,9/22/23,Deposit,37M9982877917680H,04 PAYPAL GENERAL UNRESTR,"Subject: GeneralPage
Transaction ID: 37M9982877917680H
https://www.paypal.com/activity/payment/37M9982877917680H",PayPal Bank 3,--,$47.31 ,"$972,500.95 "
Donations directed by individuals,9/22/23,Deposit,37M9982877917680H,04 PAYPAL GENERAL UNRESTR,Support Ukraine - Support Ukraine,Contributed income:Donations directed by individuals,PayPal Bank 3,$50.00 ,"$972,550.95 "
PayPal Fees,9/22/23,Deposit,37M9982877917680H,04 PAYPAL GENERAL UNRESTR,PayPal fees,OFFICE/GENERAL ADMINISTRATIVE EXPENSES:PayPal Fees,PayPal Bank 3,$2.69 ,"$972,553.64 "
PayPal Bank 3,9/22/23,Deposit,2J0737363Y461772B,04 PAYPAL GENERAL UNRESTR,"Subject: GeneralPage
Transaction ID: 2J0737363Y461772B
https://www.paypal.com/activity/payment/2J0737363Y461772B",PayPal Bank 3,--,$50.00 ,"$972,603.64 "
Donations directed by individuals,9/22/23,Deposit,2J0737363Y461772B,04 PAYPAL GENERAL UNRESTR,Support Ukraine - Support Ukraine,Contributed income:Donations directed by individuals,PayPal Bank 3,$51.99 ,"$972,655.63 "
PayPal Fees,9/22/23,Deposit,2J0737363Y461772B,04 PAYPAL GENERAL UNRESTR,PayPal fees,OFFICE/GENERAL ADMINISTRATIVE EXPENSES:PayPal Fees,PayPal Bank 3,$1.99 ,"$972,657.62 "
PayPal Bank 3,9/22/23,Deposit,8DP06760HA213550T,04 PAYPAL GENERAL UNRESTR,"Subject: GeneralPage
Transaction ID: 8DP06760HA213550T
https://www.paypal.com/activity/payment/8DP06760HA213550T",PayPal Bank 3,--,$95.12 ,"$972,752.74 "
Donations directed by individuals,9/22/23,Deposit,8DP06760HA213550T,04 PAYPAL GENERAL UNRESTR,Support Ukraine - Support Ukraine,Contributed income:Donations directed by individuals,PayPal Bank 3,$100.00 ,"$972,852.74 "
PayPal Fees,9/22/23,Deposit,8DP06760HA213550T,04 PAYPAL GENERAL UNRESTR,PayPal fees,OFFICE/GENERAL ADMINISTRATIVE EXPENSES:PayPal Fees,PayPal Bank 3,$4.88 ,"$972,857.62 "
PayPal Bank 3,9/22/23,Deposit,79T58871KV7282044,04 PAYPAL GENERAL UNRESTR,"Subject: GeneralPage
Note: Donation
Transaction ID: 79T58871KV7282044
https://www.paypal.com/activity/payment/79T58871KV7282044",PayPal Bank 3,--,$49.22 ,"$972,906.84 "
Donations directed by individuals,9/22/23,Deposit,79T58871KV7282044,04 PAYPAL GENERAL UNRESTR,Support Ukraine - Support Ukraine,Contributed income:Donations directed by individuals,PayPal Bank 3,$51.99 ,"$972,958.83 "
PayPal Fees,9/22/23,Deposit,79T58871KV7282044,04 PAYPAL GENERAL UNRESTR,PayPal fees,OFFICE/GENERAL ADMINISTRATIVE EXPENSES:PayPal Fees,PayPal Bank 3,$2.77 ,"$972,961.60 "
PayPal Bank 3,9/22/23,Deposit,18A67829770385820,07 1000 DRONES RESTR,"Subject: GeneralPage
Note: На дрони
Transaction ID: 18A67829770385820
https://www.paypal.com/activity/payment/18A67829770385820",PayPal Bank 3,--,$60.00 ,"$973,021.60 "
Donations directed by individuals,9/22/23,Deposit,18A67829770385820,07 1000 DRONES RESTR,Support Ukraine - Support Ukraine,Contributed income:Donations directed by individuals,PayPal Bank 3,$62.29 ,"$973,083.89 "
PayPal Fees,9/22/23,Deposit,18A67829770385820,07 1000 DRONES RESTR,PayPal fees,OFFICE/GENERAL ADMINISTRATIVE EXPENSES:PayPal Fees,PayPal Bank 3,$2.29 ,"$973,086.18 "
PayPal Bank 3,9/22/23,Deposit,6T766570VD482513B,04 PAYPAL GENERAL UNRESTR,"Subject: GeneralPage
Transaction ID: 6T766570VD482513B
https://www.paypal.com/activity/payment/6T766570VD482513B",PayPal Bank 3,--,"$1,000.00 ","$974,086.18 "
Donations directed by individuals,9/22/23,Deposit,6T766570VD482513B,04 PAYPAL GENERAL UNRESTR,Support Ukraine - Support Ukraine,Contributed income:Donations directed by individuals,PayPal Bank 3,"$1,030.26 ","$975,116.44 "
PayPal Fees,9/22/23,Deposit,6T766570VD482513B,04 PAYPAL GENERAL UNRESTR,PayPal fees,OFFICE/GENERAL ADMINISTRATIVE EXPENSES:PayPal Fees,PayPal Bank 3,$30.26 ,"$975,146.70 "
PayPal Bank 3,9/22/23,Deposit,55A40333WE240125A,04 PAYPAL GENERAL UNRESTR,"Subject: GeneralPage
Transaction ID: 55A40333WE240125A
https://www.paypal.com/activity/payment/55A40333WE240125A",PayPal Bank 3,--,$100.00 ,"$975,246.70 "
Donations directed by individuals,9/22/23,Deposit,55A40333WE240125A,04 PAYPAL GENERAL UNRESTR,Support Ukraine - Support Ukraine,Contributed income:Donations directed by individuals,PayPal Bank 3,$103.48 ,"$975,350.18 "
PayPal Fees,9/22/23,Deposit,55A40333WE240125A,04 PAYPAL GENERAL UNRESTR,PayPal fees,OFFICE/GENERAL ADMINISTRATIVE EXPENSES:PayPal Fees,PayPal Bank 3,$3.48 ,"$975,353.66 "
PayPal Bank 3,9/22/23,Deposit,6FG66895L05966507,04 PAYPAL GENERAL UNRESTR,"Subject: GeneralPage
Transaction ID: 6FG66895L05966507
https://www.paypal.com/activity/payment/6FG66895L05966507",PayPal Bank 3,--,$9.22 ,"$975,362.88 "
Donations directed by individuals,9/22/23,Deposit,6FG66895L05966507,04 PAYPAL GENERAL UNRESTR,Support Ukraine - Support Ukraine,Contributed income:Donations directed by individuals,PayPal Bank 3,$10.00 ,"$975,372.88 "
PayPal Fees,9/22/23,Deposit,6FG66895L05966507,04 PAYPAL GENERAL UNRESTR,PayPal fees,OFFICE/GENERAL ADMINISTRATIVE EXPENSES:PayPal Fees,PayPal Bank 3,$0.78 ,"$975,373.66 "
PayPal Bank 3,9/22/23,Deposit,1YC99974WR7018030,04 PAYPAL GENERAL UNRESTR,"Subject: GeneralPage
Transaction ID: 1YC99974WR7018030
https://www.paypal.com/activity/payment/1YC99974WR7018030",PayPal Bank 3,--,$309.29 ,"$975,682.95 "
Donations directed by individuals,9/22/23,Deposit,1YC99974WR7018030,04 PAYPAL GENERAL UNRESTR,Support Ukraine - Support Ukraine,Contributed income:Donations directed by individuals,PayPal Bank 3,$324.00 ,"$976,006.95 "
PayPal Fees,9/22/23,Deposit,1YC99974WR7018030,04 PAYPAL GENERAL UNRESTR,PayPal fees,OFFICE/GENERAL ADMINISTRATIVE EXPENSES:PayPal Fees,PayPal Bank 3,$14.71 ,"$976,021.66 "
PayPal Bank 3,9/22/23,Deposit,8MT22434X3405901G,04 PAYPAL GENERAL UNRESTR,"Subject: GeneralPage
Transaction ID: 8MT22434X3405901G
https://www.paypal.com/activity/payment/8MT22434X3405901G",PayPal Bank 3,--,$200.00 ,"$976,221.66 "
Donations directed by individuals,9/22/23,Deposit,8MT22434X3405901G,04 PAYPAL GENERAL UNRESTR,Support Ukraine - Support Ukraine,Contributed income:Donations directed by individuals,PayPal Bank 3,$206.46 ,"$976,428.12 "
PayPal Fees,9/22/23,Deposit,8MT22434X3405901G,04 PAYPAL GENERAL UNRESTR,PayPal fees,OFFICE/GENERAL ADMINISTRATIVE EXPENSES:PayPal Fees,PayPal Bank 3,$6.46 ,"$976,434.58 "
PayPal Bank 3,9/22/23,Deposit,7PB45841N2255362C,04 PAYPAL GENERAL UNRESTR,"Subject: GeneralPage
Transaction ID: 7PB45841N2255362C
https://www.paypal.com/activity/payment/7PB45841N2255362C",PayPal Bank 3,--,$50.00 ,"$976,484.58 "
Donations directed by individuals,9/22/23,Deposit,7PB45841N2255362C,04 PAYPAL GENERAL UNRESTR,Support Ukraine - Support Ukraine,Contributed income:Donations directed by individuals,PayPal Bank 3,$51.99 ,"$976,536.57 "
PayPal Fees,9/22/23,Deposit,7PB45841N2255362C,04 PAYPAL GENERAL UNRESTR,PayPal fees,OFFICE/GENERAL ADMINISTRATIVE EXPENSES:PayPal Fees,PayPal Bank 3,$1.99 ,"$976,538.56 "
PayPal Bank 3,9/22/23,Deposit,650606103C4454220,04 PAYPAL GENERAL UNRESTR,"Subject: GeneralPage
Transaction ID: 650606103C4454220
https://www.paypal.com/activity/payment/650606103C4454220",PayPal Bank 3,--,$4.29 ,"$976,542.85 "
Donations directed by individuals,9/22/23,Deposit,650606103C4454220,04 PAYPAL GENERAL UNRESTR,Support Ukraine - Support Ukraine,Contributed income:Donations directed by individuals,PayPal Bank 3,$5.00 ,"$976,547.85 "
PayPal Fees,9/22/23,Deposit,650606103C4454220,04 PAYPAL GENERAL UNRESTR,PayPal fees,OFFICE/GENERAL ADMINISTRATIVE EXPENSES:PayPal Fees,PayPal Bank 3,$0.71 ,"$976,548.56 "
PayPal Bank 3,9/22/23,Deposit,0DL42607RN849551L,07 1000 DRONES RESTR,"Subject: 1000DRONES
Note: Please, use it for 1000 drones project
Transaction ID: 0DL42607RN849551L
https://www.paypal.com/activity/payment/0DL42607RN849551L",PayPal Bank 3,--,$250.00 ,"$976,798.56 "
Donations directed by individuals,9/22/23,Deposit,0DL42607RN849551L,07 1000 DRONES RESTR,1000 DRONES FOR UKRAINE - 1000 DRONES FOR UKRAINE,Contributed income:Donations directed by individuals,PayPal Bank 3,$257.94 ,"$977,056.50 "
PayPal Fees,9/22/23,Deposit,0DL42607RN849551L,07 1000 DRONES RESTR,PayPal fees,OFFICE/GENERAL ADMINISTRATIVE EXPENSES:PayPal Fees,PayPal Bank 3,$7.94 ,"$977,064.44 "
PayPal Bank 3,9/22/23,Deposit,46R29326G5970974T,04 PAYPAL GENERAL UNRESTR,"Subject: GeneralPage
Transaction ID: 46R29326G5970974T
https://www.paypal.com/activity/payment/46R29326G5970974T",PayPal Bank 3,--,$196.91 ,"$977,261.35 "
Donations directed by individuals,9/22/23,Deposit,46R29326G5970974T,04 PAYPAL GENERAL UNRESTR,Support Ukraine - Support Ukraine,Contributed income:Donations directed by individuals,PayPal Bank 3,$206.46 ,"$977,467.81 "
PayPal Fees,9/22/23,Deposit,46R29326G5970974T,04 PAYPAL GENERAL UNRESTR,PayPal fees,OFFICE/GENERAL ADMINISTRATIVE EXPENSES:PayPal Fees,PayPal Bank 3,$9.55 ,"$977,477.36 "
PayPal Bank 3,9/22/23,Deposit,5JV46588W6831142V,04 PAYPAL GENERAL UNRESTR,"Subject: GeneralPage
Transaction ID: 5JV46588W6831142V
https://www.paypal.com/activity/payment/5JV46588W6831142V",PayPal Bank 3,--,$59.07 ,"$977,536.43 "
Donations directed by individuals,9/22/23,Deposit,5JV46588W6831142V,04 PAYPAL GENERAL UNRESTR,Support Ukraine - Support Ukraine,Contributed income:Donations directed by individuals,PayPal Bank 3,$62.29 ,"$977,598.72 "
PayPal Fees,9/22/23,Deposit,5JV46588W6831142V,04 PAYPAL GENERAL UNRESTR,PayPal fees,OFFICE/GENERAL ADMINISTRATIVE EXPENSES:PayPal Fees,PayPal Bank 3,$3.22 ,"$977,601.94 "
PayPal Bank 3,9/22/23,Deposit,9Y845883Y0615392K,07 1000 DRONES RESTR,"Subject: 1000DRONES
Transaction ID: 9Y845883Y0615392K
https://www.paypal.com/activity/payment/9Y845883Y0615392K",PayPal Bank 3,--,$96.62 ,"$977,698.56 "
Donations directed by individuals,9/22/23,Deposit,9Y845883Y0615392K,07 1000 DRONES RESTR,1000 DRONES FOR UKRAINE - 1000 DRONES FOR UKRAINE,Contributed income:Donations directed by individuals,PayPal Bank 3,$100.00 ,"$977,798.56 "
PayPal Fees,9/22/23,Deposit,9Y845883Y0615392K,07 1000 DRONES RESTR,PayPal fees,OFFICE/GENERAL ADMINISTRATIVE EXPENSES:PayPal Fees,PayPal Bank 3,$3.38 ,"$977,801.94 "
PayPal Bank 3,9/22/23,Deposit,0G042750TL522281W,04 PAYPAL GENERAL UNRESTR,"Subject: GeneralPage
Transaction ID: 0G042750TL522281W
https://www.paypal.com/activity/payment/0G042750TL522281W",PayPal Bank 3,--,$50.00 ,"$977,851.94 "
Donations directed by individuals,9/22/23,Deposit,0G042750TL522281W,04 PAYPAL GENERAL UNRESTR,Support Ukraine - Support Ukraine,Contributed income:Donations directed by individuals,PayPal Bank 3,$51.99 ,"$977,903.93 "
PayPal Fees,9/22/23,Deposit,0G042750TL522281W,04 PAYPAL GENERAL UNRESTR,PayPal fees,OFFICE/GENERAL ADMINISTRATIVE EXPENSES:PayPal Fees,PayPal Bank 3,$1.99 ,"$977,905.92 "
PayPal Bank 3,9/22/23,Deposit,4EF86051BH146503E,04 PAYPAL GENERAL UNRESTR,"Subject: GeneralPage
Transaction ID: 4EF86051BH146503E
https://www.paypal.com/activity/payment/4EF86051BH146503E",PayPal Bank 3,--,$9.84 ,"$977,915.76 "
Donations directed by individuals,9/22/23,Deposit,4EF86051BH146503E,04 PAYPAL GENERAL UNRESTR,Support Ukraine - Support Ukraine,Contributed income:Donations directed by individuals,PayPal Bank 3,$10.80 ,"$977,926.56 "
PayPal Fees,9/22/23,Deposit,4EF86051BH146503E,04 PAYPAL GENERAL UNRESTR,PayPal fees,OFFICE/GENERAL ADMINISTRATIVE EXPENSES:PayPal Fees,PayPal Bank 3,$0.96 ,"$977,927.52 "
PayPal Bank 3,9/22/23,Deposit,21U29675HP241023U,04 PAYPAL GENERAL UNRESTR,"Subject: GeneralPage
Note: Thank you for the t-shirt!
Transaction ID: 21U29675HP241023U
https://www.paypal.com/activity/payment/21U29675HP241023U",PayPal Bank 3,--,$50.00 ,"$977,977.52 "
Donations directed by individuals,9/22/23,Deposit,21U29675HP241023U,04 PAYPAL GENERAL UNRESTR,Support Ukraine - Support Ukraine,Contributed income:Donations directed by individuals,PayPal Bank 3,$51.99 ,"$978,029.51 "
PayPal Fees,9/22/23,Deposit,21U29675HP241023U,04 PAYPAL GENERAL UNRESTR,PayPal fees,OFFICE/GENERAL ADMINISTRATIVE EXPENSES:PayPal Fees,PayPal Bank 3,$1.99 ,"$978,031.50 "
PayPal Bank 3,9/22/23,Deposit,9YP68072543870357,04 PAYPAL GENERAL UNRESTR,"Subject: GeneralPage
Note: Slava Ukraine
Transaction ID: 9YP68072543870357
https://www.paypal.com/activity/payment/9YP68072543870357",PayPal Bank 3,--,$47.31 ,"$978,078.81 "
Donations directed by individuals,9/22/23,Deposit,9YP68072543870357,04 PAYPAL GENERAL UNRESTR,Support Ukraine - Support Ukraine,Contributed income:Donations directed by individuals,PayPal Bank 3,$50.00 ,"$978,128.81 "
PayPal Fees,9/22/23,Deposit,9YP68072543870357,04 PAYPAL GENERAL UNRESTR,PayPal fees,OFFICE/GENERAL ADMINISTRATIVE EXPENSES:PayPal Fees,PayPal Bank 3,$2.69 ,"$978,131.50 "
PayPal Bank 3,9/22/23,Deposit,7KG23107D52272627,08 VICTORY DRONES RESTR,"Subject: VictoryDrones
Transaction ID: 7KG23107D52272627
https://www.paypal.com/activity/payment/7KG23107D52272627",PayPal Bank 3,--,$147.68 ,"$978,279.18 "
Donations directed by individuals,9/22/23,Deposit,7KG23107D52272627,08 VICTORY DRONES RESTR,VICTORY DRONES - VICTORY DRONES,Contributed income:Donations directed by individuals,PayPal Bank 3,$154.97 ,"$978,434.15 "
PayPal Fees,9/22/23,Deposit,7KG23107D52272627,08 VICTORY DRONES RESTR,PayPal fees,OFFICE/GENERAL ADMINISTRATIVE EXPENSES:PayPal Fees,PayPal Bank 3,$7.29 ,"$978,441.44 "
PayPal Bank 3,9/22/23,Deposit,6WD9090860272945L,07 1000 DRONES RESTR,"Subject: 1000 DRONES FOR UKRAINE
Transaction ID: 6WD9090860272945L
https://www.paypal.com/activity/payment/6WD9090860272945L",PayPal Bank 3,--,$24.61 ,"$978,466.05 "
Donations directed by individuals,9/22/23,Deposit,6WD9090860272945L,07 1000 DRONES RESTR,Money in to PayPal,Contributed income:Donations directed by individuals,PayPal Bank 3,$26.25 ,"$978,492.30 "
PayPal Fees,9/22/23,Deposit,6WD9090860272945L,07 1000 DRONES RESTR,PayPal fees,OFFICE/GENERAL ADMINISTRATIVE EXPENSES:PayPal Fees,PayPal Bank 3,$1.64 ,"$978,493.94 "
PayPal Bank 3,9/22/23,Deposit,8K996993MM0083000,04 PAYPAL GENERAL UNRESTR,"Subject: GeneralPage
Transaction ID: 8K996993MM0083000
https://www.paypal.com/activity/payment/8K996993MM0083000",PayPal Bank 3,--,$18.63 ,"$978,512.57 "
Donations directed by individuals,9/22/23,Deposit,8K996993MM0083000,04 PAYPAL GENERAL UNRESTR,Support Ukraine - Support Ukraine,Contributed income:Donations directed by individuals,PayPal Bank 3,$20.00 ,"$978,532.57 "
PayPal Fees,9/22/23,Deposit,8K996993MM0083000,04 PAYPAL GENERAL UNRESTR,PayPal fees,OFFICE/GENERAL ADMINISTRATIVE EXPENSES:PayPal Fees,PayPal Bank 3,$1.37 ,"$978,533.94 "
PayPal Bank 3,9/22/23,Deposit,7MW98715D4012090M,04 PAYPAL GENERAL UNRESTR,"Transaction ID: 7MW98715D4012090M
https://www.paypal.com/activity/payment/7MW98715D4012090M",PayPal Bank 3,--,"$1,486.04 ","$980,019.98 "
Donations directed by individuals,9/22/23,Deposit,7MW98715D4012090M,04 PAYPAL GENERAL UNRESTR,Money in to PayPal,Contributed income:Donations directed by individuals,PayPal Bank 3,"$1,555.90 ","$981,575.88 "
PayPal Fees,9/22/23,Deposit,7MW98715D4012090M,04 PAYPAL GENERAL UNRESTR,PayPal fees,OFFICE/GENERAL ADMINISTRATIVE EXPENSES:PayPal Fees,PayPal Bank 3,$69.86 ,"$981,645.74 "
PayPal Bank 3,9/22/23,Deposit,4423625751190935J,04 PAYPAL GENERAL UNRESTR,"Subject: GeneralPage
Transaction ID: 4423625751190935J
https://www.paypal.com/activity/payment/4423625751190935J",PayPal Bank 3,--,$485.06 ,"$982,130.80 "
Donations directed by individuals,9/22/23,Deposit,4423625751190935J,04 PAYPAL GENERAL UNRESTR,Support Ukraine - Support Ukraine,Contributed income:Donations directed by individuals,PayPal Bank 3,$500.00 ,"$982,630.80 "
PayPal Fees,9/22/23,Deposit,4423625751190935J,04 PAYPAL GENERAL UNRESTR,PayPal fees,OFFICE/GENERAL ADMINISTRATIVE EXPENSES:PayPal Fees,PayPal Bank 3,$14.94 ,"$982,645.74 "
PayPal Bank 3,9/22/23,Deposit,5W864208RS8400105,04 PAYPAL GENERAL UNRESTR,"Subject: GeneralPage
Transaction ID: 5W864208RS8400105
https://www.paypal.com/activity/payment/5W864208RS8400105",PayPal Bank 3,--,$18.93 ,"$982,664.67 "
Donations directed by individuals,9/22/23,Deposit,5W864208RS8400105,04 PAYPAL GENERAL UNRESTR,Support Ukraine - Support Ukraine,Contributed income:Donations directed by individuals,PayPal Bank 3,$20.00 ,"$982,684.67 "
PayPal Fees,9/22/23,Deposit,5W864208RS8400105,04 PAYPAL GENERAL UNRESTR,PayPal fees,OFFICE/GENERAL ADMINISTRATIVE EXPENSES:PayPal Fees,PayPal Bank 3,$1.07 ,"$982,685.74 "
PayPal Bank 3,9/22/23,Deposit,4NE28628HT7618908,04 PAYPAL GENERAL UNRESTR,"Subject: Support Ukraine
Transaction ID: 4NE28628HT7618908
https://www.paypal.com/activity/payment/4NE28628HT7618908",PayPal Bank 3,--,$29.53 ,"$982,715.27 "
Donations directed by individuals,9/22/23,Deposit,4NE28628HT7618908,04 PAYPAL GENERAL UNRESTR,Money in to PayPal,Contributed income:Donations directed by individuals,PayPal Bank 3,$31.40 ,"$982,746.67 "
PayPal Fees,9/22/23,Deposit,4NE28628HT7618908,04 PAYPAL GENERAL UNRESTR,PayPal fees,OFFICE/GENERAL ADMINISTRATIVE EXPENSES:PayPal Fees,PayPal Bank 3,$1.87 ,"$982,748.54 "
PayPal Bank 3,9/22/23,Deposit,9VS7331018499004H,08 VICTORY DRONES RESTR,"Subject: GeneralPage
Note: For Victory Drones! Слава Україні!
Transaction ID: 9VS7331018499004H
https://www.paypal.com/activity/payment/9VS7331018499004H",PayPal Bank 3,--,$246.13 ,"$982,994.67 "
Donations directed by individuals,9/22/23,Deposit,9VS7331018499004H,08 VICTORY DRONES RESTR,Support Ukraine - Support Ukraine,Contributed income:Donations directed by individuals,PayPal Bank 3,$257.94 ,"$983,252.61 "
PayPal Fees,9/22/23,Deposit,9VS7331018499004H,08 VICTORY DRONES RESTR,PayPal fees,OFFICE/GENERAL ADMINISTRATIVE EXPENSES:PayPal Fees,PayPal Bank 3,$11.81 ,"$983,264.42 "
PayPal Bank 3,9/22/23,Deposit,9S703561N7594014R,04 PAYPAL GENERAL UNRESTR,"Subject: GeneralPage
Transaction ID: 9S703561N7594014R
https://www.paypal.com/activity/payment/9S703561N7594014R",PayPal Bank 3,--,$147.68 ,"$983,412.10 "
Donations directed by individuals,9/22/23,Deposit,9S703561N7594014R,04 PAYPAL GENERAL UNRESTR,Support Ukraine - Support Ukraine,Contributed income:Donations directed by individuals,PayPal Bank 3,$154.97 ,"$983,567.07 "
PayPal Fees,9/22/23,Deposit,9S703561N7594014R,04 PAYPAL GENERAL UNRESTR,PayPal fees,OFFICE/GENERAL ADMINISTRATIVE EXPENSES:PayPal Fees,PayPal Bank 3,$7.29 ,"$983,574.36 "
PayPal Bank 3,9/22/23,Deposit,57E40748W0072523J,04 PAYPAL GENERAL UNRESTR,"Subject: GeneralPage
Note: Україна переможе! Дякую вам.
Transaction ID: 57E40748W0072523J
https://www.paypal.com/activity/payment/57E40748W0072523J",PayPal Bank 3,--,$98.45 ,"$983,672.81 "
Donations directed by individuals,9/22/23,Deposit,57E40748W0072523J,04 PAYPAL GENERAL UNRESTR,Support Ukraine - Support Ukraine,Contributed income:Donations directed by individuals,PayPal Bank 3,$103.48 ,"$983,776.29 "
PayPal Fees,9/22/23,Deposit,57E40748W0072523J,04 PAYPAL GENERAL UNRESTR,PayPal fees,OFFICE/GENERAL ADMINISTRATIVE EXPENSES:PayPal Fees,PayPal Bank 3,$5.03 ,"$983,781.32 "
PayPal Bank 3,9/22/23,Deposit,6DW31737BH104914M,08 VICTORY DRONES RESTR,"Subject: VictoryDrones
Note: Victory drones
Transaction ID: 6DW31737BH104914M
https://www.paypal.com/activity/payment/6DW31737BH104914M",PayPal Bank 3,--,$193.73 ,"$983,975.05 "
Donations directed by individuals,9/22/23,Deposit,6DW31737BH104914M,08 VICTORY DRONES RESTR,VICTORY DRONES - VICTORY DRONES,Contributed income:Donations directed by individuals,PayPal Bank 3,$200.00 ,"$984,175.05 "
PayPal Fees,9/22/23,Deposit,6DW31737BH104914M,08 VICTORY DRONES RESTR,PayPal fees,OFFICE/GENERAL ADMINISTRATIVE EXPENSES:PayPal Fees,PayPal Bank 3,$6.27 ,"$984,181.32 "
PayPal Bank 3,9/22/23,Deposit,4XJ339189N125715B,04 PAYPAL GENERAL UNRESTR,"Subject: GeneralPage
Transaction ID: 4XJ339189N125715B
https://www.paypal.com/activity/payment/4XJ339189N125715B",PayPal Bank 3,--,$49.22 ,"$984,230.54 "
Donations directed by individuals,9/22/23,Deposit,4XJ339189N125715B,04 PAYPAL GENERAL UNRESTR,Support Ukraine - Support Ukraine,Contributed income:Donations directed by individuals,PayPal Bank 3,$51.99 ,"$984,282.53 "
PayPal Fees,9/22/23,Deposit,4XJ339189N125715B,04 PAYPAL GENERAL UNRESTR,PayPal fees,OFFICE/GENERAL ADMINISTRATIVE EXPENSES:PayPal Fees,PayPal Bank 3,$2.77 ,"$984,285.30 "
PayPal Bank 3,9/22/23,Deposit,9FF150987J782572T,04 PAYPAL GENERAL UNRESTR,"Subject: GeneralPage
Transaction ID: 9FF150987J782572T
https://www.paypal.com/activity/payment/9FF150987J782572T",PayPal Bank 3,--,$66.44 ,"$984,351.74 "
Donations directed by individuals,9/22/23,Deposit,9FF150987J782572T,04 PAYPAL GENERAL UNRESTR,Support Ukraine - Support Ukraine,Contributed income:Donations directed by individuals,PayPal Bank 3,$70.00 ,"$984,421.74 "
PayPal Fees,9/22/23,Deposit,9FF150987J782572T,04 PAYPAL GENERAL UNRESTR,PayPal fees,OFFICE/GENERAL ADMINISTRATIVE EXPENSES:PayPal Fees,PayPal Bank 3,$3.56 ,"$984,425.30 "
PayPal Bank 3,9/22/23,Deposit,9E318041SD988684F,04 PAYPAL GENERAL UNRESTR,"Subject: GeneralPage
Transaction ID: 9E318041SD988684F
https://www.paypal.com/activity/payment/9E318041SD988684F",PayPal Bank 3,--,$98.45 ,"$984,523.75 "
Donations directed by individuals,9/22/23,Deposit,9E318041SD988684F,04 PAYPAL GENERAL UNRESTR,Support Ukraine - Support Ukraine,Contributed income:Donations directed by individuals,PayPal Bank 3,$103.48 ,"$984,627.23 "
PayPal Fees,9/22/23,Deposit,9E318041SD988684F,04 PAYPAL GENERAL UNRESTR,PayPal fees,OFFICE/GENERAL ADMINISTRATIVE EXPENSES:PayPal Fees,PayPal Bank 3,$5.03 ,"$984,632.26 "
PayPal Bank 3,9/22/23,Deposit,1N261110U16825830,04 PAYPAL GENERAL UNRESTR,"Subject: GeneralPage
Transaction ID: 1N261110U16825830
https://www.paypal.com/activity/payment/1N261110U16825830",PayPal Bank 3,--,$49.22 ,"$984,681.48 "
Donations directed by individuals,9/22/23,Deposit,1N261110U16825830,04 PAYPAL GENERAL UNRESTR,Support Ukraine - Support Ukraine,Contributed income:Donations directed by individuals,PayPal Bank 3,$51.99 ,"$984,733.47 "
PayPal Fees,9/22/23,Deposit,1N261110U16825830,04 PAYPAL GENERAL UNRESTR,PayPal fees,OFFICE/GENERAL ADMINISTRATIVE EXPENSES:PayPal Fees,PayPal Bank 3,$2.77 ,"$984,736.24 "
PayPal Bank 3,9/22/23,Deposit,5U597245KM0471218,04 PAYPAL GENERAL UNRESTR,"Subject: GeneralPage
Transaction ID: 5U597245KM0471218
https://www.paypal.com/activity/payment/5U597245KM0471218",PayPal Bank 3,--,$20.54 ,"$984,756.78 "
Donations directed by individuals,9/22/23,Deposit,5U597245KM0471218,04 PAYPAL GENERAL UNRESTR,Support Ukraine - Support Ukraine,Contributed income:Donations directed by individuals,PayPal Bank 3,$22.00 ,"$984,778.78 "
PayPal Fees,9/22/23,Deposit,5U597245KM0471218,04 PAYPAL GENERAL UNRESTR,PayPal fees,OFFICE/GENERAL ADMINISTRATIVE EXPENSES:PayPal Fees,PayPal Bank 3,$1.46 ,"$984,780.24 "
PayPal Bank 3,9/22/23,Deposit,6T226983A28775126,04 PAYPAL GENERAL UNRESTR,"Subject: GeneralPage
Transaction ID: 6T226983A28775126
https://www.paypal.com/activity/payment/6T226983A28775126",PayPal Bank 3,--,$300.00 ,"$985,080.24 "
Donations directed by individuals,9/22/23,Deposit,6T226983A28775126,04 PAYPAL GENERAL UNRESTR,Support Ukraine - Support Ukraine,Contributed income:Donations directed by individuals,PayPal Bank 3,$309.43 ,"$985,389.67 "
PayPal Fees,9/22/23,Deposit,6T226983A28775126,04 PAYPAL GENERAL UNRESTR,PayPal fees,OFFICE/GENERAL ADMINISTRATIVE EXPENSES:PayPal Fees,PayPal Bank 3,$9.43 ,"$985,399.10 "
PayPal Bank 3,9/22/23,Deposit,9XM70327342792451,07 1000 DRONES RESTR,"Subject: 1000DRONES
Transaction ID: 9XM70327342792451
https://www.paypal.com/activity/payment/9XM70327342792451",PayPal Bank 3,--,$49.22 ,"$985,448.32 "
Donations directed by individuals,9/22/23,Deposit,9XM70327342792451,07 1000 DRONES RESTR,1000 DRONES FOR UKRAINE - 1000 DRONES FOR UKRAINE,Contributed income:Donations directed by individuals,PayPal Bank 3,$51.99 ,"$985,500.31 "
PayPal Fees,9/22/23,Deposit,9XM70327342792451,07 1000 DRONES RESTR,PayPal fees,OFFICE/GENERAL ADMINISTRATIVE EXPENSES:PayPal Fees,PayPal Bank 3,$2.77 ,"$985,503.08 "
PayPal Bank 3,9/22/23,Deposit,1AW929158P195604W,04 PAYPAL GENERAL UNRESTR,"Subject: Support Ukraine
Transaction ID: 1AW929158P195604W
https://www.paypal.com/activity/payment/1AW929158P195604W",PayPal Bank 3,--,$4.29 ,"$985,507.37 "
Donations directed by individuals,9/22/23,Deposit,1AW929158P195604W,04 PAYPAL GENERAL UNRESTR,Money in to PayPal,Contributed income:Donations directed by individuals,PayPal Bank 3,$5.00 ,"$985,512.37 "
PayPal Fees,9/22/23,Deposit,1AW929158P195604W,04 PAYPAL GENERAL UNRESTR,PayPal fees,OFFICE/GENERAL ADMINISTRATIVE EXPENSES:PayPal Fees,PayPal Bank 3,$0.71 ,"$985,513.08 "
PayPal Bank 3,9/22/23,Deposit,83J82022CS994471R,04 PAYPAL GENERAL UNRESTR,"Subject: GeneralPage
Transaction ID: 83J82022CS994471R
https://www.paypal.com/activity/payment/83J82022CS994471R",PayPal Bank 3,--,$500.00 ,"$986,013.08 "
Donations directed by individuals,9/22/23,Deposit,83J82022CS994471R,04 PAYPAL GENERAL UNRESTR,Support Ukraine - Support Ukraine,Contributed income:Donations directed by individuals,PayPal Bank 3,$515.38 ,"$986,528.46 "
PayPal Fees,9/22/23,Deposit,83J82022CS994471R,04 PAYPAL GENERAL UNRESTR,PayPal fees,OFFICE/GENERAL ADMINISTRATIVE EXPENSES:PayPal Fees,PayPal Bank 3,$15.38 ,"$986,543.84 "
PayPal Bank 3,9/22/23,Deposit,65N01829HV1731325,04 PAYPAL GENERAL UNRESTR,"Subject: GeneralPage
Transaction ID: 65N01829HV1731325
https://www.paypal.com/activity/payment/65N01829HV1731325",PayPal Bank 3,--,$49.22 ,"$986,593.06 "
Donations directed by individuals,9/22/23,Deposit,65N01829HV1731325,04 PAYPAL GENERAL UNRESTR,Support Ukraine - Support Ukraine,Contributed income:Donations directed by individuals,PayPal Bank 3,$51.99 ,"$986,645.05 "
PayPal Fees,9/22/23,Deposit,65N01829HV1731325,04 PAYPAL GENERAL UNRESTR,PayPal fees,OFFICE/GENERAL ADMINISTRATIVE EXPENSES:PayPal Fees,PayPal Bank 3,$2.77 ,"$986,647.82 "
PayPal Bank 3,9/22/23,Deposit,76E80618MD4962041,07 1000 DRONES RESTR,"Subject: 1000DRONES
Transaction ID: 76E80618MD4962041
https://www.paypal.com/activity/payment/76E80618MD4962041",PayPal Bank 3,--,$49.22 ,"$986,697.04 "
Donations directed by individuals,9/22/23,Deposit,76E80618MD4962041,07 1000 DRONES RESTR,1000 DRONES FOR UKRAINE - 1000 DRONES FOR UKRAINE,Contributed income:Donations directed by individuals,PayPal Bank 3,$51.99 ,"$986,749.03 "
PayPal Fees,9/22/23,Deposit,76E80618MD4962041,07 1000 DRONES RESTR,PayPal fees,OFFICE/GENERAL ADMINISTRATIVE EXPENSES:PayPal Fees,PayPal Bank 3,$2.77 ,"$986,751.80 "
PayPal Bank 3,9/22/23,Deposit,41V1083753730805F,04 PAYPAL GENERAL UNRESTR,"Subject: GeneralPage
Transaction ID: 41V1083753730805F
https://www.paypal.com/activity/payment/41V1083753730805F",PayPal Bank 3,--,$18.93 ,"$986,770.73 "
Donations directed by individuals,9/22/23,Deposit,41V1083753730805F,04 PAYPAL GENERAL UNRESTR,Support Ukraine - Support Ukraine,Contributed income:Donations directed by individuals,PayPal Bank 3,$20.00 ,"$986,790.73 "
PayPal Fees,9/22/23,Deposit,41V1083753730805F,04 PAYPAL GENERAL UNRESTR,PayPal fees,OFFICE/GENERAL ADMINISTRATIVE EXPENSES:PayPal Fees,PayPal Bank 3,$1.07 ,"$986,791.80 "
PayPal Bank 3,9/22/23,Deposit,3SU43664C50138107,04 PAYPAL GENERAL UNRESTR,"Subject: GeneralPage
Transaction ID: 3SU43664C50138107
https://www.paypal.com/activity/payment/3SU43664C50138107",PayPal Bank 3,--,$20.00 ,"$986,811.80 "
Donations directed by individuals,9/22/23,Deposit,3SU43664C50138107,04 PAYPAL GENERAL UNRESTR,Support Ukraine - Support Ukraine,Contributed income:Donations directed by individuals,PayPal Bank 3,$21.10 ,"$986,832.90 "
PayPal Fees,9/22/23,Deposit,3SU43664C50138107,04 PAYPAL GENERAL UNRESTR,PayPal fees,OFFICE/GENERAL ADMINISTRATIVE EXPENSES:PayPal Fees,PayPal Bank 3,$1.10 ,"$986,834.00 "
PayPal Bank 3,9/22/23,Deposit,3Y9551256X1186001,07 1000 DRONES RESTR,"Subject: 1000DRONES
Transaction ID: 3Y9551256X1186001
https://www.paypal.com/activity/payment/3Y9551256X1186001",PayPal Bank 3,--,$196.91 ,"$987,030.91 "
Donations directed by individuals,9/22/23,Deposit,3Y9551256X1186001,07 1000 DRONES RESTR,1000 DRONES FOR UKRAINE - 1000 DRONES FOR UKRAINE,Contributed income:Donations directed by individuals,PayPal Bank 3,$206.46 ,"$987,237.37 "
PayPal Fees,9/22/23,Deposit,3Y9551256X1186001,07 1000 DRONES RESTR,PayPal fees,OFFICE/GENERAL ADMINISTRATIVE EXPENSES:PayPal Fees,PayPal Bank 3,$9.55 ,"$987,246.92 "
PayPal Bank 3,9/22/23,Deposit,49V12490S3183652S,04 PAYPAL GENERAL UNRESTR,"Subject: GeneralPage
Transaction ID: 49V12490S3183652S
https://www.paypal.com/activity/payment/49V12490S3183652S",PayPal Bank 3,--,$106.33 ,"$987,353.25 "
Donations directed by individuals,9/22/23,Deposit,49V12490S3183652S,04 PAYPAL GENERAL UNRESTR,Support Ukraine - Support Ukraine,Contributed income:Donations directed by individuals,PayPal Bank 3,$110.00 ,"$987,463.25 "
PayPal Fees,9/22/23,Deposit,49V12490S3183652S,04 PAYPAL GENERAL UNRESTR,PayPal fees,OFFICE/GENERAL ADMINISTRATIVE EXPENSES:PayPal Fees,PayPal Bank 3,$3.67 ,"$987,466.92 "
PayPal Bank 3,9/22/23,Deposit,8Y840893KY298122U,07 1000 DRONES RESTR,"Subject: 1000DRONES
Transaction ID: 8Y840893KY298122U
https://www.paypal.com/activity/payment/8Y840893KY298122U",PayPal Bank 3,--,$100.00 ,"$987,566.92 "
Donations directed by individuals,9/22/23,Deposit,8Y840893KY298122U,07 1000 DRONES RESTR,1000 DRONES FOR UKRAINE - 1000 DRONES FOR UKRAINE,Contributed income:Donations directed by individuals,PayPal Bank 3,$103.48 ,"$987,670.40 "
PayPal Fees,9/22/23,Deposit,8Y840893KY298122U,07 1000 DRONES RESTR,PayPal fees,OFFICE/GENERAL ADMINISTRATIVE EXPENSES:PayPal Fees,PayPal Bank 3,$3.48 ,"$987,673.88 "
PayPal Bank 3,9/22/23,Deposit,0PT420167H4669905,04 PAYPAL GENERAL UNRESTR,"Subject: GeneralPage
Transaction ID: 0PT420167H4669905
https://www.paypal.com/activity/payment/0PT420167H4669905",PayPal Bank 3,--,$13.85 ,"$987,687.73 "
Donations directed by individuals,9/22/23,Deposit,0PT420167H4669905,04 PAYPAL GENERAL UNRESTR,Support Ukraine - Support Ukraine,Contributed income:Donations directed by individuals,PayPal Bank 3,$15.00 ,"$987,702.73 "
PayPal Fees,9/22/23,Deposit,0PT420167H4669905,04 PAYPAL GENERAL UNRESTR,PayPal fees,OFFICE/GENERAL ADMINISTRATIVE EXPENSES:PayPal Fees,PayPal Bank 3,$1.15 ,"$987,703.88 "
PayPal Bank 3,9/22/23,Deposit,61489646BL707764A,04 PAYPAL GENERAL UNRESTR,"Subject: GeneralPage
Transaction ID: 61489646BL707764A
https://www.paypal.com/activity/payment/61489646BL707764A",PayPal Bank 3,--,$47.31 ,"$987,751.19 "
Donations directed by individuals,9/22/23,Deposit,61489646BL707764A,04 PAYPAL GENERAL UNRESTR,Support Ukraine - Support Ukraine,Contributed income:Donations directed by individuals,PayPal Bank 3,$50.00 ,"$987,801.19 "
PayPal Fees,9/22/23,Deposit,61489646BL707764A,04 PAYPAL GENERAL UNRESTR,PayPal fees,OFFICE/GENERAL ADMINISTRATIVE EXPENSES:PayPal Fees,PayPal Bank 3,$2.69 ,"$987,803.88 "
PayPal Bank 3,9/22/23,Deposit,2DY704725L279391V,04 PAYPAL GENERAL UNRESTR,"Subject: Support Ukraine
Transaction ID: 2DY704725L279391V
https://www.paypal.com/activity/payment/2DY704725L279391V",PayPal Bank 3,--,$50.00 ,"$987,853.88 "
Donations directed by individuals,9/22/23,Deposit,2DY704725L279391V,04 PAYPAL GENERAL UNRESTR,Money in to PayPal,Contributed income:Donations directed by individuals,PayPal Bank 3,$51.99 ,"$987,905.87 "
PayPal Fees,9/22/23,Deposit,2DY704725L279391V,04 PAYPAL GENERAL UNRESTR,PayPal fees,OFFICE/GENERAL ADMINISTRATIVE EXPENSES:PayPal Fees,PayPal Bank 3,$1.99 ,"$987,907.86 "
PayPal Bank 3,9/22/23,Deposit,058676124Y1689045,04 PAYPAL GENERAL UNRESTR,"Subject: GeneralPage
Note: Нищити русню!
Transaction ID: 058676124Y1689045
https://www.paypal.com/activity/payment/058676124Y1689045",PayPal Bank 3,--,$196.91 ,"$988,104.77 "
Donations directed by individuals,9/22/23,Deposit,058676124Y1689045,04 PAYPAL GENERAL UNRESTR,Support Ukraine - Support Ukraine,Contributed income:Donations directed by individuals,PayPal Bank 3,$206.46 ,"$988,311.23 "
PayPal Fees,9/22/23,Deposit,058676124Y1689045,04 PAYPAL GENERAL UNRESTR,PayPal fees,OFFICE/GENERAL ADMINISTRATIVE EXPENSES:PayPal Fees,PayPal Bank 3,$9.55 ,"$988,320.78 "
PayPal Bank 3,9/22/23,Deposit,32T35881WU2525456,07 1000 DRONES RESTR,"Subject: 1000DRONES
Note: З Днем Народження, Любо Шипович!
Transaction ID: 32T35881WU2525456
https://www.paypal.com/activity/payment/32T35881WU2525456",PayPal Bank 3,--,$100.00 ,"$988,420.78 "
Donations directed by individuals,9/22/23,Deposit,32T35881WU2525456,07 1000 DRONES RESTR,1000 DRONES FOR UKRAINE - 1000 DRONES FOR UKRAINE,Contributed income:Donations directed by individuals,PayPal Bank 3,$103.48 ,"$988,524.26 "
PayPal Fees,9/22/23,Deposit,32T35881WU2525456,07 1000 DRONES RESTR,PayPal fees,OFFICE/GENERAL ADMINISTRATIVE EXPENSES:PayPal Fees,PayPal Bank 3,$3.48 ,"$988,527.74 "
PayPal Bank 3,9/22/23,Deposit,83407418C0310890F,07 1000 DRONES RESTR,"Subject: 1000DRONES
Transaction ID: 83407418C0310890F
https://www.paypal.com/activity/payment/83407418C0310890F",PayPal Bank 3,--,$98.45 ,"$988,626.19 "
Donations directed by individuals,9/22/23,Deposit,83407418C0310890F,07 1000 DRONES RESTR,1000 DRONES FOR UKRAINE - 1000 DRONES FOR UKRAINE,Contributed income:Donations directed by individuals,PayPal Bank 3,$103.48 ,"$988,729.67 "
PayPal Fees,9/22/23,Deposit,83407418C0310890F,07 1000 DRONES RESTR,PayPal fees,OFFICE/GENERAL ADMINISTRATIVE EXPENSES:PayPal Fees,PayPal Bank 3,$5.03 ,"$988,734.70 "
PayPal Bank 3,9/22/23,Deposit,4X4680358N101271N,04 PAYPAL GENERAL UNRESTR,"Subject: GeneralPage
Note: test (but drones)
Transaction ID: 4X4680358N101271N
https://www.paypal.com/activity/payment/4X4680358N101271N",PayPal Bank 3,--,$9.22 ,"$988,743.92 "
Donations directed by individuals,9/22/23,Deposit,4X4680358N101271N,04 PAYPAL GENERAL UNRESTR,Support Ukraine - Support Ukraine,Contributed income:Donations directed by individuals,PayPal Bank 3,$10.00 ,"$988,753.92 "
PayPal Fees,9/22/23,Deposit,4X4680358N101271N,04 PAYPAL GENERAL UNRESTR,PayPal fees,OFFICE/GENERAL ADMINISTRATIVE EXPENSES:PayPal Fees,PayPal Bank 3,$0.78 ,"$988,754.70 "
PayPal Bank 3,9/22/23,Deposit,64C982311K8830128,04 PAYPAL GENERAL UNRESTR,"Subject: GeneralPage
Transaction ID: 64C982311K8830128
https://www.paypal.com/activity/payment/64C982311K8830128",PayPal Bank 3,--,$48.06 ,"$988,802.76 "
Donations directed by individuals,9/22/23,Deposit,64C982311K8830128,04 PAYPAL GENERAL UNRESTR,Support Ukraine - Support Ukraine,Contributed income:Donations directed by individuals,PayPal Bank 3,$50.00 ,"$988,852.76 "
PayPal Fees,9/22/23,Deposit,64C982311K8830128,04 PAYPAL GENERAL UNRESTR,PayPal fees,OFFICE/GENERAL ADMINISTRATIVE EXPENSES:PayPal Fees,PayPal Bank 3,$1.94 ,"$988,854.70 "
PayPal Bank 3,9/22/23,Deposit,2636058282394482F,04 PAYPAL GENERAL UNRESTR,"Subject: Support Ukraine
Transaction ID: 2636058282394482F
https://www.paypal.com/activity/payment/2636058282394482F",PayPal Bank 3,--,$190.73 ,"$989,045.43 "
Donations directed by individuals,9/22/23,Deposit,2636058282394482F,04 PAYPAL GENERAL UNRESTR,Money in to PayPal,Contributed income:Donations directed by individuals,PayPal Bank 3,$200.00 ,"$989,245.43 "
PayPal Fees,9/22/23,Deposit,2636058282394482F,04 PAYPAL GENERAL UNRESTR,PayPal fees,OFFICE/GENERAL ADMINISTRATIVE EXPENSES:PayPal Fees,PayPal Bank 3,$9.27 ,"$989,254.70 "
PayPal Bank 3,9/22/23,Deposit,3EV33143HF0267404,04 PAYPAL GENERAL UNRESTR,"Subject: Support Ukraine
Transaction ID: 3EV33143HF0267404
https://www.paypal.com/activity/payment/3EV33143HF0267404",PayPal Bank 3,--,$29.53 ,"$989,284.23 "
Donations directed by individuals,9/22/23,Deposit,3EV33143HF0267404,04 PAYPAL GENERAL UNRESTR,Money in to PayPal,Contributed income:Donations directed by individuals,PayPal Bank 3,$31.40 ,"$989,315.63 "
PayPal Fees,9/22/23,Deposit,3EV33143HF0267404,04 PAYPAL GENERAL UNRESTR,PayPal fees,OFFICE/GENERAL ADMINISTRATIVE EXPENSES:PayPal Fees,PayPal Bank 3,$1.87 ,"$989,317.50 "
PayPal Bank 3,9/22/23,Deposit,0NC46849FC796934H,04 PAYPAL GENERAL UNRESTR,"Subject: GeneralPage
Transaction ID: 0NC46849FC796934H
https://www.paypal.com/activity/payment/0NC46849FC796934H",PayPal Bank 3,--,$19.68 ,"$989,337.18 "
Donations directed by individuals,9/22/23,Deposit,0NC46849FC796934H,04 PAYPAL GENERAL UNRESTR,Support Ukraine - Support Ukraine,Contributed income:Donations directed by individuals,PayPal Bank 3,$21.10 ,"$989,358.28 "
PayPal Fees,9/22/23,Deposit,0NC46849FC796934H,04 PAYPAL GENERAL UNRESTR,PayPal fees,OFFICE/GENERAL ADMINISTRATIVE EXPENSES:PayPal Fees,PayPal Bank 3,$1.42 ,"$989,359.70 "
PayPal Bank 3,9/22/23,Deposit,00J142725F697602C,04 PAYPAL GENERAL UNRESTR,"Subject: GeneralPage
Transaction ID: 00J142725F697602C
https://www.paypal.com/activity/payment/00J142725F697602C",PayPal Bank 3,--,$98.45 ,"$989,458.15 "
Donations directed by individuals,9/22/23,Deposit,00J142725F697602C,04 PAYPAL GENERAL UNRESTR,Support Ukraine - Support Ukraine,Contributed income:Donations directed by individuals,PayPal Bank 3,$103.48 ,"$989,561.63 "
PayPal Fees,9/22/23,Deposit,00J142725F697602C,04 PAYPAL GENERAL UNRESTR,PayPal fees,OFFICE/GENERAL ADMINISTRATIVE EXPENSES:PayPal Fees,PayPal Bank 3,$5.03 ,"$989,566.66 "
PayPal Bank 3,9/22/23,Deposit,67Y37778X6923745X,04 PAYPAL GENERAL UNRESTR,"Subject: Support Ukraine
Transaction ID: 67Y37778X6923745X
https://www.paypal.com/activity/payment/67Y37778X6923745X",PayPal Bank 3,--,$47.31 ,"$989,613.97 "
Donations directed by individuals,9/22/23,Deposit,67Y37778X6923745X,04 PAYPAL GENERAL UNRESTR,Money in to PayPal,Contributed income:Donations directed by individuals,PayPal Bank 3,$50.00 ,"$989,663.97 "
PayPal Fees,9/22/23,Deposit,67Y37778X6923745X,04 PAYPAL GENERAL UNRESTR,PayPal fees,OFFICE/GENERAL ADMINISTRATIVE EXPENSES:PayPal Fees,PayPal Bank 3,$2.69 ,"$989,666.66 "
PayPal Bank 3,9/22/23,Deposit,9NX78933WR082700M,04 PAYPAL GENERAL UNRESTR,"Subject: Support Ukraine
Transaction ID: 9NX78933WR082700M
https://www.paypal.com/activity/payment/9NX78933WR082700M",PayPal Bank 3,--,$23.41 ,"$989,690.07 "
Donations directed by individuals,9/22/23,Deposit,9NX78933WR082700M,04 PAYPAL GENERAL UNRESTR,Money in to PayPal,Contributed income:Donations directed by individuals,PayPal Bank 3,$25.00 ,"$989,715.07 "
PayPal Fees,9/22/23,Deposit,9NX78933WR082700M,04 PAYPAL GENERAL UNRESTR,PayPal fees,OFFICE/GENERAL ADMINISTRATIVE EXPENSES:PayPal Fees,PayPal Bank 3,$1.59 ,"$989,716.66 "
PayPal Bank 3,9/22/23,Deposit,2CY56271VD704912V,04 PAYPAL GENERAL UNRESTR,"Subject: Support Ukraine
Transaction ID: 2CY56271VD704912V
https://www.paypal.com/activity/payment/2CY56271VD704912V",PayPal Bank 3,--,$18.63 ,"$989,735.29 "
Donations directed by individuals,9/22/23,Deposit,2CY56271VD704912V,04 PAYPAL GENERAL UNRESTR,Money in to PayPal,Contributed income:Donations directed by individuals,PayPal Bank 3,$20.00 ,"$989,755.29 "
PayPal Fees,9/22/23,Deposit,2CY56271VD704912V,04 PAYPAL GENERAL UNRESTR,PayPal fees,OFFICE/GENERAL ADMINISTRATIVE EXPENSES:PayPal Fees,PayPal Bank 3,$1.37 ,"$989,756.66 "
PayPal Bank 3,9/22/23,Deposit,1B395927SN6996818,04 PAYPAL GENERAL UNRESTR,"Subject: Support Ukraine
Transaction ID: 1B395927SN6996818
https://www.paypal.com/activity/payment/1B395927SN6996818",PayPal Bank 3,--,$4.91 ,"$989,761.57 "
Donations directed by individuals,9/22/23,Deposit,1B395927SN6996818,04 PAYPAL GENERAL UNRESTR,Money in to PayPal,Contributed income:Donations directed by individuals,PayPal Bank 3,$5.65 ,"$989,767.22 "
PayPal Fees,9/22/23,Deposit,1B395927SN6996818,04 PAYPAL GENERAL UNRESTR,PayPal fees,OFFICE/GENERAL ADMINISTRATIVE EXPENSES:PayPal Fees,PayPal Bank 3,$0.74 ,"$989,767.96 "
PayPal Bank 3,9/22/23,Deposit,27258365JS642482E,04 PAYPAL GENERAL UNRESTR,"Subject: GeneralPage
Transaction ID: 27258365JS642482E
https://www.paypal.com/activity/payment/27258365JS642482E",PayPal Bank 3,--,$284.71 ,"$990,052.67 "
Donations directed by individuals,9/22/23,Deposit,27258365JS642482E,04 PAYPAL GENERAL UNRESTR,Support Ukraine - Support Ukraine,Contributed income:Donations directed by individuals,PayPal Bank 3,$298.30 ,"$990,350.97 "
PayPal Fees,9/22/23,Deposit,27258365JS642482E,04 PAYPAL GENERAL UNRESTR,PayPal fees,OFFICE/GENERAL ADMINISTRATIVE EXPENSES:PayPal Fees,PayPal Bank 3,$13.59 ,"$990,364.56 "
PayPal Bank 3,9/22/23,Deposit,61841628J4912041A,09 MSU RESTR,"Subject: MobileShowers
Transaction ID: 61841628J4912041A
https://www.paypal.com/activity/payment/61841628J4912041A",PayPal Bank 3,--,$96.62 ,"$990,461.18 "
Donations directed by individuals,9/22/23,Deposit,61841628J4912041A,09 MSU RESTR,Mobile Shower/Laundry Units - Mobile Shower/Laundry Units,Contributed income:Donations directed by individuals,PayPal Bank 3,$100.00 ,"$990,561.18 "
PayPal Fees,9/22/23,Deposit,61841628J4912041A,09 MSU RESTR,PayPal fees,OFFICE/GENERAL ADMINISTRATIVE EXPENSES:PayPal Fees,PayPal Bank 3,$3.38 ,"$990,564.56 "
PayPal Bank 3,9/22/23,Deposit,0C59898945601080G,04 PAYPAL GENERAL UNRESTR,"Subject: GeneralPage
Transaction ID: 0C59898945601080G
https://www.paypal.com/activity/payment/0C59898945601080G",PayPal Bank 3,--,$0.47 ,"$990,565.03 "
Donations directed by individuals,9/22/23,Deposit,0C59898945601080G,04 PAYPAL GENERAL UNRESTR,Support Ukraine - Support Ukraine,Contributed income:Donations directed by individuals,PayPal Bank 3,$1.00 ,"$990,566.03 "
PayPal Fees,9/22/23,Deposit,0C59898945601080G,04 PAYPAL GENERAL UNRESTR,PayPal fees,OFFICE/GENERAL ADMINISTRATIVE EXPENSES:PayPal Fees,PayPal Bank 3,$0.53 ,"$990,566.56 "
PayPal Bank 3,9/22/23,Deposit,0PC837507H261180U,04 PAYPAL GENERAL UNRESTR,"Subject: GeneralPage
Transaction ID: 0PC837507H261180U
https://www.paypal.com/activity/payment/0PC837507H261180U",PayPal Bank 3,--,$100.00 ,"$990,666.56 "
Donations directed by individuals,9/22/23,Deposit,0PC837507H261180U,04 PAYPAL GENERAL UNRESTR,Support Ukraine - Support Ukraine,Contributed income:Donations directed by individuals,PayPal Bank 3,$103.48 ,"$990,770.04 "
PayPal Fees,9/22/23,Deposit,0PC837507H261180U,04 PAYPAL GENERAL UNRESTR,PayPal fees,OFFICE/GENERAL ADMINISTRATIVE EXPENSES:PayPal Fees,PayPal Bank 3,$3.48 ,"$990,773.52 "
PayPal Bank 3,9/22/23,Deposit,6BS578075R959133K,04 PAYPAL GENERAL UNRESTR,"Subject: Support Ukraine
Transaction ID: 6BS578075R959133K
https://www.paypal.com/activity/payment/6BS578075R959133K",PayPal Bank 3,--,$68.35 ,"$990,841.87 "
Donations directed by individuals,9/22/23,Deposit,6BS578075R959133K,04 PAYPAL GENERAL UNRESTR,Money in to PayPal,Contributed income:Donations directed by individuals,PayPal Bank 3,$72.00 ,"$990,913.87 "
PayPal Fees,9/22/23,Deposit,6BS578075R959133K,04 PAYPAL GENERAL UNRESTR,PayPal fees,OFFICE/GENERAL ADMINISTRATIVE EXPENSES:PayPal Fees,PayPal Bank 3,$3.65 ,"$990,917.52 "
PayPal Bank 3,9/22/23,Deposit,20237340KV493331P,07 1000 DRONES RESTR,"Subject: 1000DRONES
Transaction ID: 20237340KV493331P
https://www.paypal.com/activity/payment/20237340KV493331P",PayPal Bank 3,--,$96.62 ,"$991,014.14 "
Donations directed by individuals,9/22/23,Deposit,20237340KV493331P,07 1000 DRONES RESTR,1000 DRONES FOR UKRAINE - 1000 DRONES FOR UKRAINE,Contributed income:Donations directed by individuals,PayPal Bank 3,$100.00 ,"$991,114.14 "
PayPal Fees,9/22/23,Deposit,20237340KV493331P,07 1000 DRONES RESTR,PayPal fees,OFFICE/GENERAL ADMINISTRATIVE EXPENSES:PayPal Fees,PayPal Bank 3,$3.38 ,"$991,117.52 "
PayPal Bank 3,9/22/23,Deposit,2K246371S2833063W,04 PAYPAL GENERAL UNRESTR,"Subject: GeneralPage
Transaction ID: 2K246371S2833063W
https://www.paypal.com/activity/payment/2K246371S2833063W",PayPal Bank 3,--,$14.76 ,"$991,132.28 "
Donations directed by individuals,9/22/23,Deposit,2K246371S2833063W,04 PAYPAL GENERAL UNRESTR,Support Ukraine - Support Ukraine,Contributed income:Donations directed by individuals,PayPal Bank 3,$15.95 ,"$991,148.23 "
PayPal Fees,9/22/23,Deposit,2K246371S2833063W,04 PAYPAL GENERAL UNRESTR,PayPal fees,OFFICE/GENERAL ADMINISTRATIVE EXPENSES:PayPal Fees,PayPal Bank 3,$1.19 ,"$991,149.42 "
PayPal Bank 3,9/22/23,Deposit,2PT56001K0682042R,04 PAYPAL GENERAL UNRESTR,"Subject: GeneralPage
Transaction ID: 2PT56001K0682042R
https://www.paypal.com/activity/payment/2PT56001K0682042R",PayPal Bank 3,--,$19.68 ,"$991,169.10 "
Donations directed by individuals,9/22/23,Deposit,2PT56001K0682042R,04 PAYPAL GENERAL UNRESTR,Support Ukraine - Support Ukraine,Contributed income:Donations directed by individuals,PayPal Bank 3,$21.10 ,"$991,190.20 "
PayPal Fees,9/22/23,Deposit,2PT56001K0682042R,04 PAYPAL GENERAL UNRESTR,PayPal fees,OFFICE/GENERAL ADMINISTRATIVE EXPENSES:PayPal Fees,PayPal Bank 3,$1.42 ,"$991,191.62 "
PayPal Bank 3,9/22/23,Deposit,57Y34941DT708264U,04 PAYPAL GENERAL UNRESTR,"Subject: GeneralPage
Note: З Днем народження)))�
Transaction ID: 57Y34941DT708264U
https://www.paypal.com/activity/payment/57Y34941DT708264U",PayPal Bank 3,--,$200.00 ,"$991,391.62 "
Donations directed by individuals,9/22/23,Deposit,57Y34941DT708264U,04 PAYPAL GENERAL UNRESTR,Support Ukraine - Support Ukraine,Contributed income:Donations directed by individuals,PayPal Bank 3,$206.46 ,"$991,598.08 "
PayPal Fees,9/22/23,Deposit,57Y34941DT708264U,04 PAYPAL GENERAL UNRESTR,PayPal fees,OFFICE/GENERAL ADMINISTRATIVE EXPENSES:PayPal Fees,PayPal Bank 3,$6.46 ,"$991,604.54 "
PayPal Bank 3,9/22/23,Deposit,0XS31101EJ8169012,04 PAYPAL GENERAL UNRESTR,"Subject: GeneralPage
Transaction ID: 0XS31101EJ8169012
https://www.paypal.com/activity/payment/0XS31101EJ8169012",PayPal Bank 3,--,$23.41 ,"$991,627.95 "
Donations directed by individuals,9/22/23,Deposit,0XS31101EJ8169012,04 PAYPAL GENERAL UNRESTR,Support Ukraine - Support Ukraine,Contributed income:Donations directed by individuals,PayPal Bank 3,$25.00 ,"$991,652.95 "
PayPal Fees,9/22/23,Deposit,0XS31101EJ8169012,04 PAYPAL GENERAL UNRESTR,PayPal fees,OFFICE/GENERAL ADMINISTRATIVE EXPENSES:PayPal Fees,PayPal Bank 3,$1.59 ,"$991,654.54 "
PayPal Bank 3,9/22/23,Deposit,51B546867K0736349,04 PAYPAL GENERAL UNRESTR,"Subject: Support Ukraine
Transaction ID: 51B546867K0736349
https://www.paypal.com/activity/payment/51B546867K0736349",PayPal Bank 3,--,$50.00 ,"$991,704.54 "
Donations directed by individuals,9/22/23,Deposit,51B546867K0736349,04 PAYPAL GENERAL UNRESTR,Money in to PayPal,Contributed income:Donations directed by individuals,PayPal Bank 3,$51.99 ,"$991,756.53 "
PayPal Fees,9/22/23,Deposit,51B546867K0736349,04 PAYPAL GENERAL UNRESTR,PayPal fees,OFFICE/GENERAL ADMINISTRATIVE EXPENSES:PayPal Fees,PayPal Bank 3,$1.99 ,"$991,758.52 "
PayPal Bank 3,9/22/23,Deposit,3JU54555E6068053N,04 PAYPAL GENERAL UNRESTR,"Subject: GeneralPage
Transaction ID: 3JU54555E6068053N
https://www.paypal.com/activity/payment/3JU54555E6068053N",PayPal Bank 3,--,$98.45 ,"$991,856.97 "
Donations directed by individuals,9/22/23,Deposit,3JU54555E6068053N,04 PAYPAL GENERAL UNRESTR,Support Ukraine - Support Ukraine,Contributed income:Donations directed by individuals,PayPal Bank 3,$103.48 ,"$991,960.45 "
PayPal Fees,9/22/23,Deposit,3JU54555E6068053N,04 PAYPAL GENERAL UNRESTR,PayPal fees,OFFICE/GENERAL ADMINISTRATIVE EXPENSES:PayPal Fees,PayPal Bank 3,$5.03 ,"$991,965.48 "
PayPal Bank 3,9/22/23,Deposit,5EH0736972589691N,07 1000 DRONES RESTR,"Subject: GeneralPage
Note: на дрони для рот ударних БПЛА.   З Днем Народження!
Transaction ID: 5EH0736972589691N
https://www.paypal.com/activity/payment/5EH0736972589691N",PayPal Bank 3,--,$40.00 ,"$992,005.48 "
Donations directed by individuals,9/22/23,Deposit,5EH0736972589691N,07 1000 DRONES RESTR,Support Ukraine - Support Ukraine,Contributed income:Donations directed by individuals,PayPal Bank 3,$41.69 ,"$992,047.17 "
PayPal Fees,9/22/23,Deposit,5EH0736972589691N,07 1000 DRONES RESTR,PayPal fees,OFFICE/GENERAL ADMINISTRATIVE EXPENSES:PayPal Fees,PayPal Bank 3,$1.69 ,"$992,048.86 "
PayPal Bank 3,9/22/23,Deposit,01303884X7914430B,04 PAYPAL GENERAL UNRESTR,"Subject: GeneralPage
Note: ЗА ПЕРЕМОГУ!!!!
Transaction ID: 01303884X7914430B
https://www.paypal.com/activity/payment/01303884X7914430B",PayPal Bank 3,--,$96.62 ,"$992,145.48 "
Donations directed by individuals,9/22/23,Deposit,01303884X7914430B,04 PAYPAL GENERAL UNRESTR,Support Ukraine - Support Ukraine,Contributed income:Donations directed by individuals,PayPal Bank 3,$100.00 ,"$992,245.48 "
PayPal Fees,9/22/23,Deposit,01303884X7914430B,04 PAYPAL GENERAL UNRESTR,PayPal fees,OFFICE/GENERAL ADMINISTRATIVE EXPENSES:PayPal Fees,PayPal Bank 3,$3.38 ,"$992,248.86 "
PayPal Bank 3,9/22/23,Deposit,0DM94883L7387281S,04 PAYPAL GENERAL UNRESTR,"Subject: GeneralPage
Note: Тримайся, Люба! Може пом’ятаеш мене…
Transaction ID: 0DM94883L7387281S
https://www.paypal.com/activity/payment/0DM94883L7387281S",PayPal Bank 3,--,$96.62 ,"$992,345.48 "
Donations directed by individuals,9/22/23,Deposit,0DM94883L7387281S,04 PAYPAL GENERAL UNRESTR,Support Ukraine - Support Ukraine,Contributed income:Donations directed by individuals,PayPal Bank 3,$100.00 ,"$992,445.48 "
PayPal Fees,9/22/23,Deposit,0DM94883L7387281S,04 PAYPAL GENERAL UNRESTR,PayPal fees,OFFICE/GENERAL ADMINISTRATIVE EXPENSES:PayPal Fees,PayPal Bank 3,$3.38 ,"$992,448.86 "
PayPal Bank 3,9/22/23,Deposit,3SC17136LW391014S,04 PAYPAL GENERAL UNRESTR,"Subject: GeneralPage
Transaction ID: 3SC17136LW391014S
https://www.paypal.com/activity/payment/3SC17136LW391014S",PayPal Bank 3,--,$4.29 ,"$992,453.15 "
Donations directed by individuals,9/22/23,Deposit,3SC17136LW391014S,04 PAYPAL GENERAL UNRESTR,Support Ukraine - Support Ukraine,Contributed income:Donations directed by individuals,PayPal Bank 3,$5.00 ,"$992,458.15 "
PayPal Fees,9/22/23,Deposit,3SC17136LW391014S,04 PAYPAL GENERAL UNRESTR,PayPal fees,OFFICE/GENERAL ADMINISTRATIVE EXPENSES:PayPal Fees,PayPal Bank 3,$0.71 ,"$992,458.86 "
PayPal Bank 3,9/22/23,Deposit,7MB7968597946332P,04 PAYPAL GENERAL UNRESTR,"Subject: GeneralPage
Transaction ID: 7MB7968597946332P
https://www.paypal.com/activity/payment/7MB7968597946332P",PayPal Bank 3,--,$190.73 ,"$992,649.59 "
Donations directed by individuals,9/22/23,Deposit,7MB7968597946332P,04 PAYPAL GENERAL UNRESTR,Support Ukraine - Support Ukraine,Contributed income:Donations directed by individuals,PayPal Bank 3,$200.00 ,"$992,849.59 "
PayPal Fees,9/22/23,Deposit,7MB7968597946332P,04 PAYPAL GENERAL UNRESTR,PayPal fees,OFFICE/GENERAL ADMINISTRATIVE EXPENSES:PayPal Fees,PayPal Bank 3,$9.27 ,"$992,858.86 "
PayPal Bank 3,9/22/23,Deposit,9M1166777M785673U,04 PAYPAL GENERAL UNRESTR,"Subject: Support Ukraine
Transaction ID: 9M1166777M785673U
https://www.paypal.com/activity/payment/9M1166777M785673U",PayPal Bank 3,--,$47.31 ,"$992,906.17 "
Donations directed by individuals,9/22/23,Deposit,9M1166777M785673U,04 PAYPAL GENERAL UNRESTR,Money in to PayPal,Contributed income:Donations directed by individuals,PayPal Bank 3,$50.00 ,"$992,956.17 "
PayPal Fees,9/22/23,Deposit,9M1166777M785673U,04 PAYPAL GENERAL UNRESTR,PayPal fees,OFFICE/GENERAL ADMINISTRATIVE EXPENSES:PayPal Fees,PayPal Bank 3,$2.69 ,"$992,958.86 "
PayPal Bank 3,9/22/23,Deposit,7LL9406133599474N,04 PAYPAL GENERAL UNRESTR,"Subject: GeneralPage
Note: Lyuba's birthday
Transaction ID: 7LL9406133599474N
https://www.paypal.com/activity/payment/7LL9406133599474N",PayPal Bank 3,--,$36.00 ,"$992,994.86 "
Donations directed by individuals,9/22/23,Deposit,7LL9406133599474N,04 PAYPAL GENERAL UNRESTR,Support Ukraine - Support Ukraine,Contributed income:Donations directed by individuals,PayPal Bank 3,$37.58 ,"$993,032.44 "
PayPal Fees,9/22/23,Deposit,7LL9406133599474N,04 PAYPAL GENERAL UNRESTR,PayPal fees,OFFICE/GENERAL ADMINISTRATIVE EXPENSES:PayPal Fees,PayPal Bank 3,$1.58 ,"$993,034.02 "
PayPal Bank 3,9/22/23,Deposit,6YF83188VT3411648,04 PAYPAL GENERAL UNRESTR,"Subject: GeneralPage
Transaction ID: 6YF83188VT3411648
https://www.paypal.com/activity/payment/6YF83188VT3411648",PayPal Bank 3,--,$13.85 ,"$993,047.87 "
Donations directed by individuals,9/22/23,Deposit,6YF83188VT3411648,04 PAYPAL GENERAL UNRESTR,Support Ukraine - Support Ukraine,Contributed income:Donations directed by individuals,PayPal Bank 3,$15.00 ,"$993,062.87 "
PayPal Fees,9/22/23,Deposit,6YF83188VT3411648,04 PAYPAL GENERAL UNRESTR,PayPal fees,OFFICE/GENERAL ADMINISTRATIVE EXPENSES:PayPal Fees,PayPal Bank 3,$1.15 ,"$993,064.02 "
PayPal Bank 3,9/22/23,Deposit,5MN29950GY4716218,07 1000 DRONES RESTR,"Subject: 1000DRONES
Transaction ID: 5MN29950GY4716218
https://www.paypal.com/activity/payment/5MN29950GY4716218",PayPal Bank 3,--,$19.68 ,"$993,083.70 "
Donations directed by individuals,9/22/23,Deposit,5MN29950GY4716218,07 1000 DRONES RESTR,1000 DRONES FOR UKRAINE - 1000 DRONES FOR UKRAINE,Contributed income:Donations directed by individuals,PayPal Bank 3,$21.10 ,"$993,104.80 "
PayPal Fees,9/22/23,Deposit,5MN29950GY4716218,07 1000 DRONES RESTR,PayPal fees,OFFICE/GENERAL ADMINISTRATIVE EXPENSES:PayPal Fees,PayPal Bank 3,$1.42 ,"$993,106.22 "
PayPal Bank 3,9/22/23,Deposit,8F445094XW806482B,04 PAYPAL GENERAL UNRESTR,"Subject: GeneralPage
Transaction ID: 8F445094XW806482B
https://www.paypal.com/activity/payment/8F445094XW806482B",PayPal Bank 3,--,$50.00 ,"$993,156.22 "
Donations directed by individuals,9/22/23,Deposit,8F445094XW806482B,04 PAYPAL GENERAL UNRESTR,Support Ukraine - Support Ukraine,Contributed income:Donations directed by individuals,PayPal Bank 3,$51.99 ,"$993,208.21 "
PayPal Fees,9/22/23,Deposit,8F445094XW806482B,04 PAYPAL GENERAL UNRESTR,PayPal fees,OFFICE/GENERAL ADMINISTRATIVE EXPENSES:PayPal Fees,PayPal Bank 3,$1.99 ,"$993,210.20 "
PayPal Bank 3,9/22/23,Deposit,5YG57798EC0730455,04 PAYPAL GENERAL UNRESTR,"Subject: GeneralPage
Transaction ID: 5YG57798EC0730455
https://www.paypal.com/activity/payment/5YG57798EC0730455",PayPal Bank 3,--,$9.84 ,"$993,220.04 "
Donations directed by individuals,9/22/23,Deposit,5YG57798EC0730455,04 PAYPAL GENERAL UNRESTR,Support Ukraine - Support Ukraine,Contributed income:Donations directed by individuals,PayPal Bank 3,$10.80 ,"$993,230.84 "
PayPal Fees,9/22/23,Deposit,5YG57798EC0730455,04 PAYPAL GENERAL UNRESTR,PayPal fees,OFFICE/GENERAL ADMINISTRATIVE EXPENSES:PayPal Fees,PayPal Bank 3,$0.96 ,"$993,231.80 "
PayPal Bank 3,9/22/23,Deposit,5CF836038T654152T,04 PAYPAL GENERAL UNRESTR,"Subject: GeneralPage
Transaction ID: 5CF836038T654152T
https://www.paypal.com/activity/payment/5CF836038T654152T",PayPal Bank 3,--,$300.00 ,"$993,531.80 "
Donations directed by individuals,9/22/23,Deposit,5CF836038T654152T,04 PAYPAL GENERAL UNRESTR,Support Ukraine - Support Ukraine,Contributed income:Donations directed by individuals,PayPal Bank 3,$309.43 ,"$993,841.23 "
PayPal Fees,9/22/23,Deposit,5CF836038T654152T,04 PAYPAL GENERAL UNRESTR,PayPal fees,OFFICE/GENERAL ADMINISTRATIVE EXPENSES:PayPal Fees,PayPal Bank 3,$9.43 ,"$993,850.66 "
PayPal Bank 3,9/22/23,Deposit,5MX38849AE713991E,04 PAYPAL GENERAL UNRESTR,"Subject: GeneralPage
Transaction ID: 5MX38849AE713991E
https://www.paypal.com/activity/payment/5MX38849AE713991E",PayPal Bank 3,--,$96.62 ,"$993,947.28 "
Donations directed by individuals,9/22/23,Deposit,5MX38849AE713991E,04 PAYPAL GENERAL UNRESTR,Support Ukraine - Support Ukraine,Contributed income:Donations directed by individuals,PayPal Bank 3,$100.00 ,"$994,047.28 "
PayPal Fees,9/22/23,Deposit,5MX38849AE713991E,04 PAYPAL GENERAL UNRESTR,PayPal fees,OFFICE/GENERAL ADMINISTRATIVE EXPENSES:PayPal Fees,PayPal Bank 3,$3.38 ,"$994,050.66 "
PayPal Bank 3,9/22/23,Deposit,5GE00546M49214419,04 PAYPAL GENERAL UNRESTR,"Subject: GeneralPage
Transaction ID: 5GE00546M49214419
https://www.paypal.com/activity/payment/5GE00546M49214419",PayPal Bank 3,--,$96.62 ,"$994,147.28 "
Donations directed by individuals,9/22/23,Deposit,5GE00546M49214419,04 PAYPAL GENERAL UNRESTR,Support Ukraine - Support Ukraine,Contributed income:Donations directed by individuals,PayPal Bank 3,$100.00 ,"$994,247.28 "
PayPal Fees,9/22/23,Deposit,5GE00546M49214419,04 PAYPAL GENERAL UNRESTR,PayPal fees,OFFICE/GENERAL ADMINISTRATIVE EXPENSES:PayPal Fees,PayPal Bank 3,$3.38 ,"$994,250.66 "
PayPal Bank 3,9/22/23,Deposit,6UN85806ED284713M,04 PAYPAL GENERAL UNRESTR,"Subject: GeneralPage
Transaction ID: 6UN85806ED284713M
https://www.paypal.com/activity/payment/6UN85806ED284713M",PayPal Bank 3,--,$30.00 ,"$994,280.66 "
Donations directed by individuals,9/22/23,Deposit,6UN85806ED284713M,04 PAYPAL GENERAL UNRESTR,Support Ukraine - Support Ukraine,Contributed income:Donations directed by individuals,PayPal Bank 3,$31.40 ,"$994,312.06 "
PayPal Fees,9/22/23,Deposit,6UN85806ED284713M,04 PAYPAL GENERAL UNRESTR,PayPal fees,OFFICE/GENERAL ADMINISTRATIVE EXPENSES:PayPal Fees,PayPal Bank 3,$1.40 ,"$994,313.46 "
PayPal Bank 3,9/22/23,Deposit,6MP6452204563261K,04 PAYPAL GENERAL UNRESTR,"Subject: GeneralPage
Note: Mnohii Lita, Lyuba
Transaction ID: 6MP6452204563261K
https://www.paypal.com/activity/payment/6MP6452204563261K",PayPal Bank 3,--,$98.45 ,"$994,411.91 "
Donations directed by individuals,9/22/23,Deposit,6MP6452204563261K,04 PAYPAL GENERAL UNRESTR,Support Ukraine - Support Ukraine,Contributed income:Donations directed by individuals,PayPal Bank 3,$103.48 ,"$994,515.39 "
PayPal Fees,9/22/23,Deposit,6MP6452204563261K,04 PAYPAL GENERAL UNRESTR,PayPal fees,OFFICE/GENERAL ADMINISTRATIVE EXPENSES:PayPal Fees,PayPal Bank 3,$5.03 ,"$994,520.42 "
PayPal Bank 3,9/22/23,Deposit,9HD345775D588911W,04 PAYPAL GENERAL UNRESTR,"Subject: Support Ukraine
Transaction ID: 9HD345775D588911W
https://www.paypal.com/activity/payment/9HD345775D588911W",PayPal Bank 3,--,$25.00 ,"$994,545.42 "
Donations directed by individuals,9/22/23,Deposit,9HD345775D588911W,04 PAYPAL GENERAL UNRESTR,Money in to PayPal,Contributed income:Donations directed by individuals,PayPal Bank 3,$26.25 ,"$994,571.67 "
PayPal Fees,9/22/23,Deposit,9HD345775D588911W,04 PAYPAL GENERAL UNRESTR,PayPal fees,OFFICE/GENERAL ADMINISTRATIVE EXPENSES:PayPal Fees,PayPal Bank 3,$1.25 ,"$994,572.92 "
PayPal Bank 3,9/22/23,Deposit,3W37598027733534A,04 PAYPAL GENERAL UNRESTR,"Subject: GeneralPage
Transaction ID: 3W37598027733534A
https://www.paypal.com/activity/payment/3W37598027733534A",PayPal Bank 3,--,$30.00 ,"$994,602.92 "
Donations directed by individuals,9/22/23,Deposit,3W37598027733534A,04 PAYPAL GENERAL UNRESTR,Support Ukraine - Support Ukraine,Contributed income:Donations directed by individuals,PayPal Bank 3,$31.40 ,"$994,634.32 "
PayPal Fees,9/22/23,Deposit,3W37598027733534A,04 PAYPAL GENERAL UNRESTR,PayPal fees,OFFICE/GENERAL ADMINISTRATIVE EXPENSES:PayPal Fees,PayPal Bank 3,$1.40 ,"$994,635.72 "
PayPal Bank 3,9/22/23,Deposit,7L593890MC561110M,04 PAYPAL GENERAL UNRESTR,"Subject: GeneralPage
Transaction ID: 7L593890MC561110M
https://www.paypal.com/activity/payment/7L593890MC561110M",PayPal Bank 3,--,$49.22 ,"$994,684.94 "
Donations directed by individuals,9/22/23,Deposit,7L593890MC561110M,04 PAYPAL GENERAL UNRESTR,Support Ukraine - Support Ukraine,Contributed income:Donations directed by individuals,PayPal Bank 3,$51.99 ,"$994,736.93 "
PayPal Fees,9/22/23,Deposit,7L593890MC561110M,04 PAYPAL GENERAL UNRESTR,PayPal fees,OFFICE/GENERAL ADMINISTRATIVE EXPENSES:PayPal Fees,PayPal Bank 3,$2.77 ,"$994,739.70 "
PayPal Bank 3,9/22/23,Deposit,9TM50698FE886611N,04 PAYPAL GENERAL UNRESTR,"Subject: GeneralPage
Note: Happy Birthday Lyuba Shipovich!
Transaction ID: 9TM50698FE886611N
https://www.paypal.com/activity/payment/9TM50698FE886611N",PayPal Bank 3,--,$100.00 ,"$994,839.70 "
Donations directed by individuals,9/22/23,Deposit,9TM50698FE886611N,04 PAYPAL GENERAL UNRESTR,Support Ukraine - Support Ukraine,Contributed income:Donations directed by individuals,PayPal Bank 3,$103.48 ,"$994,943.18 "
PayPal Fees,9/22/23,Deposit,9TM50698FE886611N,04 PAYPAL GENERAL UNRESTR,PayPal fees,OFFICE/GENERAL ADMINISTRATIVE EXPENSES:PayPal Fees,PayPal Bank 3,$3.48 ,"$994,946.66 "
PayPal Bank 3,9/22/23,Deposit,31A121404C1997703,04 PAYPAL GENERAL UNRESTR,"Subject: GeneralPage
Transaction ID: 31A121404C1997703
https://www.paypal.com/activity/payment/31A121404C1997703",PayPal Bank 3,--,$290.84 ,"$995,237.50 "
Donations directed by individuals,9/22/23,Deposit,31A121404C1997703,04 PAYPAL GENERAL UNRESTR,Support Ukraine - Support Ukraine,Contributed income:Donations directed by individuals,PayPal Bank 3,$300.00 ,"$995,537.50 "
PayPal Fees,9/22/23,Deposit,31A121404C1997703,04 PAYPAL GENERAL UNRESTR,PayPal fees,OFFICE/GENERAL ADMINISTRATIVE EXPENSES:PayPal Fees,PayPal Bank 3,$9.16 ,"$995,546.66 "
PayPal Bank 3,9/22/23,Deposit,39X62260U80060447,04 PAYPAL GENERAL UNRESTR,"Subject: GeneralPage
Note: Happy Birthday Lyuba!
Transaction ID: 39X62260U80060447
https://www.paypal.com/activity/payment/39X62260U80060447",PayPal Bank 3,--,$193.73 ,"$995,740.39 "
Donations directed by individuals,9/22/23,Deposit,39X62260U80060447,04 PAYPAL GENERAL UNRESTR,Support Ukraine - Support Ukraine,Contributed income:Donations directed by individuals,PayPal Bank 3,$200.00 ,"$995,940.39 "
PayPal Fees,9/22/23,Deposit,39X62260U80060447,04 PAYPAL GENERAL UNRESTR,PayPal fees,OFFICE/GENERAL ADMINISTRATIVE EXPENSES:PayPal Fees,PayPal Bank 3,$6.27 ,"$995,946.66 "
PayPal Bank 3,9/22/23,Deposit,71A50641X46963142,04 PAYPAL GENERAL UNRESTR,"Subject: GeneralPage
Transaction ID: 71A50641X46963142
https://www.paypal.com/activity/payment/71A50641X46963142",PayPal Bank 3,--,$820.00 ,"$996,766.66 "
Donations directed by individuals,9/22/23,Deposit,71A50641X46963142,04 PAYPAL GENERAL UNRESTR,Support Ukraine - Support Ukraine,Contributed income:Donations directed by individuals,PayPal Bank 3,$844.91 ,"$997,611.57 "
PayPal Fees,9/22/23,Deposit,71A50641X46963142,04 PAYPAL GENERAL UNRESTR,PayPal fees,OFFICE/GENERAL ADMINISTRATIVE EXPENSES:PayPal Fees,PayPal Bank 3,$24.91 ,"$997,636.48 "
PayPal Bank 3,9/22/23,Deposit,49Y29843UW779240L,04 PAYPAL GENERAL UNRESTR,"Subject: GeneralPage
Transaction ID: 49Y29843UW779240L
https://www.paypal.com/activity/payment/49Y29843UW779240L",PayPal Bank 3,--,$49.22 ,"$997,685.70 "
Donations directed by individuals,9/22/23,Deposit,49Y29843UW779240L,04 PAYPAL GENERAL UNRESTR,Support Ukraine - Support Ukraine,Contributed income:Donations directed by individuals,PayPal Bank 3,$51.99 ,"$997,737.69 "
PayPal Fees,9/22/23,Deposit,49Y29843UW779240L,04 PAYPAL GENERAL UNRESTR,PayPal fees,OFFICE/GENERAL ADMINISTRATIVE EXPENSES:PayPal Fees,PayPal Bank 3,$2.77 ,"$997,740.46 "
PayPal Bank 3,9/22/23,Deposit,64387333V3369200X,04 PAYPAL GENERAL UNRESTR,"Subject: GeneralPage
Transaction ID: 64387333V3369200X
https://www.paypal.com/activity/payment/64387333V3369200X",PayPal Bank 3,--,$50.00 ,"$997,790.46 "
Donations directed by individuals,9/22/23,Deposit,64387333V3369200X,04 PAYPAL GENERAL UNRESTR,Support Ukraine - Support Ukraine,Contributed income:Donations directed by individuals,PayPal Bank 3,$51.99 ,"$997,842.45 "
PayPal Fees,9/22/23,Deposit,64387333V3369200X,04 PAYPAL GENERAL UNRESTR,PayPal fees,OFFICE/GENERAL ADMINISTRATIVE EXPENSES:PayPal Fees,PayPal Bank 3,$1.99 ,"$997,844.44 "
PayPal Bank 3,9/22/23,Deposit,7UW41748MF324114U,04 PAYPAL GENERAL UNRESTR,"Subject: GeneralPage
Transaction ID: 7UW41748MF324114U
https://www.paypal.com/activity/payment/7UW41748MF324114U",PayPal Bank 3,--,$50.00 ,"$997,894.44 "
Donations directed by individuals,9/22/23,Deposit,7UW41748MF324114U,04 PAYPAL GENERAL UNRESTR,Support Ukraine - Support Ukraine,Contributed income:Donations directed by individuals,PayPal Bank 3,$51.99 ,"$997,946.43 "
PayPal Fees,9/22/23,Deposit,7UW41748MF324114U,04 PAYPAL GENERAL UNRESTR,PayPal fees,OFFICE/GENERAL ADMINISTRATIVE EXPENSES:PayPal Fees,PayPal Bank 3,$1.99 ,"$997,948.42 "
PayPal Bank 3,9/22/23,Deposit,4RY212138X079980M,04 PAYPAL GENERAL UNRESTR,"Subject: GeneralPage
Transaction ID: 4RY212138X079980M
https://www.paypal.com/activity/payment/4RY212138X079980M",PayPal Bank 3,--,$48.06 ,"$997,996.48 "
Donations directed by individuals,9/22/23,Deposit,4RY212138X079980M,04 PAYPAL GENERAL UNRESTR,Support Ukraine - Support Ukraine,Contributed income:Donations directed by individuals,PayPal Bank 3,$50.00 ,"$998,046.48 "
PayPal Fees,9/22/23,Deposit,4RY212138X079980M,04 PAYPAL GENERAL UNRESTR,PayPal fees,OFFICE/GENERAL ADMINISTRATIVE EXPENSES:PayPal Fees,PayPal Bank 3,$1.94 ,"$998,048.42 "
PayPal Bank 3,9/22/23,Deposit,72C5448182009291B,04 PAYPAL GENERAL UNRESTR,"Subject: GeneralPage
Transaction ID: 72C5448182009291B
https://www.paypal.com/activity/payment/72C5448182009291B",PayPal Bank 3,--,$4.37 ,"$998,052.79 "
Donations directed by individuals,9/22/23,Deposit,72C5448182009291B,04 PAYPAL GENERAL UNRESTR,Support Ukraine - Support Ukraine,Contributed income:Donations directed by individuals,PayPal Bank 3,$5.00 ,"$998,057.79 "
PayPal Fees,9/22/23,Deposit,72C5448182009291B,04 PAYPAL GENERAL UNRESTR,PayPal fees,OFFICE/GENERAL ADMINISTRATIVE EXPENSES:PayPal Fees,PayPal Bank 3,$0.63 ,"$998,058.42 "
PayPal Bank 3,9/22/23,Deposit,2RJ87902UJ811740F,04 PAYPAL GENERAL UNRESTR,"Transaction ID: 2RJ87902UJ811740F
https://www.paypal.com/activity/payment/2RJ87902UJ811740F",PayPal Bank 3,--,$33.95 ,"$998,092.37 "
Donations directed by individuals,9/22/23,Deposit,2RJ87902UJ811740F,04 PAYPAL GENERAL UNRESTR,Money in to PayPal,Contributed income:Donations directed by individuals,PayPal Bank 3,$35.00 ,"$998,127.37 "
PayPal Fees,9/22/23,Deposit,2RJ87902UJ811740F,04 PAYPAL GENERAL UNRESTR,PayPal fees,OFFICE/GENERAL ADMINISTRATIVE EXPENSES:PayPal Fees,PayPal Bank 3,$1.05 ,"$998,128.42 "
PayPal Bank 3,9/22/23,Deposit,9A081869S52439819,04 PAYPAL GENERAL UNRESTR,"Subject: GeneralPage
Transaction ID: 9A081869S52439819
https://www.paypal.com/activity/payment/9A081869S52439819",PayPal Bank 3,--,$38.35 ,"$998,166.77 "
Donations directed by individuals,9/22/23,Deposit,9A081869S52439819,04 PAYPAL GENERAL UNRESTR,Support Ukraine - Support Ukraine,Contributed income:Donations directed by individuals,PayPal Bank 3,$40.00 ,"$998,206.77 "
PayPal Fees,9/22/23,Deposit,9A081869S52439819,04 PAYPAL GENERAL UNRESTR,PayPal fees,OFFICE/GENERAL ADMINISTRATIVE EXPENSES:PayPal Fees,PayPal Bank 3,$1.65 ,"$998,208.42 "
PayPal Bank 3,9/22/23,Deposit,76H76369F45085905,04 PAYPAL GENERAL UNRESTR,"Subject: GeneralPage
Transaction ID: 76H76369F45085905
https://www.paypal.com/activity/payment/76H76369F45085905",PayPal Bank 3,--,$96.62 ,"$998,305.04 "
Donations directed by individuals,9/22/23,Deposit,76H76369F45085905,04 PAYPAL GENERAL UNRESTR,Support Ukraine - Support Ukraine,Contributed income:Donations directed by individuals,PayPal Bank 3,$100.00 ,"$998,405.04 "
PayPal Fees,9/22/23,Deposit,76H76369F45085905,04 PAYPAL GENERAL UNRESTR,PayPal fees,OFFICE/GENERAL ADMINISTRATIVE EXPENSES:PayPal Fees,PayPal Bank 3,$3.38 ,"$998,408.42 "
PayPal Bank 3,9/22/23,Deposit,3XG02471JY446130J,04 PAYPAL GENERAL UNRESTR,"Subject: Support Ukraine
Transaction ID: 3XG02471JY446130J
https://www.paypal.com/activity/payment/3XG02471JY446130J",PayPal Bank 3,--,$20.75 ,"$998,429.17 "
Donations directed by individuals,9/22/23,Deposit,3XG02471JY446130J,04 PAYPAL GENERAL UNRESTR,Money in to PayPal,Contributed income:Donations directed by individuals,PayPal Bank 3,$22.22 ,"$998,451.39 "
PayPal Fees,9/22/23,Deposit,3XG02471JY446130J,04 PAYPAL GENERAL UNRESTR,PayPal fees,OFFICE/GENERAL ADMINISTRATIVE EXPENSES:PayPal Fees,PayPal Bank 3,$1.47 ,"$998,452.86 "
PayPal Bank 3,9/22/23,Deposit,51M60073MG3717313,04 PAYPAL GENERAL UNRESTR,"Subject: GeneralPage
Transaction ID: 51M60073MG3717313
https://www.paypal.com/activity/payment/51M60073MG3717313",PayPal Bank 3,--,$290.84 ,"$998,743.70 "
Donations directed by individuals,9/22/23,Deposit,51M60073MG3717313,04 PAYPAL GENERAL UNRESTR,Support Ukraine - Support Ukraine,Contributed income:Donations directed by individuals,PayPal Bank 3,$300.00 ,"$999,043.70 "
PayPal Fees,9/22/23,Deposit,51M60073MG3717313,04 PAYPAL GENERAL UNRESTR,PayPal fees,OFFICE/GENERAL ADMINISTRATIVE EXPENSES:PayPal Fees,PayPal Bank 3,$9.16 ,"$999,052.86 "
PayPal Bank 3,9/22/23,Deposit,1Y388623659877031,07 1000 DRONES RESTR,"Subject: 1000DRONES
Transaction ID: 1Y388623659877031
https://www.paypal.com/activity/payment/1Y388623659877031",PayPal Bank 3,--,$29.53 ,"$999,082.39 "
Donations directed by individuals,9/22/23,Deposit,1Y388623659877031,07 1000 DRONES RESTR,1000 DRONES FOR UKRAINE - 1000 DRONES FOR UKRAINE,Contributed income:Donations directed by individuals,PayPal Bank 3,$31.40 ,"$999,113.79 "
PayPal Fees,9/22/23,Deposit,1Y388623659877031,07 1000 DRONES RESTR,PayPal fees,OFFICE/GENERAL ADMINISTRATIVE EXPENSES:PayPal Fees,PayPal Bank 3,$1.87 ,"$999,115.66 "
PayPal Bank 3,9/22/23,Deposit,7W774328XL7301211,04 PAYPAL GENERAL UNRESTR,"Subject: GeneralPage
Note: Berlinska you are the best ��
Transaction ID: 7W774328XL7301211
https://www.paypal.com/activity/payment/7W774328XL7301211",PayPal Bank 3,--,$95.12 ,"$999,210.78 "
Donations directed by individuals,9/22/23,Deposit,7W774328XL7301211,04 PAYPAL GENERAL UNRESTR,Support Ukraine - Support Ukraine,Contributed income:Donations directed by individuals,PayPal Bank 3,$100.00 ,"$999,310.78 "
PayPal Fees,9/22/23,Deposit,7W774328XL7301211,04 PAYPAL GENERAL UNRESTR,PayPal fees,OFFICE/GENERAL ADMINISTRATIVE EXPENSES:PayPal Fees,PayPal Bank 3,$4.88 ,"$999,315.66 "
PayPal Bank 3,9/22/23,Deposit,2MJ53335SS7405935,04 PAYPAL GENERAL UNRESTR,"Subject: Support Ukraine
Transaction ID: 2MJ53335SS7405935
https://www.paypal.com/activity/payment/2MJ53335SS7405935",PayPal Bank 3,--,$98.45 ,"$999,414.11 "
Donations directed by individuals,9/22/23,Deposit,2MJ53335SS7405935,04 PAYPAL GENERAL UNRESTR,Money in to PayPal,Contributed income:Donations directed by individuals,PayPal Bank 3,$103.48 ,"$999,517.59 "
PayPal Fees,9/22/23,Deposit,2MJ53335SS7405935,04 PAYPAL GENERAL UNRESTR,PayPal fees,OFFICE/GENERAL ADMINISTRATIVE EXPENSES:PayPal Fees,PayPal Bank 3,$5.03 ,"$999,522.62 "
PayPal Bank 3,9/22/23,Deposit,4Y295847E9693872H,04 PAYPAL GENERAL UNRESTR,"Subject: GeneralPage
Transaction ID: 4Y295847E9693872H
https://www.paypal.com/activity/payment/4Y295847E9693872H",PayPal Bank 3,--,$18.93 ,"$999,541.55 "
Donations directed by individuals,9/22/23,Deposit,4Y295847E9693872H,04 PAYPAL GENERAL UNRESTR,Support Ukraine - Support Ukraine,Contributed income:Donations directed by individuals,PayPal Bank 3,$20.00 ,"$999,561.55 "
PayPal Fees,9/22/23,Deposit,4Y295847E9693872H,04 PAYPAL GENERAL UNRESTR,PayPal fees,OFFICE/GENERAL ADMINISTRATIVE EXPENSES:PayPal Fees,PayPal Bank 3,$1.07 ,"$999,562.62 "
PayPal Bank 3,9/22/23,Deposit,4WF86501W7438222D,04 PAYPAL GENERAL UNRESTR,"Subject: GeneralPage
Transaction ID: 4WF86501W7438222D
https://www.paypal.com/activity/payment/4WF86501W7438222D",PayPal Bank 3,--,$98.45 ,"$999,661.07 "
Donations directed by individuals,9/22/23,Deposit,4WF86501W7438222D,04 PAYPAL GENERAL UNRESTR,Support Ukraine - Support Ukraine,Contributed income:Donations directed by individuals,PayPal Bank 3,$103.48 ,"$999,764.55 "
PayPal Fees,9/22/23,Deposit,4WF86501W7438222D,04 PAYPAL GENERAL UNRESTR,PayPal fees,OFFICE/GENERAL ADMINISTRATIVE EXPENSES:PayPal Fees,PayPal Bank 3,$5.03 ,"$999,769.58 "
PayPal Bank 3,9/22/23,Deposit,7CA338358D569582P,08 VICTORY DRONES RESTR,"Subject: VICTORY DRONES
Transaction ID: 7CA338358D569582P
https://www.paypal.com/activity/payment/7CA338358D569582P",PayPal Bank 3,--,$2.94 ,"$999,772.52 "
Donations directed by individuals,9/22/23,Deposit,7CA338358D569582P,08 VICTORY DRONES RESTR,Money in to PayPal,Contributed income:Donations directed by individuals,PayPal Bank 3,$3.59 ,"$999,776.11 "
PayPal Fees,9/22/23,Deposit,7CA338358D569582P,08 VICTORY DRONES RESTR,PayPal fees,OFFICE/GENERAL ADMINISTRATIVE EXPENSES:PayPal Fees,PayPal Bank 3,$0.65 ,"$999,776.76 "
PayPal Bank 3,9/22/23,Deposit,5EB99905YK1619709,04 PAYPAL GENERAL UNRESTR,"Subject: GeneralPage
Transaction ID: 5EB99905YK1619709
https://www.paypal.com/activity/payment/5EB99905YK1619709",PayPal Bank 3,--,$573.17 ,"$1,000,349.93 "
Donations directed by individuals,9/22/23,Deposit,5EB99905YK1619709,04 PAYPAL GENERAL UNRESTR,Support Ukraine - Support Ukraine,Contributed income:Donations directed by individuals,PayPal Bank 3,$600.00 ,"$1,000,949.93 "
PayPal Fees,9/22/23,Deposit,5EB99905YK1619709,04 PAYPAL GENERAL UNRESTR,PayPal fees,OFFICE/GENERAL ADMINISTRATIVE EXPENSES:PayPal Fees,PayPal Bank 3,$26.83 ,"$1,000,976.76 "
PayPal Bank 3,9/22/23,Deposit,1NK258195G7166433,07 1000 DRONES RESTR,"Subject: 1000DRONES
Note: 1000 Drones for Ukraine
Transaction ID: 1NK258195G7166433
https://www.paypal.com/activity/payment/1NK258195G7166433",PayPal Bank 3,--,$290.84 ,"$1,001,267.60 "
Donations directed by individuals,9/22/23,Deposit,1NK258195G7166433,07 1000 DRONES RESTR,1000 DRONES FOR UKRAINE - 1000 DRONES FOR UKRAINE,Contributed income:Donations directed by individuals,PayPal Bank 3,$300.00 ,"$1,001,567.60 "
PayPal Fees,9/22/23,Deposit,1NK258195G7166433,07 1000 DRONES RESTR,PayPal fees,OFFICE/GENERAL ADMINISTRATIVE EXPENSES:PayPal Fees,PayPal Bank 3,$9.16 ,"$1,001,576.76 "
PayPal Bank 3,9/22/23,Deposit,8S8098256V0659126,04 PAYPAL GENERAL UNRESTR,"Subject: GeneralPage
Transaction ID: 8S8098256V0659126
https://www.paypal.com/activity/payment/8S8098256V0659126",PayPal Bank 3,--,$196.91 ,"$1,001,773.67 "
Donations directed by individuals,9/22/23,Deposit,8S8098256V0659126,04 PAYPAL GENERAL UNRESTR,Support Ukraine - Support Ukraine,Contributed income:Donations directed by individuals,PayPal Bank 3,$206.46 ,"$1,001,980.13 "
PayPal Fees,9/22/23,Deposit,8S8098256V0659126,04 PAYPAL GENERAL UNRESTR,PayPal fees,OFFICE/GENERAL ADMINISTRATIVE EXPENSES:PayPal Fees,PayPal Bank 3,$9.55 ,"$1,001,989.68 "
PayPal Bank 3,9/22/23,Deposit,3XR22187XW8843046,04 PAYPAL GENERAL UNRESTR,"Subject: GeneralPage
Transaction ID: 3XR22187XW8843046
https://www.paypal.com/activity/payment/3XR22187XW8843046",PayPal Bank 3,--,$9.84 ,"$1,001,999.52 "
Donations directed by individuals,9/22/23,Deposit,3XR22187XW8843046,04 PAYPAL GENERAL UNRESTR,Support Ukraine - Support Ukraine,Contributed income:Donations directed by individuals,PayPal Bank 3,$10.80 ,"$1,002,010.32 "
PayPal Fees,9/22/23,Deposit,3XR22187XW8843046,04 PAYPAL GENERAL UNRESTR,PayPal fees,OFFICE/GENERAL ADMINISTRATIVE EXPENSES:PayPal Fees,PayPal Bank 3,$0.96 ,"$1,002,011.28 "
PayPal Bank 3,9/22/23,Deposit,92A166717S631983S,04 PAYPAL GENERAL UNRESTR,"Subject: GeneralPage
Transaction ID: 92A166717S631983S
https://www.paypal.com/activity/payment/92A166717S631983S",PayPal Bank 3,--,$18.63 ,"$1,002,029.91 "
Donations directed by individuals,9/22/23,Deposit,92A166717S631983S,04 PAYPAL GENERAL UNRESTR,Support Ukraine - Support Ukraine,Contributed income:Donations directed by individuals,PayPal Bank 3,$20.00 ,"$1,002,049.91 "
PayPal Fees,9/22/23,Deposit,92A166717S631983S,04 PAYPAL GENERAL UNRESTR,PayPal fees,OFFICE/GENERAL ADMINISTRATIVE EXPENSES:PayPal Fees,PayPal Bank 3,$1.37 ,"$1,002,051.28 "
PayPal Bank 3,9/22/23,Deposit,2JK07157RS451103B,04 PAYPAL GENERAL UNRESTR,"Subject: GeneralPage
Transaction ID: 2JK07157RS451103B
https://www.paypal.com/activity/payment/2JK07157RS451103B",PayPal Bank 3,--,$23.41 ,"$1,002,074.69 "
Donations directed by individuals,9/22/23,Deposit,2JK07157RS451103B,04 PAYPAL GENERAL UNRESTR,Support Ukraine - Support Ukraine,Contributed income:Donations directed by individuals,PayPal Bank 3,$25.00 ,"$1,002,099.69 "
PayPal Fees,9/22/23,Deposit,2JK07157RS451103B,04 PAYPAL GENERAL UNRESTR,PayPal fees,OFFICE/GENERAL ADMINISTRATIVE EXPENSES:PayPal Fees,PayPal Bank 3,$1.59 ,"$1,002,101.28 "
PayPal Bank 3,9/22/23,Deposit,48J341091C089703F,07 1000 DRONES RESTR,"Subject: 1000DRONES
Transaction ID: 48J341091C089703F
https://www.paypal.com/activity/payment/48J341091C089703F",PayPal Bank 3,--,$19.68 ,"$1,002,120.96 "
Donations directed by individuals,9/22/23,Deposit,48J341091C089703F,07 1000 DRONES RESTR,1000 DRONES FOR UKRAINE - 1000 DRONES FOR UKRAINE,Contributed income:Donations directed by individuals,PayPal Bank 3,$21.10 ,"$1,002,142.06 "
PayPal Fees,9/22/23,Deposit,48J341091C089703F,07 1000 DRONES RESTR,PayPal fees,OFFICE/GENERAL ADMINISTRATIVE EXPENSES:PayPal Fees,PayPal Bank 3,$1.42 ,"$1,002,143.48 "
PayPal Bank 3,9/22/23,Deposit,16S87911137311040,04 PAYPAL GENERAL UNRESTR,"Subject: Support Ukraine
Transaction ID: 16S87911137311040
https://www.paypal.com/activity/payment/16S87911137311040",PayPal Bank 3,--,$47.25 ,"$1,002,190.73 "
Donations directed by individuals,9/22/23,Deposit,16S87911137311040,04 PAYPAL GENERAL UNRESTR,Money in to PayPal,Contributed income:Donations directed by individuals,PayPal Bank 3,$49.93 ,"$1,002,240.66 "
PayPal Fees,9/22/23,Deposit,16S87911137311040,04 PAYPAL GENERAL UNRESTR,PayPal fees,OFFICE/GENERAL ADMINISTRATIVE EXPENSES:PayPal Fees,PayPal Bank 3,$2.68 ,"$1,002,243.34 "
PayPal Bank 3,9/22/23,Deposit,9VW99510006981318,04 PAYPAL GENERAL UNRESTR,"Subject: GeneralPage
Transaction ID: 9VW99510006981318
https://www.paypal.com/activity/payment/9VW99510006981318",PayPal Bank 3,--,$29.53 ,"$1,002,272.87 "
Donations directed by individuals,9/22/23,Deposit,9VW99510006981318,04 PAYPAL GENERAL UNRESTR,Support Ukraine - Support Ukraine,Contributed income:Donations directed by individuals,PayPal Bank 3,$31.40 ,"$1,002,304.27 "
PayPal Fees,9/22/23,Deposit,9VW99510006981318,04 PAYPAL GENERAL UNRESTR,PayPal fees,OFFICE/GENERAL ADMINISTRATIVE EXPENSES:PayPal Fees,PayPal Bank 3,$1.87 ,"$1,002,306.14 "
PayPal Bank 3,9/22/23,Deposit,6WK833943P229073V,04 PAYPAL GENERAL UNRESTR,"Subject: GeneralPage
Transaction ID: 6WK833943P229073V
https://www.paypal.com/activity/payment/6WK833943P229073V",PayPal Bank 3,--,$13.85 ,"$1,002,319.99 "
Donations directed by individuals,9/22/23,Deposit,6WK833943P229073V,04 PAYPAL GENERAL UNRESTR,Support Ukraine - Support Ukraine,Contributed income:Donations directed by individuals,PayPal Bank 3,$15.00 ,"$1,002,334.99 "
PayPal Fees,9/22/23,Deposit,6WK833943P229073V,04 PAYPAL GENERAL UNRESTR,PayPal fees,OFFICE/GENERAL ADMINISTRATIVE EXPENSES:PayPal Fees,PayPal Bank 3,$1.15 ,"$1,002,336.14 "
PayPal Bank 3,9/22/23,Deposit,3KE110899T596373N,07 1000 DRONES RESTR,"Subject: GeneralPage
Note: Люті пташки ��
Transaction ID: 3KE110899T596373N
https://www.paypal.com/activity/payment/3KE110899T596373N",PayPal Bank 3,--,$98.45 ,"$1,002,434.59 "
Donations directed by individuals,9/22/23,Deposit,3KE110899T596373N,07 1000 DRONES RESTR,Support Ukraine - Support Ukraine,Contributed income:Donations directed by individuals,PayPal Bank 3,$103.48 ,"$1,002,538.07 "
PayPal Fees,9/22/23,Deposit,3KE110899T596373N,07 1000 DRONES RESTR,PayPal fees,OFFICE/GENERAL ADMINISTRATIVE EXPENSES:PayPal Fees,PayPal Bank 3,$5.03 ,"$1,002,543.10 "
PayPal Bank 3,9/22/23,Deposit,25M34503NX359714G,07 1000 DRONES RESTR,"Subject: GeneralPage
Note: До 1000 дронів для України неньки
Transaction ID: 25M34503NX359714G
https://www.paypal.com/activity/payment/25M34503NX359714G",PayPal Bank 3,--,$295.36 ,"$1,002,838.46 "
Donations directed by individuals,9/22/23,Deposit,25M34503NX359714G,07 1000 DRONES RESTR,Support Ukraine - Support Ukraine,Contributed income:Donations directed by individuals,PayPal Bank 3,$309.43 ,"$1,003,147.89 "
PayPal Fees,9/22/23,Deposit,25M34503NX359714G,07 1000 DRONES RESTR,PayPal fees,OFFICE/GENERAL ADMINISTRATIVE EXPENSES:PayPal Fees,PayPal Bank 3,$14.07 ,"$1,003,161.96 "
PayPal Bank 3,9/22/23,Deposit,9XE72826T6403323F,04 PAYPAL GENERAL UNRESTR,"Subject: GeneralPage
Transaction ID: 9XE72826T6403323F
https://www.paypal.com/activity/payment/9XE72826T6403323F",PayPal Bank 3,--,$50.00 ,"$1,003,211.96 "
Donations directed by individuals,9/22/23,Deposit,9XE72826T6403323F,04 PAYPAL GENERAL UNRESTR,Support Ukraine - Support Ukraine,Contributed income:Donations directed by individuals,PayPal Bank 3,$51.99 ,"$1,003,263.95 "
PayPal Fees,9/22/23,Deposit,9XE72826T6403323F,04 PAYPAL GENERAL UNRESTR,PayPal fees,OFFICE/GENERAL ADMINISTRATIVE EXPENSES:PayPal Fees,PayPal Bank 3,$1.99 ,"$1,003,265.94 "
PayPal Bank 3,9/22/23,Deposit,8F387199M5915234R,04 PAYPAL GENERAL UNRESTR,"Subject: GeneralPage
Transaction ID: 8F387199M5915234R
https://www.paypal.com/activity/payment/8F387199M5915234R",PayPal Bank 3,--,$32.97 ,"$1,003,298.91 "
Donations directed by individuals,9/22/23,Deposit,8F387199M5915234R,04 PAYPAL GENERAL UNRESTR,Support Ukraine - Support Ukraine,Contributed income:Donations directed by individuals,PayPal Bank 3,$35.00 ,"$1,003,333.91 "
PayPal Fees,9/22/23,Deposit,8F387199M5915234R,04 PAYPAL GENERAL UNRESTR,PayPal fees,OFFICE/GENERAL ADMINISTRATIVE EXPENSES:PayPal Fees,PayPal Bank 3,$2.03 ,"$1,003,335.94 "
PayPal Bank 3,9/22/23,Deposit,42B07612NT542883V,04 PAYPAL GENERAL UNRESTR,"Subject: Support Ukraine
Transaction ID: 42B07612NT542883V
https://www.paypal.com/activity/payment/42B07612NT542883V",PayPal Bank 3,--,$9.84 ,"$1,003,345.78 "
Donations directed by individuals,9/22/23,Deposit,42B07612NT542883V,04 PAYPAL GENERAL UNRESTR,Money in to PayPal,Contributed income:Donations directed by individuals,PayPal Bank 3,$10.80 ,"$1,003,356.58 "
PayPal Fees,9/22/23,Deposit,42B07612NT542883V,04 PAYPAL GENERAL UNRESTR,PayPal fees,OFFICE/GENERAL ADMINISTRATIVE EXPENSES:PayPal Fees,PayPal Bank 3,$0.96 ,"$1,003,357.54 "
PayPal Bank 3,9/22/23,Deposit,42K81052BV6225712,04 PAYPAL GENERAL UNRESTR,"Subject: GeneralPage
Transaction ID: 42K81052BV6225712
https://www.paypal.com/activity/payment/42K81052BV6225712",PayPal Bank 3,--,$49.22 ,"$1,003,406.76 "
Donations directed by individuals,9/22/23,Deposit,42K81052BV6225712,04 PAYPAL GENERAL UNRESTR,Support Ukraine - Support Ukraine,Contributed income:Donations directed by individuals,PayPal Bank 3,$51.99 ,"$1,003,458.75 "
PayPal Fees,9/22/23,Deposit,42K81052BV6225712,04 PAYPAL GENERAL UNRESTR,PayPal fees,OFFICE/GENERAL ADMINISTRATIVE EXPENSES:PayPal Fees,PayPal Bank 3,$2.77 ,"$1,003,461.52 "
PayPal Bank 3,9/22/23,Deposit,6W103413XG919330W,04 PAYPAL GENERAL UNRESTR,"Subject: GeneralPage
Transaction ID: 6W103413XG919330W
https://www.paypal.com/activity/payment/6W103413XG919330W",PayPal Bank 3,--,$96.62 ,"$1,003,558.14 "
Donations directed by individuals,9/22/23,Deposit,6W103413XG919330W,04 PAYPAL GENERAL UNRESTR,Support Ukraine - Support Ukraine,Contributed income:Donations directed by individuals,PayPal Bank 3,$100.00 ,"$1,003,658.14 "
PayPal Fees,9/22/23,Deposit,6W103413XG919330W,04 PAYPAL GENERAL UNRESTR,PayPal fees,OFFICE/GENERAL ADMINISTRATIVE EXPENSES:PayPal Fees,PayPal Bank 3,$3.38 ,"$1,003,661.52 "
PayPal Bank 3,9/22/23,Deposit,9GR73003PP668005S,04 PAYPAL GENERAL UNRESTR,"Subject: GeneralPage
Transaction ID: 9GR73003PP668005S
https://www.paypal.com/activity/payment/9GR73003PP668005S",PayPal Bank 3,--,$98.45 ,"$1,003,759.97 "
Donations directed by individuals,9/22/23,Deposit,9GR73003PP668005S,04 PAYPAL GENERAL UNRESTR,Support Ukraine - Support Ukraine,Contributed income:Donations directed by individuals,PayPal Bank 3,$103.48 ,"$1,003,863.45 "
PayPal Fees,9/22/23,Deposit,9GR73003PP668005S,04 PAYPAL GENERAL UNRESTR,PayPal fees,OFFICE/GENERAL ADMINISTRATIVE EXPENSES:PayPal Fees,PayPal Bank 3,$5.03 ,"$1,003,868.48 "
PayPal Bank 3,9/22/23,Deposit,8KS66926H3530631A,04 PAYPAL GENERAL UNRESTR,"Subject: GeneralPage
Transaction ID: 8KS66926H3530631A
https://www.paypal.com/activity/payment/8KS66926H3530631A",PayPal Bank 3,--,$500.00 ,"$1,004,368.48 "
Donations directed by individuals,9/22/23,Deposit,8KS66926H3530631A,04 PAYPAL GENERAL UNRESTR,Support Ukraine - Support Ukraine,Contributed income:Donations directed by individuals,PayPal Bank 3,$515.38 ,"$1,004,883.86 "
PayPal Fees,9/22/23,Deposit,8KS66926H3530631A,04 PAYPAL GENERAL UNRESTR,PayPal fees,OFFICE/GENERAL ADMINISTRATIVE EXPENSES:PayPal Fees,PayPal Bank 3,$15.38 ,"$1,004,899.24 "
PayPal Bank 3,9/22/23,Deposit,03K69425HF604842P,04 PAYPAL GENERAL UNRESTR,"Subject: GeneralPage
Transaction ID: 03K69425HF604842P
https://www.paypal.com/activity/payment/03K69425HF604842P",PayPal Bank 3,--,$100.00 ,"$1,004,999.24 "
Donations directed by individuals,9/22/23,Deposit,03K69425HF604842P,04 PAYPAL GENERAL UNRESTR,Support Ukraine - Support Ukraine,Contributed income:Donations directed by individuals,PayPal Bank 3,$103.48 ,"$1,005,102.72 "
PayPal Fees,9/22/23,Deposit,03K69425HF604842P,04 PAYPAL GENERAL UNRESTR,PayPal fees,OFFICE/GENERAL ADMINISTRATIVE EXPENSES:PayPal Fees,PayPal Bank 3,$3.48 ,"$1,005,106.20 "
PayPal Bank 3,9/22/23,Deposit,5XA3732165849152L,04 PAYPAL GENERAL UNRESTR,"Subject: GeneralPage
Transaction ID: 5XA3732165849152L
https://www.paypal.com/activity/payment/5XA3732165849152L",PayPal Bank 3,--,$100.00 ,"$1,005,206.20 "
Donations directed by individuals,9/22/23,Deposit,5XA3732165849152L,04 PAYPAL GENERAL UNRESTR,Support Ukraine - Support Ukraine,Contributed income:Donations directed by individuals,PayPal Bank 3,$103.48 ,"$1,005,309.68 "
PayPal Fees,9/22/23,Deposit,5XA3732165849152L,04 PAYPAL GENERAL UNRESTR,PayPal fees,OFFICE/GENERAL ADMINISTRATIVE EXPENSES:PayPal Fees,PayPal Bank 3,$3.48 ,"$1,005,313.16 "
PayPal Bank 3,9/22/23,Deposit,95538973EW2526137,07 1000 DRONES RESTR,"Subject: GeneralPage
Note: Na ptashky
Transaction ID: 95538973EW2526137
https://www.paypal.com/activity/payment/95538973EW2526137",PayPal Bank 3,--,$9.22 ,"$1,005,322.38 "
Donations directed by individuals,9/22/23,Deposit,95538973EW2526137,07 1000 DRONES RESTR,Support Ukraine - Support Ukraine,Contributed income:Donations directed by individuals,PayPal Bank 3,$10.00 ,"$1,005,332.38 "
PayPal Fees,9/22/23,Deposit,95538973EW2526137,07 1000 DRONES RESTR,PayPal fees,OFFICE/GENERAL ADMINISTRATIVE EXPENSES:PayPal Fees,PayPal Bank 3,$0.78 ,"$1,005,333.16 "
PayPal Bank 3,9/22/23,Deposit,5JV12215MS3743010,04 PAYPAL GENERAL UNRESTR,"Subject: Support Ukraine
Transaction ID: 5JV12215MS3743010
https://www.paypal.com/activity/payment/5JV12215MS3743010",PayPal Bank 3,--,$9.07 ,"$1,005,342.23 "
Donations directed by individuals,9/22/23,Deposit,5JV12215MS3743010,04 PAYPAL GENERAL UNRESTR,Money in to PayPal,Contributed income:Donations directed by individuals,PayPal Bank 3,$10.00 ,"$1,005,352.23 "
PayPal Fees,9/22/23,Deposit,5JV12215MS3743010,04 PAYPAL GENERAL UNRESTR,PayPal fees,OFFICE/GENERAL ADMINISTRATIVE EXPENSES:PayPal Fees,PayPal Bank 3,$0.93 ,"$1,005,353.16 "
PayPal Bank 3,9/22/23,Deposit,6WK07755YW466793L,04 PAYPAL GENERAL UNRESTR,"Subject: GeneralPage
Transaction ID: 6WK07755YW466793L
https://www.paypal.com/activity/payment/6WK07755YW466793L",PayPal Bank 3,--,$47.31 ,"$1,005,400.47 "
Donations directed by individuals,9/22/23,Deposit,6WK07755YW466793L,04 PAYPAL GENERAL UNRESTR,Support Ukraine - Support Ukraine,Contributed income:Donations directed by individuals,PayPal Bank 3,$50.00 ,"$1,005,450.47 "
PayPal Fees,9/22/23,Deposit,6WK07755YW466793L,04 PAYPAL GENERAL UNRESTR,PayPal fees,OFFICE/GENERAL ADMINISTRATIVE EXPENSES:PayPal Fees,PayPal Bank 3,$2.69 ,"$1,005,453.16 "
PayPal Bank 3,9/22/23,Deposit,9FC1834436717901S,04 PAYPAL GENERAL UNRESTR,"Subject: GeneralPage
Note: Support for Ukraine
Transaction ID: 9FC1834436717901S
https://www.paypal.com/activity/payment/9FC1834436717901S",PayPal Bank 3,--,$200.00 ,"$1,005,653.16 "
Donations directed by individuals,9/22/23,Deposit,9FC1834436717901S,04 PAYPAL GENERAL UNRESTR,Support Ukraine - Support Ukraine,Contributed income:Donations directed by individuals,PayPal Bank 3,$206.46 ,"$1,005,859.62 "
PayPal Fees,9/22/23,Deposit,9FC1834436717901S,04 PAYPAL GENERAL UNRESTR,PayPal fees,OFFICE/GENERAL ADMINISTRATIVE EXPENSES:PayPal Fees,PayPal Bank 3,$6.46 ,"$1,005,866.08 "
PayPal Bank 3,9/22/23,Deposit,5RA79431HA847290Y,04 PAYPAL GENERAL UNRESTR,"Subject: GeneralPage
Transaction ID: 5RA79431HA847290Y
https://www.paypal.com/activity/payment/5RA79431HA847290Y",PayPal Bank 3,--,$98.45 ,"$1,005,964.53 "
Donations directed by individuals,9/22/23,Deposit,5RA79431HA847290Y,04 PAYPAL GENERAL UNRESTR,Support Ukraine - Support Ukraine,Contributed income:Donations directed by individuals,PayPal Bank 3,$103.48 ,"$1,006,068.01 "
PayPal Fees,9/22/23,Deposit,5RA79431HA847290Y,04 PAYPAL GENERAL UNRESTR,PayPal fees,OFFICE/GENERAL ADMINISTRATIVE EXPENSES:PayPal Fees,PayPal Bank 3,$5.03 ,"$1,006,073.04 "
PayPal Bank 3,9/22/23,Deposit,25F31626EE663584U,04 PAYPAL GENERAL UNRESTR,"Subject: GeneralPage
Transaction ID: 25F31626EE663584U
https://www.paypal.com/activity/payment/25F31626EE663584U",PayPal Bank 3,--,$9.07 ,"$1,006,082.11 "
Donations directed by individuals,9/22/23,Deposit,25F31626EE663584U,04 PAYPAL GENERAL UNRESTR,Support Ukraine - Support Ukraine,Contributed income:Donations directed by individuals,PayPal Bank 3,$10.00 ,"$1,006,092.11 "
PayPal Fees,9/22/23,Deposit,25F31626EE663584U,04 PAYPAL GENERAL UNRESTR,PayPal fees,OFFICE/GENERAL ADMINISTRATIVE EXPENSES:PayPal Fees,PayPal Bank 3,$0.93 ,"$1,006,093.04 "
PayPal Bank 3,9/22/23,Deposit,77H280990U621721G,04 PAYPAL GENERAL UNRESTR,"Subject: GeneralPage
Transaction ID: 77H280990U621721G
https://www.paypal.com/activity/payment/77H280990U621721G",PayPal Bank 3,--,$49.22 ,"$1,006,142.26 "
Donations directed by individuals,9/22/23,Deposit,77H280990U621721G,04 PAYPAL GENERAL UNRESTR,Support Ukraine - Support Ukraine,Contributed income:Donations directed by individuals,PayPal Bank 3,$51.99 ,"$1,006,194.25 "
PayPal Fees,9/22/23,Deposit,77H280990U621721G,04 PAYPAL GENERAL UNRESTR,PayPal fees,OFFICE/GENERAL ADMINISTRATIVE EXPENSES:PayPal Fees,PayPal Bank 3,$2.77 ,"$1,006,197.02 "
PayPal Bank 3,9/22/23,Deposit,58U2170704821354R,04 PAYPAL GENERAL UNRESTR,"Subject: GeneralPage
Transaction ID: 58U2170704821354R
https://www.paypal.com/activity/payment/58U2170704821354R",PayPal Bank 3,--,$19.68 ,"$1,006,216.70 "
Donations directed by individuals,9/22/23,Deposit,58U2170704821354R,04 PAYPAL GENERAL UNRESTR,Support Ukraine - Support Ukraine,Contributed income:Donations directed by individuals,PayPal Bank 3,$21.10 ,"$1,006,237.80 "
PayPal Fees,9/22/23,Deposit,58U2170704821354R,04 PAYPAL GENERAL UNRESTR,PayPal fees,OFFICE/GENERAL ADMINISTRATIVE EXPENSES:PayPal Fees,PayPal Bank 3,$1.42 ,"$1,006,239.22 "
PayPal Bank 3,9/22/23,Deposit,359359249B0114451,04 PAYPAL GENERAL UNRESTR,"Subject: GeneralPage
Transaction ID: 359359249B0114451
https://www.paypal.com/activity/payment/359359249B0114451",PayPal Bank 3,--,$19.68 ,"$1,006,258.90 "
Donations directed by individuals,9/22/23,Deposit,359359249B0114451,04 PAYPAL GENERAL UNRESTR,Support Ukraine - Support Ukraine,Contributed income:Donations directed by individuals,PayPal Bank 3,$21.10 ,"$1,006,280.00 "
PayPal Fees,9/22/23,Deposit,359359249B0114451,04 PAYPAL GENERAL UNRESTR,PayPal fees,OFFICE/GENERAL ADMINISTRATIVE EXPENSES:PayPal Fees,PayPal Bank 3,$1.42 ,"$1,006,281.42 "
PayPal Bank 3,9/22/23,Deposit,5RW14553BU7106123,04 PAYPAL GENERAL UNRESTR,"Subject: Support Ukraine
Transaction ID: 5RW14553BU7106123
https://www.paypal.com/activity/payment/5RW14553BU7106123",PayPal Bank 3,--,$24.61 ,"$1,006,306.03 "
Donations directed by individuals,9/22/23,Deposit,5RW14553BU7106123,04 PAYPAL GENERAL UNRESTR,Money in to PayPal,Contributed income:Donations directed by individuals,PayPal Bank 3,$26.25 ,"$1,006,332.28 "
PayPal Fees,9/22/23,Deposit,5RW14553BU7106123,04 PAYPAL GENERAL UNRESTR,PayPal fees,OFFICE/GENERAL ADMINISTRATIVE EXPENSES:PayPal Fees,PayPal Bank 3,$1.64 ,"$1,006,333.92 "
PayPal Bank 3,9/22/23,Deposit,1N559813K2223021G,04 PAYPAL GENERAL UNRESTR,"Subject: Support Ukraine
Transaction ID: 1N559813K2223021G
https://www.paypal.com/activity/payment/1N559813K2223021G",PayPal Bank 3,--,$50.00 ,"$1,006,383.92 "
Donations directed by individuals,9/22/23,Deposit,1N559813K2223021G,04 PAYPAL GENERAL UNRESTR,Money in to PayPal,Contributed income:Donations directed by individuals,PayPal Bank 3,$51.99 ,"$1,006,435.91 "
PayPal Fees,9/22/23,Deposit,1N559813K2223021G,04 PAYPAL GENERAL UNRESTR,PayPal fees,OFFICE/GENERAL ADMINISTRATIVE EXPENSES:PayPal Fees,PayPal Bank 3,$1.99 ,"$1,006,437.90 "
PayPal Bank 3,9/22/23,Deposit,3F632953T3606281T,07 1000 DRONES RESTR,"Subject: 1000DRONES
Transaction ID: 3F632953T3606281T
https://www.paypal.com/activity/payment/3F632953T3606281T",PayPal Bank 3,--,$193.73 ,"$1,006,631.63 "
Donations directed by individuals,9/22/23,Deposit,3F632953T3606281T,07 1000 DRONES RESTR,1000 DRONES FOR UKRAINE - 1000 DRONES FOR UKRAINE,Contributed income:Donations directed by individuals,PayPal Bank 3,$200.00 ,"$1,006,831.63 "
PayPal Fees,9/22/23,Deposit,3F632953T3606281T,07 1000 DRONES RESTR,PayPal fees,OFFICE/GENERAL ADMINISTRATIVE EXPENSES:PayPal Fees,PayPal Bank 3,$6.27 ,"$1,006,837.90 "
PayPal Bank 3,9/22/23,Deposit,4JM21726SS849751D,04 PAYPAL GENERAL UNRESTR,"Subject: GeneralPage
Transaction ID: 4JM21726SS849751D
https://www.paypal.com/activity/payment/4JM21726SS849751D",PayPal Bank 3,--,$95.12 ,"$1,006,933.02 "
Donations directed by individuals,9/22/23,Deposit,4JM21726SS849751D,04 PAYPAL GENERAL UNRESTR,Support Ukraine - Support Ukraine,Contributed income:Donations directed by individuals,PayPal Bank 3,$100.00 ,"$1,007,033.02 "
PayPal Fees,9/22/23,Deposit,4JM21726SS849751D,04 PAYPAL GENERAL UNRESTR,PayPal fees,OFFICE/GENERAL ADMINISTRATIVE EXPENSES:PayPal Fees,PayPal Bank 3,$4.88 ,"$1,007,037.90 "
PayPal Bank 3,9/22/23,Deposit,5H0010721Y763150T,04 PAYPAL GENERAL UNRESTR,"Subject: GeneralPage
Transaction ID: 5H0010721Y763150T
https://www.paypal.com/activity/payment/5H0010721Y763150T",PayPal Bank 3,--,$95.12 ,"$1,007,133.02 "
Donations directed by individuals,9/22/23,Deposit,5H0010721Y763150T,04 PAYPAL GENERAL UNRESTR,Support Ukraine - Support Ukraine,Contributed income:Donations directed by individuals,PayPal Bank 3,$100.00 ,"$1,007,233.02 "
PayPal Fees,9/22/23,Deposit,5H0010721Y763150T,04 PAYPAL GENERAL UNRESTR,PayPal fees,OFFICE/GENERAL ADMINISTRATIVE EXPENSES:PayPal Fees,PayPal Bank 3,$4.88 ,"$1,007,237.90 "
PayPal Bank 3,9/22/23,Deposit,1LT21801GY7912345,07 1000 DRONES RESTR,"Subject: 1000DRONES
Transaction ID: 1LT21801GY7912345
https://www.paypal.com/activity/payment/1LT21801GY7912345",PayPal Bank 3,--,$492.26 ,"$1,007,730.16 "
Donations directed by individuals,9/22/23,Deposit,1LT21801GY7912345,07 1000 DRONES RESTR,1000 DRONES FOR UKRAINE - 1000 DRONES FOR UKRAINE,Contributed income:Donations directed by individuals,PayPal Bank 3,$515.38 ,"$1,008,245.54 "
PayPal Fees,9/22/23,Deposit,1LT21801GY7912345,07 1000 DRONES RESTR,PayPal fees,OFFICE/GENERAL ADMINISTRATIVE EXPENSES:PayPal Fees,PayPal Bank 3,$23.12 ,"$1,008,268.66 "
PayPal Bank 3,9/22/23,Deposit,4KE83002GX485871C,04 PAYPAL GENERAL UNRESTR,"Subject: GeneralPage
Note: Slava Ukraini!
Transaction ID: 4KE83002GX485871C
https://www.paypal.com/activity/payment/4KE83002GX485871C",PayPal Bank 3,--,$300.00 ,"$1,008,568.66 "
Donations directed by individuals,9/22/23,Deposit,4KE83002GX485871C,04 PAYPAL GENERAL UNRESTR,Support Ukraine - Support Ukraine,Contributed income:Donations directed by individuals,PayPal Bank 3,$309.43 ,"$1,008,878.09 "
PayPal Fees,9/22/23,Deposit,4KE83002GX485871C,04 PAYPAL GENERAL UNRESTR,PayPal fees,OFFICE/GENERAL ADMINISTRATIVE EXPENSES:PayPal Fees,PayPal Bank 3,$9.43 ,"$1,008,887.52 "
PayPal Bank 3,9/22/23,Deposit,2DA32544345137526,04 PAYPAL GENERAL UNRESTR,"Subject: GeneralPage
Note: Слава Україні ��
Transaction ID: 2DA32544345137526
https://www.paypal.com/activity/payment/2DA32544345137526",PayPal Bank 3,--,$19.68 ,"$1,008,907.20 "
Donations directed by individuals,9/22/23,Deposit,2DA32544345137526,04 PAYPAL GENERAL UNRESTR,Support Ukraine - Support Ukraine,Contributed income:Donations directed by individuals,PayPal Bank 3,$21.10 ,"$1,008,928.30 "
PayPal Fees,9/22/23,Deposit,2DA32544345137526,04 PAYPAL GENERAL UNRESTR,PayPal fees,OFFICE/GENERAL ADMINISTRATIVE EXPENSES:PayPal Fees,PayPal Bank 3,$1.42 ,"$1,008,929.72 "
PayPal Bank 3,9/22/23,Deposit,3S921031J73009534,04 PAYPAL GENERAL UNRESTR,"Subject: GeneralPage
Transaction ID: 3S921031J73009534
https://www.paypal.com/activity/payment/3S921031J73009534",PayPal Bank 3,--,$49.22 ,"$1,008,978.94 "
Donations directed by individuals,9/22/23,Deposit,3S921031J73009534,04 PAYPAL GENERAL UNRESTR,Support Ukraine - Support Ukraine,Contributed income:Donations directed by individuals,PayPal Bank 3,$51.99 ,"$1,009,030.93 "
PayPal Fees,9/22/23,Deposit,3S921031J73009534,04 PAYPAL GENERAL UNRESTR,PayPal fees,OFFICE/GENERAL ADMINISTRATIVE EXPENSES:PayPal Fees,PayPal Bank 3,$2.77 ,"$1,009,033.70 "
PayPal Bank 3,9/22/23,Deposit,2VM04440AS328494H,04 PAYPAL GENERAL UNRESTR,"Subject: GeneralPage
Transaction ID: 2VM04440AS328494H
https://www.paypal.com/activity/payment/2VM04440AS328494H",PayPal Bank 3,--,$95.12 ,"$1,009,128.82 "
Donations directed by individuals,9/22/23,Deposit,2VM04440AS328494H,04 PAYPAL GENERAL UNRESTR,Support Ukraine - Support Ukraine,Contributed income:Donations directed by individuals,PayPal Bank 3,$100.00 ,"$1,009,228.82 "
PayPal Fees,9/22/23,Deposit,2VM04440AS328494H,04 PAYPAL GENERAL UNRESTR,PayPal fees,OFFICE/GENERAL ADMINISTRATIVE EXPENSES:PayPal Fees,PayPal Bank 3,$4.88 ,"$1,009,233.70 "
PayPal Bank 3,9/22/23,Deposit,00K56961BF045794P,07 1000 DRONES RESTR,"Subject: 1000DRONES
Note: На дрони їбошити русню от родини одеситів.   Дякуємо за тещо ви робите!
Transaction ID: 00K56961BF045794P
https://www.paypal.com/activity/payment/00K56961BF045794P",PayPal Bank 3,--,$47.31 ,"$1,009,281.01 "
Donations directed by individuals,9/22/23,Deposit,00K56961BF045794P,07 1000 DRONES RESTR,1000 DRONES FOR UKRAINE - 1000 DRONES FOR UKRAINE,Contributed income:Donations directed by individuals,PayPal Bank 3,$50.00 ,"$1,009,331.01 "
PayPal Fees,9/22/23,Deposit,00K56961BF045794P,07 1000 DRONES RESTR,PayPal fees,OFFICE/GENERAL ADMINISTRATIVE EXPENSES:PayPal Fees,PayPal Bank 3,$2.69 ,"$1,009,333.70 "
PayPal Bank 3,9/22/23,Deposit,98S39545HS489392P,04 PAYPAL GENERAL UNRESTR,"Subject: GeneralPage
Transaction ID: 98S39545HS489392P
https://www.paypal.com/activity/payment/98S39545HS489392P",PayPal Bank 3,--,$39.37 ,"$1,009,373.07 "
Donations directed by individuals,9/22/23,Deposit,98S39545HS489392P,04 PAYPAL GENERAL UNRESTR,Support Ukraine - Support Ukraine,Contributed income:Donations directed by individuals,PayPal Bank 3,$41.69 ,"$1,009,414.76 "
PayPal Fees,9/22/23,Deposit,98S39545HS489392P,04 PAYPAL GENERAL UNRESTR,PayPal fees,OFFICE/GENERAL ADMINISTRATIVE EXPENSES:PayPal Fees,PayPal Bank 3,$2.32 ,"$1,009,417.08 "
PayPal Bank 3,9/22/23,Deposit,5RS06339Y0587420W,04 PAYPAL GENERAL UNRESTR,"Subject: GeneralPage
Transaction ID: 5RS06339Y0587420W
https://www.paypal.com/activity/payment/5RS06339Y0587420W",PayPal Bank 3,--,$246.13 ,"$1,009,663.21 "
Donations directed by individuals,9/22/23,Deposit,5RS06339Y0587420W,04 PAYPAL GENERAL UNRESTR,Support Ukraine - Support Ukraine,Contributed income:Donations directed by individuals,PayPal Bank 3,$257.94 ,"$1,009,921.15 "
PayPal Fees,9/22/23,Deposit,5RS06339Y0587420W,04 PAYPAL GENERAL UNRESTR,PayPal fees,OFFICE/GENERAL ADMINISTRATIVE EXPENSES:PayPal Fees,PayPal Bank 3,$11.81 ,"$1,009,932.96 "
PayPal Bank 3,9/22/23,Deposit,3WG41587NM439472Y,04 PAYPAL GENERAL UNRESTR,"Subject: GeneralPage
Transaction ID: 3WG41587NM439472Y
https://www.paypal.com/activity/payment/3WG41587NM439472Y",PayPal Bank 3,--,$47.31 ,"$1,009,980.27 "
Donations directed by individuals,9/22/23,Deposit,3WG41587NM439472Y,04 PAYPAL GENERAL UNRESTR,Support Ukraine - Support Ukraine,Contributed income:Donations directed by individuals,PayPal Bank 3,$50.00 ,"$1,010,030.27 "
PayPal Fees,9/22/23,Deposit,3WG41587NM439472Y,04 PAYPAL GENERAL UNRESTR,PayPal fees,OFFICE/GENERAL ADMINISTRATIVE EXPENSES:PayPal Fees,PayPal Bank 3,$2.69 ,"$1,010,032.96 "
PayPal Bank 3,9/22/23,Deposit,33T93556B1385403L,04 PAYPAL GENERAL UNRESTR,"Subject: GeneralPage
Transaction ID: 33T93556B1385403L
https://www.paypal.com/activity/payment/33T93556B1385403L",PayPal Bank 3,--,$19.68 ,"$1,010,052.64 "
Donations directed by individuals,9/22/23,Deposit,33T93556B1385403L,04 PAYPAL GENERAL UNRESTR,Support Ukraine - Support Ukraine,Contributed income:Donations directed by individuals,PayPal Bank 3,$21.10 ,"$1,010,073.74 "
PayPal Fees,9/22/23,Deposit,33T93556B1385403L,04 PAYPAL GENERAL UNRESTR,PayPal fees,OFFICE/GENERAL ADMINISTRATIVE EXPENSES:PayPal Fees,PayPal Bank 3,$1.42 ,"$1,010,075.16 "
PayPal Bank 3,9/22/23,Deposit,6TY60856ET897635N,04 PAYPAL GENERAL UNRESTR,"Subject: GeneralPage
Transaction ID: 6TY60856ET897635N
https://www.paypal.com/activity/payment/6TY60856ET897635N",PayPal Bank 3,--,$9.84 ,"$1,010,085.00 "
Donations directed by individuals,9/22/23,Deposit,6TY60856ET897635N,04 PAYPAL GENERAL UNRESTR,Support Ukraine - Support Ukraine,Contributed income:Donations directed by individuals,PayPal Bank 3,$10.80 ,"$1,010,095.80 "
PayPal Fees,9/22/23,Deposit,6TY60856ET897635N,04 PAYPAL GENERAL UNRESTR,PayPal fees,OFFICE/GENERAL ADMINISTRATIVE EXPENSES:PayPal Fees,PayPal Bank 3,$0.96 ,"$1,010,096.76 "
PayPal Bank 3,9/22/23,Deposit,2AG40679G54369508,07 1000 DRONES RESTR,"Subject: 1000DRONES
Transaction ID: 2AG40679G54369508
https://www.paypal.com/activity/payment/2AG40679G54369508",PayPal Bank 3,--,$9.07 ,"$1,010,105.83 "
Donations directed by individuals,9/22/23,Deposit,2AG40679G54369508,07 1000 DRONES RESTR,1000 DRONES FOR UKRAINE - 1000 DRONES FOR UKRAINE,Contributed income:Donations directed by individuals,PayPal Bank 3,$10.00 ,"$1,010,115.83 "
PayPal Fees,9/22/23,Deposit,2AG40679G54369508,07 1000 DRONES RESTR,PayPal fees,OFFICE/GENERAL ADMINISTRATIVE EXPENSES:PayPal Fees,PayPal Bank 3,$0.93 ,"$1,010,116.76 "
PayPal Bank 3,9/22/23,Deposit,27365438GR4770420,04 PAYPAL GENERAL UNRESTR,"Subject: GeneralPage
Transaction ID: 27365438GR4770420
https://www.paypal.com/activity/payment/27365438GR4770420",PayPal Bank 3,--,$500.00 ,"$1,010,616.76 "
Donations directed by individuals,9/22/23,Deposit,27365438GR4770420,04 PAYPAL GENERAL UNRESTR,Support Ukraine - Support Ukraine,Contributed income:Donations directed by individuals,PayPal Bank 3,$515.38 ,"$1,011,132.14 "
PayPal Fees,9/22/23,Deposit,27365438GR4770420,04 PAYPAL GENERAL UNRESTR,PayPal fees,OFFICE/GENERAL ADMINISTRATIVE EXPENSES:PayPal Fees,PayPal Bank 3,$15.38 ,"$1,011,147.52 "
PayPal Bank 3,9/22/23,Deposit,58G17779VT869534N,04 PAYPAL GENERAL UNRESTR,"Subject: GeneralPage
Transaction ID: 58G17779VT869534N
https://www.paypal.com/activity/payment/58G17779VT869534N",PayPal Bank 3,--,$147.68 ,"$1,011,295.20 "
Donations directed by individuals,9/22/23,Deposit,58G17779VT869534N,04 PAYPAL GENERAL UNRESTR,Support Ukraine - Support Ukraine,Contributed income:Donations directed by individuals,PayPal Bank 3,$154.97 ,"$1,011,450.17 "
PayPal Fees,9/22/23,Deposit,58G17779VT869534N,04 PAYPAL GENERAL UNRESTR,PayPal fees,OFFICE/GENERAL ADMINISTRATIVE EXPENSES:PayPal Fees,PayPal Bank 3,$7.29 ,"$1,011,457.46 "
PayPal Bank 3,9/22/23,Deposit,4FP558038W846493C,04 PAYPAL GENERAL UNRESTR,"Subject: GeneralPage
Transaction ID: 4FP558038W846493C
https://www.paypal.com/activity/payment/4FP558038W846493C",PayPal Bank 3,--,$9.84 ,"$1,011,467.30 "
Donations directed by individuals,9/22/23,Deposit,4FP558038W846493C,04 PAYPAL GENERAL UNRESTR,Support Ukraine - Support Ukraine,Contributed income:Donations directed by individuals,PayPal Bank 3,$10.80 ,"$1,011,478.10 "
PayPal Fees,9/22/23,Deposit,4FP558038W846493C,04 PAYPAL GENERAL UNRESTR,PayPal fees,OFFICE/GENERAL ADMINISTRATIVE EXPENSES:PayPal Fees,PayPal Bank 3,$0.96 ,"$1,011,479.06 "
PayPal Bank 3,9/22/23,Deposit,94613622SY192712G,04 PAYPAL GENERAL UNRESTR,"Subject: GeneralPage
Transaction ID: 94613622SY192712G
https://www.paypal.com/activity/payment/94613622SY192712G",PayPal Bank 3,--,$49.22 ,"$1,011,528.28 "
Donations directed by individuals,9/22/23,Deposit,94613622SY192712G,04 PAYPAL GENERAL UNRESTR,Support Ukraine - Support Ukraine,Contributed income:Donations directed by individuals,PayPal Bank 3,$51.99 ,"$1,011,580.27 "
PayPal Fees,9/22/23,Deposit,94613622SY192712G,04 PAYPAL GENERAL UNRESTR,PayPal fees,OFFICE/GENERAL ADMINISTRATIVE EXPENSES:PayPal Fees,PayPal Bank 3,$2.77 ,"$1,011,583.04 "
PayPal Bank 3,9/22/23,Deposit,4R202272UT023183C,04 PAYPAL GENERAL UNRESTR,"Subject: GeneralPage
Transaction ID: 4R202272UT023183C
https://www.paypal.com/activity/payment/4R202272UT023183C",PayPal Bank 3,--,$96.62 ,"$1,011,679.66 "
Donations directed by individuals,9/22/23,Deposit,4R202272UT023183C,04 PAYPAL GENERAL UNRESTR,Support Ukraine - Support Ukraine,Contributed income:Donations directed by individuals,PayPal Bank 3,$100.00 ,"$1,011,779.66 "
PayPal Fees,9/22/23,Deposit,4R202272UT023183C,04 PAYPAL GENERAL UNRESTR,PayPal fees,OFFICE/GENERAL ADMINISTRATIVE EXPENSES:PayPal Fees,PayPal Bank 3,$3.38 ,"$1,011,783.04 "
PayPal Bank 3,9/22/23,Deposit,7TY77350AB906844H,04 PAYPAL GENERAL UNRESTR,"Subject: GeneralPage
Transaction ID: 7TY77350AB906844H
https://www.paypal.com/activity/payment/7TY77350AB906844H",PayPal Bank 3,--,$29.53 ,"$1,011,812.57 "
Donations directed by individuals,9/22/23,Deposit,7TY77350AB906844H,04 PAYPAL GENERAL UNRESTR,Support Ukraine - Support Ukraine,Contributed income:Donations directed by individuals,PayPal Bank 3,$31.40 ,"$1,011,843.97 "
PayPal Fees,9/22/23,Deposit,7TY77350AB906844H,04 PAYPAL GENERAL UNRESTR,PayPal fees,OFFICE/GENERAL ADMINISTRATIVE EXPENSES:PayPal Fees,PayPal Bank 3,$1.87 ,"$1,011,845.84 "
PayPal Bank 3,9/22/23,Deposit,53E41718GV723764U,07 1000 DRONES RESTR,"Subject: GeneralPage
Note: Spende für FPV-Drone
Transaction ID: 53E41718GV723764U
https://www.paypal.com/activity/payment/53E41718GV723764U",PayPal Bank 3,--,$49.22 ,"$1,011,895.06 "
Donations directed by individuals,9/22/23,Deposit,53E41718GV723764U,07 1000 DRONES RESTR,Support Ukraine - Support Ukraine,Contributed income:Donations directed by individuals,PayPal Bank 3,$51.99 ,"$1,011,947.05 "
PayPal Fees,9/22/23,Deposit,53E41718GV723764U,07 1000 DRONES RESTR,PayPal fees,OFFICE/GENERAL ADMINISTRATIVE EXPENSES:PayPal Fees,PayPal Bank 3,$2.77 ,"$1,011,949.82 "
PayPal Bank 3,9/22/23,Deposit,66N44466GY225503S,04 PAYPAL GENERAL UNRESTR,"Subject: GeneralPage
Transaction ID: 66N44466GY225503S
https://www.paypal.com/activity/payment/66N44466GY225503S",PayPal Bank 3,--,$95.12 ,"$1,012,044.94 "
Donations directed by individuals,9/22/23,Deposit,66N44466GY225503S,04 PAYPAL GENERAL UNRESTR,Support Ukraine - Support Ukraine,Contributed income:Donations directed by individuals,PayPal Bank 3,$100.00 ,"$1,012,144.94 "
PayPal Fees,9/22/23,Deposit,66N44466GY225503S,04 PAYPAL GENERAL UNRESTR,PayPal fees,OFFICE/GENERAL ADMINISTRATIVE EXPENSES:PayPal Fees,PayPal Bank 3,$4.88 ,"$1,012,149.82 "
PayPal Bank 3,9/22/23,Deposit,80876349UY840945G,04 PAYPAL GENERAL UNRESTR,"Subject: GeneralPage
Transaction ID: 80876349UY840945G
https://www.paypal.com/activity/payment/80876349UY840945G",PayPal Bank 3,--,$20.67 ,"$1,012,170.49 "
Donations directed by individuals,9/22/23,Deposit,80876349UY840945G,04 PAYPAL GENERAL UNRESTR,Support Ukraine - Support Ukraine,Contributed income:Donations directed by individuals,PayPal Bank 3,$22.13 ,"$1,012,192.62 "
PayPal Fees,9/22/23,Deposit,80876349UY840945G,04 PAYPAL GENERAL UNRESTR,PayPal fees,OFFICE/GENERAL ADMINISTRATIVE EXPENSES:PayPal Fees,PayPal Bank 3,$1.46 ,"$1,012,194.08 "
PayPal Bank 3,9/22/23,Deposit,7UG234104N448590P,04 PAYPAL GENERAL UNRESTR,"Subject: Support Ukraine
Transaction ID: 7UG234104N448590P
https://www.paypal.com/activity/payment/7UG234104N448590P",PayPal Bank 3,--,$10.82 ,"$1,012,204.90 "
Donations directed by individuals,9/22/23,Deposit,7UG234104N448590P,04 PAYPAL GENERAL UNRESTR,Money in to PayPal,Contributed income:Donations directed by individuals,PayPal Bank 3,$11.83 ,"$1,012,216.73 "
PayPal Fees,9/22/23,Deposit,7UG234104N448590P,04 PAYPAL GENERAL UNRESTR,PayPal fees,OFFICE/GENERAL ADMINISTRATIVE EXPENSES:PayPal Fees,PayPal Bank 3,$1.01 ,"$1,012,217.74 "
PayPal Bank 3,9/22/23,Deposit,4WD93372323467427,04 PAYPAL GENERAL UNRESTR,"Subject: GeneralPage
Transaction ID: 4WD93372323467427
https://www.paypal.com/activity/payment/4WD93372323467427",PayPal Bank 3,--,$9.84 ,"$1,012,227.58 "
Donations directed by individuals,9/22/23,Deposit,4WD93372323467427,04 PAYPAL GENERAL UNRESTR,Support Ukraine - Support Ukraine,Contributed income:Donations directed by individuals,PayPal Bank 3,$10.80 ,"$1,012,238.38 "
PayPal Fees,9/22/23,Deposit,4WD93372323467427,04 PAYPAL GENERAL UNRESTR,PayPal fees,OFFICE/GENERAL ADMINISTRATIVE EXPENSES:PayPal Fees,PayPal Bank 3,$0.96 ,"$1,012,239.34 "
PayPal Bank 3,9/22/23,Deposit,23670184G2819700Y,04 PAYPAL GENERAL UNRESTR,"Subject: GeneralPage
Transaction ID: 23670184G2819700Y
https://www.paypal.com/activity/payment/23670184G2819700Y",PayPal Bank 3,--,$50.00 ,"$1,012,289.34 "
Donations directed by individuals,9/22/23,Deposit,23670184G2819700Y,04 PAYPAL GENERAL UNRESTR,Support Ukraine - Support Ukraine,Contributed income:Donations directed by individuals,PayPal Bank 3,$51.99 ,"$1,012,341.33 "
PayPal Fees,9/22/23,Deposit,23670184G2819700Y,04 PAYPAL GENERAL UNRESTR,PayPal fees,OFFICE/GENERAL ADMINISTRATIVE EXPENSES:PayPal Fees,PayPal Bank 3,$1.99 ,"$1,012,343.32 "
PayPal Bank 3,9/22/23,Deposit,61X72037XP3307507,08 VICTORY DRONES RESTR,"Subject: VICTORY DRONES
Transaction ID: 61X72037XP3307507
https://www.paypal.com/activity/payment/61X72037XP3307507",PayPal Bank 3,--,$2.94 ,"$1,012,346.26 "
Donations directed by individuals,9/22/23,Deposit,61X72037XP3307507,08 VICTORY DRONES RESTR,Money in to PayPal,Contributed income:Donations directed by individuals,PayPal Bank 3,$3.59 ,"$1,012,349.85 "
PayPal Fees,9/22/23,Deposit,61X72037XP3307507,08 VICTORY DRONES RESTR,PayPal fees,OFFICE/GENERAL ADMINISTRATIVE EXPENSES:PayPal Fees,PayPal Bank 3,$0.65 ,"$1,012,350.50 "
PayPal Bank 3,9/22/23,Deposit,496874789A098354V,04 PAYPAL GENERAL UNRESTR,"Subject: GeneralPage
Transaction ID: 496874789A098354V
https://www.paypal.com/activity/payment/496874789A098354V",PayPal Bank 3,--,$49.22 ,"$1,012,399.72 "
Donations directed by individuals,9/22/23,Deposit,496874789A098354V,04 PAYPAL GENERAL UNRESTR,Support Ukraine - Support Ukraine,Contributed income:Donations directed by individuals,PayPal Bank 3,$51.99 ,"$1,012,451.71 "
PayPal Fees,9/22/23,Deposit,496874789A098354V,04 PAYPAL GENERAL UNRESTR,PayPal fees,OFFICE/GENERAL ADMINISTRATIVE EXPENSES:PayPal Fees,PayPal Bank 3,$2.77 ,"$1,012,454.48 "
PayPal Bank 3,9/22/23,Deposit,5JN97613TA549501S,04 PAYPAL GENERAL UNRESTR,"Subject: GeneralPage
Transaction ID: 5JN97613TA549501S
https://www.paypal.com/activity/payment/5JN97613TA549501S",PayPal Bank 3,--,$9.22 ,"$1,012,463.70 "
Donations directed by individuals,9/22/23,Deposit,5JN97613TA549501S,04 PAYPAL GENERAL UNRESTR,Support Ukraine - Support Ukraine,Contributed income:Donations directed by individuals,PayPal Bank 3,$10.00 ,"$1,012,473.70 "
PayPal Fees,9/22/23,Deposit,5JN97613TA549501S,04 PAYPAL GENERAL UNRESTR,PayPal fees,OFFICE/GENERAL ADMINISTRATIVE EXPENSES:PayPal Fees,PayPal Bank 3,$0.78 ,"$1,012,474.48 "
PayPal Bank 3,9/22/23,Deposit,9N53505568674084L,07 1000 DRONES RESTR,"Subject: GeneralPage
Note: На люті пташки
Transaction ID: 9N53505568674084L
https://www.paypal.com/activity/payment/9N53505568674084L",PayPal Bank 3,--,$48.06 ,"$1,012,522.54 "
Donations directed by individuals,9/22/23,Deposit,9N53505568674084L,07 1000 DRONES RESTR,Support Ukraine - Support Ukraine,Contributed income:Donations directed by individuals,PayPal Bank 3,$50.00 ,"$1,012,572.54 "
PayPal Fees,9/22/23,Deposit,9N53505568674084L,07 1000 DRONES RESTR,PayPal fees,OFFICE/GENERAL ADMINISTRATIVE EXPENSES:PayPal Fees,PayPal Bank 3,$1.94 ,"$1,012,574.48 "
PayPal Bank 3,9/22/23,Deposit,67H76598CF579340P,04 PAYPAL GENERAL UNRESTR,"Subject: GeneralPage
Transaction ID: 67H76598CF579340P
https://www.paypal.com/activity/payment/67H76598CF579340P",PayPal Bank 3,--,$48.06 ,"$1,012,622.54 "
Donations directed by individuals,9/22/23,Deposit,67H76598CF579340P,04 PAYPAL GENERAL UNRESTR,Support Ukraine - Support Ukraine,Contributed income:Donations directed by individuals,PayPal Bank 3,$50.00 ,"$1,012,672.54 "
PayPal Fees,9/22/23,Deposit,67H76598CF579340P,04 PAYPAL GENERAL UNRESTR,PayPal fees,OFFICE/GENERAL ADMINISTRATIVE EXPENSES:PayPal Fees,PayPal Bank 3,$1.94 ,"$1,012,674.48 "
PayPal Bank 3,9/22/23,Deposit,4JA304881D342170Y,07 1000 DRONES RESTR,"Subject: 1000DRONES
Transaction ID: 4JA304881D342170Y
https://www.paypal.com/activity/payment/4JA304881D342170Y",PayPal Bank 3,--,$98.45 ,"$1,012,772.93 "
Donations directed by individuals,9/22/23,Deposit,4JA304881D342170Y,07 1000 DRONES RESTR,1000 DRONES FOR UKRAINE - 1000 DRONES FOR UKRAINE,Contributed income:Donations directed by individuals,PayPal Bank 3,$103.48 ,"$1,012,876.41 "
PayPal Fees,9/22/23,Deposit,4JA304881D342170Y,07 1000 DRONES RESTR,PayPal fees,OFFICE/GENERAL ADMINISTRATIVE EXPENSES:PayPal Fees,PayPal Bank 3,$5.03 ,"$1,012,881.44 "
PayPal Bank 3,9/22/23,Deposit,5DJ85528JP825880T,04 PAYPAL GENERAL UNRESTR,"Subject: GeneralPage
Transaction ID: 5DJ85528JP825880T
https://www.paypal.com/activity/payment/5DJ85528JP825880T",PayPal Bank 3,--,$98.45 ,"$1,012,979.89 "
Donations directed by individuals,9/22/23,Deposit,5DJ85528JP825880T,04 PAYPAL GENERAL UNRESTR,Support Ukraine - Support Ukraine,Contributed income:Donations directed by individuals,PayPal Bank 3,$103.48 ,"$1,013,083.37 "
PayPal Fees,9/22/23,Deposit,5DJ85528JP825880T,04 PAYPAL GENERAL UNRESTR,PayPal fees,OFFICE/GENERAL ADMINISTRATIVE EXPENSES:PayPal Fees,PayPal Bank 3,$5.03 ,"$1,013,088.40 "
PayPal Bank 3,9/22/23,Deposit,8HL11662SR0867322,04 PAYPAL GENERAL UNRESTR,"Subject: Support Ukraine
Transaction ID: 8HL11662SR0867322
https://www.paypal.com/activity/payment/8HL11662SR0867322",PayPal Bank 3,--,$47.31 ,"$1,013,135.71 "
Donations directed by individuals,9/22/23,Deposit,8HL11662SR0867322,04 PAYPAL GENERAL UNRESTR,Money in to PayPal,Contributed income:Donations directed by individuals,PayPal Bank 3,$50.00 ,"$1,013,185.71 "
PayPal Fees,9/22/23,Deposit,8HL11662SR0867322,04 PAYPAL GENERAL UNRESTR,PayPal fees,OFFICE/GENERAL ADMINISTRATIVE EXPENSES:PayPal Fees,PayPal Bank 3,$2.69 ,"$1,013,188.40 "
PayPal Bank 3,9/22/23,Deposit,3UH11990LU863560R,04 PAYPAL GENERAL UNRESTR,"Subject: Support Ukraine
Transaction ID: 3UH11990LU863560R
https://www.paypal.com/activity/payment/3UH11990LU863560R",PayPal Bank 3,--,$47.31 ,"$1,013,235.71 "
Donations directed by individuals,9/22/23,Deposit,3UH11990LU863560R,04 PAYPAL GENERAL UNRESTR,Money in to PayPal,Contributed income:Donations directed by individuals,PayPal Bank 3,$50.00 ,"$1,013,285.71 "
PayPal Fees,9/22/23,Deposit,3UH11990LU863560R,04 PAYPAL GENERAL UNRESTR,PayPal fees,OFFICE/GENERAL ADMINISTRATIVE EXPENSES:PayPal Fees,PayPal Bank 3,$2.69 ,"$1,013,288.40 "
PayPal Bank 3,9/22/23,Deposit,10P63206A8040883B,04 PAYPAL GENERAL UNRESTR,"Subject: GeneralPage
Transaction ID: 10P63206A8040883B
https://www.paypal.com/activity/payment/10P63206A8040883B",PayPal Bank 3,--,$14.76 ,"$1,013,303.16 "
Donations directed by individuals,9/22/23,Deposit,10P63206A8040883B,04 PAYPAL GENERAL UNRESTR,Support Ukraine - Support Ukraine,Contributed income:Donations directed by individuals,PayPal Bank 3,$15.95 ,"$1,013,319.11 "
PayPal Fees,9/22/23,Deposit,10P63206A8040883B,04 PAYPAL GENERAL UNRESTR,PayPal fees,OFFICE/GENERAL ADMINISTRATIVE EXPENSES:PayPal Fees,PayPal Bank 3,$1.19 ,"$1,013,320.30 "
PayPal Bank 3,9/22/23,Deposit,2JB49266W5158790U,04 PAYPAL GENERAL UNRESTR,"Subject: GeneralPage
Transaction ID: 2JB49266W5158790U
https://www.paypal.com/activity/payment/2JB49266W5158790U",PayPal Bank 3,--,$96.62 ,"$1,013,416.92 "
Donations directed by individuals,9/22/23,Deposit,2JB49266W5158790U,04 PAYPAL GENERAL UNRESTR,Support Ukraine - Support Ukraine,Contributed income:Donations directed by individuals,PayPal Bank 3,$100.00 ,"$1,013,516.92 "
PayPal Fees,9/22/23,Deposit,2JB49266W5158790U,04 PAYPAL GENERAL UNRESTR,PayPal fees,OFFICE/GENERAL ADMINISTRATIVE EXPENSES:PayPal Fees,PayPal Bank 3,$3.38 ,"$1,013,520.30 "
PayPal Bank 3,9/22/23,Deposit,4JS579261V5573904,07 1000 DRONES RESTR,"Subject: 1000DRONES
Transaction ID: 4JS579261V5573904
https://www.paypal.com/activity/payment/4JS579261V5573904",PayPal Bank 3,--,$29.53 ,"$1,013,549.83 "
Donations directed by individuals,9/22/23,Deposit,4JS579261V5573904,07 1000 DRONES RESTR,1000 DRONES FOR UKRAINE - 1000 DRONES FOR UKRAINE,Contributed income:Donations directed by individuals,PayPal Bank 3,$31.40 ,"$1,013,581.23 "
PayPal Fees,9/22/23,Deposit,4JS579261V5573904,07 1000 DRONES RESTR,PayPal fees,OFFICE/GENERAL ADMINISTRATIVE EXPENSES:PayPal Fees,PayPal Bank 3,$1.87 ,"$1,013,583.10 "
PayPal Bank 3,9/22/23,Deposit,8SM41909B8153125G,04 PAYPAL GENERAL UNRESTR,"Subject: GeneralPage
Transaction ID: 8SM41909B8153125G
https://www.paypal.com/activity/payment/8SM41909B8153125G",PayPal Bank 3,--,$19.68 ,"$1,013,602.78 "
Donations directed by individuals,9/22/23,Deposit,8SM41909B8153125G,04 PAYPAL GENERAL UNRESTR,Support Ukraine - Support Ukraine,Contributed income:Donations directed by individuals,PayPal Bank 3,$21.10 ,"$1,013,623.88 "
PayPal Fees,9/22/23,Deposit,8SM41909B8153125G,04 PAYPAL GENERAL UNRESTR,PayPal fees,OFFICE/GENERAL ADMINISTRATIVE EXPENSES:PayPal Fees,PayPal Bank 3,$1.42 ,"$1,013,625.30 "
PayPal Bank 3,9/22/23,Deposit,78S8914314077252C,04 PAYPAL GENERAL UNRESTR,"Subject: GeneralPage
Transaction ID: 78S8914314077252C
https://www.paypal.com/activity/payment/78S8914314077252C",PayPal Bank 3,--,$49.22 ,"$1,013,674.52 "
Donations directed by individuals,9/22/23,Deposit,78S8914314077252C,04 PAYPAL GENERAL UNRESTR,Support Ukraine - Support Ukraine,Contributed income:Donations directed by individuals,PayPal Bank 3,$51.99 ,"$1,013,726.51 "
PayPal Fees,9/22/23,Deposit,78S8914314077252C,04 PAYPAL GENERAL UNRESTR,PayPal fees,OFFICE/GENERAL ADMINISTRATIVE EXPENSES:PayPal Fees,PayPal Bank 3,$2.77 ,"$1,013,729.28 "
PayPal Bank 3,9/22/23,Deposit,82B04636ND647513M,04 PAYPAL GENERAL UNRESTR,"Subject: GeneralPage
Transaction ID: 82B04636ND647513M
https://www.paypal.com/activity/payment/82B04636ND647513M",PayPal Bank 3,--,$276.61 ,"$1,014,005.89 "
Donations directed by individuals,9/22/23,Deposit,82B04636ND647513M,04 PAYPAL GENERAL UNRESTR,Support Ukraine - Support Ukraine,Contributed income:Donations directed by individuals,PayPal Bank 3,$289.82 ,"$1,014,295.71 "
PayPal Fees,9/22/23,Deposit,82B04636ND647513M,04 PAYPAL GENERAL UNRESTR,PayPal fees,OFFICE/GENERAL ADMINISTRATIVE EXPENSES:PayPal Fees,PayPal Bank 3,$13.21 ,"$1,014,308.92 "
PayPal Bank 3,9/22/23,Deposit,9R089859FU788214C,04 PAYPAL GENERAL UNRESTR,"Subject: GeneralPage
Transaction ID: 9R089859FU788214C
https://www.paypal.com/activity/payment/9R089859FU788214C",PayPal Bank 3,--,$9.84 ,"$1,014,318.76 "
Donations directed by individuals,9/22/23,Deposit,9R089859FU788214C,04 PAYPAL GENERAL UNRESTR,Support Ukraine - Support Ukraine,Contributed income:Donations directed by individuals,PayPal Bank 3,$10.80 ,"$1,014,329.56 "
PayPal Fees,9/22/23,Deposit,9R089859FU788214C,04 PAYPAL GENERAL UNRESTR,PayPal fees,OFFICE/GENERAL ADMINISTRATIVE EXPENSES:PayPal Fees,PayPal Bank 3,$0.96 ,"$1,014,330.52 "
PayPal Bank 3,9/22/23,Deposit,2B971202F4835130S,07 1000 DRONES RESTR,"Subject: 1000DRONES
Transaction ID: 2B971202F4835130S
https://www.paypal.com/activity/payment/2B971202F4835130S",PayPal Bank 3,--,$200.00 ,"$1,014,530.52 "
Donations directed by individuals,9/22/23,Deposit,2B971202F4835130S,07 1000 DRONES RESTR,1000 DRONES FOR UKRAINE - 1000 DRONES FOR UKRAINE,Contributed income:Donations directed by individuals,PayPal Bank 3,$206.46 ,"$1,014,736.98 "
PayPal Fees,9/22/23,Deposit,2B971202F4835130S,07 1000 DRONES RESTR,PayPal fees,OFFICE/GENERAL ADMINISTRATIVE EXPENSES:PayPal Fees,PayPal Bank 3,$6.46 ,"$1,014,743.44 "
PayPal Bank 3,9/22/23,Deposit,8D816449WB8347731,04 PAYPAL GENERAL UNRESTR,"Subject: GeneralPage
Transaction ID: 8D816449WB8347731
https://www.paypal.com/activity/payment/8D816449WB8347731",PayPal Bank 3,--,$13.85 ,"$1,014,757.29 "
Donations directed by individuals,9/22/23,Deposit,8D816449WB8347731,04 PAYPAL GENERAL UNRESTR,Support Ukraine - Support Ukraine,Contributed income:Donations directed by individuals,PayPal Bank 3,$15.00 ,"$1,014,772.29 "
PayPal Fees,9/22/23,Deposit,8D816449WB8347731,04 PAYPAL GENERAL UNRESTR,PayPal fees,OFFICE/GENERAL ADMINISTRATIVE EXPENSES:PayPal Fees,PayPal Bank 3,$1.15 ,"$1,014,773.44 "
PayPal Bank 3,9/22/23,Deposit,0XJ17311J57320303,07 1000 DRONES RESTR,"Subject: 1000DRONES
Transaction ID: 0XJ17311J57320303
https://www.paypal.com/activity/payment/0XJ17311J57320303",PayPal Bank 3,--,$100.00 ,"$1,014,873.44 "
Donations directed by individuals,9/22/23,Deposit,0XJ17311J57320303,07 1000 DRONES RESTR,1000 DRONES FOR UKRAINE - 1000 DRONES FOR UKRAINE,Contributed income:Donations directed by individuals,PayPal Bank 3,$103.48 ,"$1,014,976.92 "
PayPal Fees,9/22/23,Deposit,0XJ17311J57320303,07 1000 DRONES RESTR,PayPal fees,OFFICE/GENERAL ADMINISTRATIVE EXPENSES:PayPal Fees,PayPal Bank 3,$3.48 ,"$1,014,980.40 "
PayPal Bank 3,9/22/23,Deposit,53V20915JA1803934,04 PAYPAL GENERAL UNRESTR,"Subject: GeneralPage
Transaction ID: 53V20915JA1803934
https://www.paypal.com/activity/payment/53V20915JA1803934",PayPal Bank 3,--,$9.84 ,"$1,014,990.24 "
Donations directed by individuals,9/22/23,Deposit,53V20915JA1803934,04 PAYPAL GENERAL UNRESTR,Support Ukraine - Support Ukraine,Contributed income:Donations directed by individuals,PayPal Bank 3,$10.80 ,"$1,015,001.04 "
PayPal Fees,9/22/23,Deposit,53V20915JA1803934,04 PAYPAL GENERAL UNRESTR,PayPal fees,OFFICE/GENERAL ADMINISTRATIVE EXPENSES:PayPal Fees,PayPal Bank 3,$0.96 ,"$1,015,002.00 "
PayPal Bank 3,9/22/23,Deposit,77U01518B5083202L,04 PAYPAL GENERAL UNRESTR,"Subject: GeneralPage
Transaction ID: 77U01518B5083202L
https://www.paypal.com/activity/payment/77U01518B5083202L",PayPal Bank 3,--,$50.00 ,"$1,015,052.00 "
Donations directed by individuals,9/22/23,Deposit,77U01518B5083202L,04 PAYPAL GENERAL UNRESTR,Support Ukraine - Support Ukraine,Contributed income:Donations directed by individuals,PayPal Bank 3,$51.99 ,"$1,015,103.99 "
PayPal Fees,9/22/23,Deposit,77U01518B5083202L,04 PAYPAL GENERAL UNRESTR,PayPal fees,OFFICE/GENERAL ADMINISTRATIVE EXPENSES:PayPal Fees,PayPal Bank 3,$1.99 ,"$1,015,105.98 "
PayPal Bank 3,9/22/23,Deposit,8DW22426UN678923Y,04 PAYPAL GENERAL UNRESTR,"Subject: GeneralPage
Transaction ID: 8DW22426UN678923Y
https://www.paypal.com/activity/payment/8DW22426UN678923Y",PayPal Bank 3,--,$295.36 ,"$1,015,401.34 "
Donations directed by individuals,9/22/23,Deposit,8DW22426UN678923Y,04 PAYPAL GENERAL UNRESTR,Support Ukraine - Support Ukraine,Contributed income:Donations directed by individuals,PayPal Bank 3,$309.43 ,"$1,015,710.77 "
PayPal Fees,9/22/23,Deposit,8DW22426UN678923Y,04 PAYPAL GENERAL UNRESTR,PayPal fees,OFFICE/GENERAL ADMINISTRATIVE EXPENSES:PayPal Fees,PayPal Bank 3,$14.07 ,"$1,015,724.84 "
PayPal Bank 3,9/22/23,Deposit,58H02392HU906463P,07 1000 DRONES RESTR,"Subject: GeneralPage
Note: Drons����
Transaction ID: 58H02392HU906463P
https://www.paypal.com/activity/payment/58H02392HU906463P",PayPal Bank 3,--,$48.06 ,"$1,015,772.90 "
Donations directed by individuals,9/22/23,Deposit,58H02392HU906463P,07 1000 DRONES RESTR,Support Ukraine - Support Ukraine,Contributed income:Donations directed by individuals,PayPal Bank 3,$50.00 ,"$1,015,822.90 "
PayPal Fees,9/22/23,Deposit,58H02392HU906463P,07 1000 DRONES RESTR,PayPal fees,OFFICE/GENERAL ADMINISTRATIVE EXPENSES:PayPal Fees,PayPal Bank 3,$1.94 ,"$1,015,824.84 "
PayPal Bank 3,9/22/23,Deposit,2AK77463G6229984D,04 PAYPAL GENERAL UNRESTR,"Subject: GeneralPage
Transaction ID: 2AK77463G6229984D
https://www.paypal.com/activity/payment/2AK77463G6229984D",PayPal Bank 3,--,$30.00 ,"$1,015,854.84 "
Donations directed by individuals,9/22/23,Deposit,2AK77463G6229984D,04 PAYPAL GENERAL UNRESTR,Support Ukraine - Support Ukraine,Contributed income:Donations directed by individuals,PayPal Bank 3,$31.40 ,"$1,015,886.24 "
PayPal Fees,9/22/23,Deposit,2AK77463G6229984D,04 PAYPAL GENERAL UNRESTR,PayPal fees,OFFICE/GENERAL ADMINISTRATIVE EXPENSES:PayPal Fees,PayPal Bank 3,$1.40 ,"$1,015,887.64 "
PayPal Bank 3,9/22/23,Deposit,78K308185U947333J,04 PAYPAL GENERAL UNRESTR,"Subject: GeneralPage
Transaction ID: 78K308185U947333J
https://www.paypal.com/activity/payment/78K308185U947333J",PayPal Bank 3,--,$20.00 ,"$1,015,907.64 "
Donations directed by individuals,9/22/23,Deposit,78K308185U947333J,04 PAYPAL GENERAL UNRESTR,Support Ukraine - Support Ukraine,Contributed income:Donations directed by individuals,PayPal Bank 3,$21.10 ,"$1,015,928.74 "
PayPal Fees,9/22/23,Deposit,78K308185U947333J,04 PAYPAL GENERAL UNRESTR,PayPal fees,OFFICE/GENERAL ADMINISTRATIVE EXPENSES:PayPal Fees,PayPal Bank 3,$1.10 ,"$1,015,929.84 "
PayPal Bank 3,9/22/23,Deposit,2SW46133K98458928,04 PAYPAL GENERAL UNRESTR,"Subject: GeneralPage
Transaction ID: 2SW46133K98458928
https://www.paypal.com/activity/payment/2SW46133K98458928",PayPal Bank 3,--,$4.91 ,"$1,015,934.75 "
Donations directed by individuals,9/22/23,Deposit,2SW46133K98458928,04 PAYPAL GENERAL UNRESTR,Support Ukraine - Support Ukraine,Contributed income:Donations directed by individuals,PayPal Bank 3,$5.65 ,"$1,015,940.40 "
PayPal Fees,9/22/23,Deposit,2SW46133K98458928,04 PAYPAL GENERAL UNRESTR,PayPal fees,OFFICE/GENERAL ADMINISTRATIVE EXPENSES:PayPal Fees,PayPal Bank 3,$0.74 ,"$1,015,941.14 "
PayPal Bank 3,9/22/23,Deposit,4AX40225XH000561L,04 PAYPAL GENERAL UNRESTR,"Subject: GeneralPage
Transaction ID: 4AX40225XH000561L
https://www.paypal.com/activity/payment/4AX40225XH000561L",PayPal Bank 3,--,$9.07 ,"$1,015,950.21 "
Donations directed by individuals,9/22/23,Deposit,4AX40225XH000561L,04 PAYPAL GENERAL UNRESTR,Support Ukraine - Support Ukraine,Contributed income:Donations directed by individuals,PayPal Bank 3,$10.00 ,"$1,015,960.21 "
PayPal Fees,9/22/23,Deposit,4AX40225XH000561L,04 PAYPAL GENERAL UNRESTR,PayPal fees,OFFICE/GENERAL ADMINISTRATIVE EXPENSES:PayPal Fees,PayPal Bank 3,$0.93 ,"$1,015,961.14 "
PayPal Bank 3,9/22/23,Deposit,6FD90403RL741741U,04 PAYPAL GENERAL UNRESTR,"Subject: GeneralPage
Transaction ID: 6FD90403RL741741U
https://www.paypal.com/activity/payment/6FD90403RL741741U",PayPal Bank 3,--,$100.00 ,"$1,016,061.14 "
Donations directed by individuals,9/22/23,Deposit,6FD90403RL741741U,04 PAYPAL GENERAL UNRESTR,Support Ukraine - Support Ukraine,Contributed income:Donations directed by individuals,PayPal Bank 3,$103.48 ,"$1,016,164.62 "
PayPal Fees,9/22/23,Deposit,6FD90403RL741741U,04 PAYPAL GENERAL UNRESTR,PayPal fees,OFFICE/GENERAL ADMINISTRATIVE EXPENSES:PayPal Fees,PayPal Bank 3,$3.48 ,"$1,016,168.10 "
PayPal Bank 3,9/22/23,Deposit,7AK5878893329071K,04 PAYPAL GENERAL UNRESTR,"Subject: GeneralPage
Transaction ID: 7AK5878893329071K
https://www.paypal.com/activity/payment/7AK5878893329071K",PayPal Bank 3,--,$9.84 ,"$1,016,177.94 "
Donations directed by individuals,9/22/23,Deposit,7AK5878893329071K,04 PAYPAL GENERAL UNRESTR,Support Ukraine - Support Ukraine,Contributed income:Donations directed by individuals,PayPal Bank 3,$10.80 ,"$1,016,188.74 "
PayPal Fees,9/22/23,Deposit,7AK5878893329071K,04 PAYPAL GENERAL UNRESTR,PayPal fees,OFFICE/GENERAL ADMINISTRATIVE EXPENSES:PayPal Fees,PayPal Bank 3,$0.96 ,"$1,016,189.70 "
PayPal Bank 3,9/22/23,Deposit,69E305135D2119318,04 PAYPAL GENERAL UNRESTR,"Subject: GeneralPage
Transaction ID: 69E305135D2119318
https://www.paypal.com/activity/payment/69E305135D2119318",PayPal Bank 3,--,$50.00 ,"$1,016,239.70 "
Donations directed by individuals,9/22/23,Deposit,69E305135D2119318,04 PAYPAL GENERAL UNRESTR,Support Ukraine - Support Ukraine,Contributed income:Donations directed by individuals,PayPal Bank 3,$51.99 ,"$1,016,291.69 "
PayPal Fees,9/22/23,Deposit,69E305135D2119318,04 PAYPAL GENERAL UNRESTR,PayPal fees,OFFICE/GENERAL ADMINISTRATIVE EXPENSES:PayPal Fees,PayPal Bank 3,$1.99 ,"$1,016,293.68 "
PayPal Bank 3,9/22/23,Deposit,9SX29258FK023532G,04 PAYPAL GENERAL UNRESTR,"Subject: GeneralPage
Transaction ID: 9SX29258FK023532G
https://www.paypal.com/activity/payment/9SX29258FK023532G",PayPal Bank 3,--,$47.31 ,"$1,016,340.99 "
Donations directed by individuals,9/22/23,Deposit,9SX29258FK023532G,04 PAYPAL GENERAL UNRESTR,Support Ukraine - Support Ukraine,Contributed income:Donations directed by individuals,PayPal Bank 3,$50.00 ,"$1,016,390.99 "
PayPal Fees,9/22/23,Deposit,9SX29258FK023532G,04 PAYPAL GENERAL UNRESTR,PayPal fees,OFFICE/GENERAL ADMINISTRATIVE EXPENSES:PayPal Fees,PayPal Bank 3,$2.69 ,"$1,016,393.68 "
PayPal Bank 3,9/22/23,Deposit,40W00283DK709843P,04 PAYPAL GENERAL UNRESTR,"Subject: GeneralPage
Transaction ID: 40W00283DK709843P
https://www.paypal.com/activity/payment/40W00283DK709843P",PayPal Bank 3,--,$9.84 ,"$1,016,403.52 "
Donations directed by individuals,9/22/23,Deposit,40W00283DK709843P,04 PAYPAL GENERAL UNRESTR,Support Ukraine - Support Ukraine,Contributed income:Donations directed by individuals,PayPal Bank 3,$10.80 ,"$1,016,414.32 "
PayPal Fees,9/22/23,Deposit,40W00283DK709843P,04 PAYPAL GENERAL UNRESTR,PayPal fees,OFFICE/GENERAL ADMINISTRATIVE EXPENSES:PayPal Fees,PayPal Bank 3,$0.96 ,"$1,016,415.28 "
PayPal Bank 3,9/22/23,Deposit,1H2489953B243751L,04 PAYPAL GENERAL UNRESTR,"Subject: GeneralPage
Transaction ID: 1H2489953B243751L
https://www.paypal.com/activity/payment/1H2489953B243751L",PayPal Bank 3,--,$47.31 ,"$1,016,462.59 "
Donations directed by individuals,9/22/23,Deposit,1H2489953B243751L,04 PAYPAL GENERAL UNRESTR,Support Ukraine - Support Ukraine,Contributed income:Donations directed by individuals,PayPal Bank 3,$50.00 ,"$1,016,512.59 "
PayPal Fees,9/22/23,Deposit,1H2489953B243751L,04 PAYPAL GENERAL UNRESTR,PayPal fees,OFFICE/GENERAL ADMINISTRATIVE EXPENSES:PayPal Fees,PayPal Bank 3,$2.69 ,"$1,016,515.28 "
PayPal Bank 3,9/22/23,Deposit,7H23632278885211C,04 PAYPAL GENERAL UNRESTR,"Subject: Support Ukraine
Transaction ID: 7H23632278885211C
https://www.paypal.com/activity/payment/7H23632278885211C",PayPal Bank 3,--,$98.45 ,"$1,016,613.73 "
Donations directed by individuals,9/22/23,Deposit,7H23632278885211C,04 PAYPAL GENERAL UNRESTR,Money in to PayPal,Contributed income:Donations directed by individuals,PayPal Bank 3,$103.48 ,"$1,016,717.21 "
PayPal Fees,9/22/23,Deposit,7H23632278885211C,04 PAYPAL GENERAL UNRESTR,PayPal fees,OFFICE/GENERAL ADMINISTRATIVE EXPENSES:PayPal Fees,PayPal Bank 3,$5.03 ,"$1,016,722.24 "
PayPal Bank 3,9/22/23,Deposit,3PH558264D524425J,04 PAYPAL GENERAL UNRESTR,"Subject: GeneralPage
Transaction ID: 3PH558264D524425J
https://www.paypal.com/activity/payment/3PH558264D524425J",PayPal Bank 3,--,"$3,000.00 ","$1,019,722.24 "
Donations directed by individuals,9/22/23,Deposit,3PH558264D524425J,04 PAYPAL GENERAL UNRESTR,Support Ukraine - Support Ukraine,Contributed income:Donations directed by individuals,PayPal Bank 3,"$3,089.78 ","$1,022,812.02 "
PayPal Fees,9/22/23,Deposit,3PH558264D524425J,04 PAYPAL GENERAL UNRESTR,PayPal fees,OFFICE/GENERAL ADMINISTRATIVE EXPENSES:PayPal Fees,PayPal Bank 3,$89.78 ,"$1,022,901.80 "
PayPal Bank 3,9/22/23,Deposit,5PU22237EU940383M,07 1000 DRONES RESTR,"Subject: GeneralPage
Note: I would love it if you used this money to get some FPV drones to blow up some invader scum.   Слава Україні!
Transaction ID: 5PU22237EU940383M
https://www.paypal.com/activity/payment/5PU22237EU940383M",PayPal Bank 3,--,$96.62 ,"$1,022,998.42 "
Donations directed by individuals,9/22/23,Deposit,5PU22237EU940383M,07 1000 DRONES RESTR,Support Ukraine - Support Ukraine,Contributed income:Donations directed by individuals,PayPal Bank 3,$100.00 ,"$1,023,098.42 "
PayPal Fees,9/22/23,Deposit,5PU22237EU940383M,07 1000 DRONES RESTR,PayPal fees,OFFICE/GENERAL ADMINISTRATIVE EXPENSES:PayPal Fees,PayPal Bank 3,$3.38 ,"$1,023,101.80 "
PayPal Bank 3,9/22/23,Deposit,1LU169853B0954527,04 PAYPAL GENERAL UNRESTR,"Subject: GeneralPage
Transaction ID: 1LU169853B0954527
https://www.paypal.com/activity/payment/1LU169853B0954527",PayPal Bank 3,--,$100.00 ,"$1,023,201.80 "
Donations directed by individuals,9/22/23,Deposit,1LU169853B0954527,04 PAYPAL GENERAL UNRESTR,Support Ukraine - Support Ukraine,Contributed income:Donations directed by individuals,PayPal Bank 3,$103.48 ,"$1,023,305.28 "
PayPal Fees,9/22/23,Deposit,1LU169853B0954527,04 PAYPAL GENERAL UNRESTR,PayPal fees,OFFICE/GENERAL ADMINISTRATIVE EXPENSES:PayPal Fees,PayPal Bank 3,$3.48 ,"$1,023,308.76 "
PayPal Bank 3,9/22/23,Deposit,8G955465MY182713W,08 VICTORY DRONES RESTR,"Subject: VICTORY DRONES
Transaction ID: 8G955465MY182713W
https://www.paypal.com/activity/payment/8G955465MY182713W",PayPal Bank 3,--,$100.00 ,"$1,023,408.76 "
Donations directed by individuals,9/22/23,Deposit,8G955465MY182713W,08 VICTORY DRONES RESTR,Money in to PayPal,Contributed income:Donations directed by individuals,PayPal Bank 3,$103.48 ,"$1,023,512.24 "
PayPal Fees,9/22/23,Deposit,8G955465MY182713W,08 VICTORY DRONES RESTR,PayPal fees,OFFICE/GENERAL ADMINISTRATIVE EXPENSES:PayPal Fees,PayPal Bank 3,$3.48 ,"$1,023,515.72 "
PayPal Bank 3,9/22/23,Deposit,878176043N743231T,04 PAYPAL GENERAL UNRESTR,"Subject: GeneralPage
Note: From Irish-Ukrainian community.   We wish you a strong wings� and no wind.
Transaction ID: 878176043N743231T
https://www.paypal.com/activity/payment/878176043N743231T",PayPal Bank 3,--,$47.31 ,"$1,023,563.03 "
Donations directed by individuals,9/22/23,Deposit,878176043N743231T,04 PAYPAL GENERAL UNRESTR,Support Ukraine - Support Ukraine,Contributed income:Donations directed by individuals,PayPal Bank 3,$50.00 ,"$1,023,613.03 "
PayPal Fees,9/22/23,Deposit,878176043N743231T,04 PAYPAL GENERAL UNRESTR,PayPal fees,OFFICE/GENERAL ADMINISTRATIVE EXPENSES:PayPal Fees,PayPal Bank 3,$2.69 ,"$1,023,615.72 "
PayPal Bank 3,9/22/23,Deposit,4LJ48094CX539084E,04 PAYPAL GENERAL UNRESTR,"Subject: GeneralPage
Transaction ID: 4LJ48094CX539084E
https://www.paypal.com/activity/payment/4LJ48094CX539084E",PayPal Bank 3,--,$23.41 ,"$1,023,639.13 "
Donations directed by individuals,9/22/23,Deposit,4LJ48094CX539084E,04 PAYPAL GENERAL UNRESTR,Support Ukraine - Support Ukraine,Contributed income:Donations directed by individuals,PayPal Bank 3,$25.00 ,"$1,023,664.13 "
PayPal Fees,9/22/23,Deposit,4LJ48094CX539084E,04 PAYPAL GENERAL UNRESTR,PayPal fees,OFFICE/GENERAL ADMINISTRATIVE EXPENSES:PayPal Fees,PayPal Bank 3,$1.59 ,"$1,023,665.72 "
PayPal Bank 3,9/22/23,Deposit,3R591967RC218180B,04 PAYPAL GENERAL UNRESTR,"Subject: GeneralPage
Transaction ID: 3R591967RC218180B
https://www.paypal.com/activity/payment/3R591967RC218180B",PayPal Bank 3,--,$29.53 ,"$1,023,695.25 "
Donations directed by individuals,9/22/23,Deposit,3R591967RC218180B,04 PAYPAL GENERAL UNRESTR,Support Ukraine - Support Ukraine,Contributed income:Donations directed by individuals,PayPal Bank 3,$31.40 ,"$1,023,726.65 "
PayPal Fees,9/22/23,Deposit,3R591967RC218180B,04 PAYPAL GENERAL UNRESTR,PayPal fees,OFFICE/GENERAL ADMINISTRATIVE EXPENSES:PayPal Fees,PayPal Bank 3,$1.87 ,"$1,023,728.52 "
PayPal Bank 3,9/22/23,Deposit,37397940NS1206827,04 PAYPAL GENERAL UNRESTR,"Subject: GeneralPage
Transaction ID: 37397940NS1206827
https://www.paypal.com/activity/payment/37397940NS1206827",PayPal Bank 3,--,$24.61 ,"$1,023,753.13 "
Donations directed by individuals,9/22/23,Deposit,37397940NS1206827,04 PAYPAL GENERAL UNRESTR,Support Ukraine - Support Ukraine,Contributed income:Donations directed by individuals,PayPal Bank 3,$26.25 ,"$1,023,779.38 "
PayPal Fees,9/22/23,Deposit,37397940NS1206827,04 PAYPAL GENERAL UNRESTR,PayPal fees,OFFICE/GENERAL ADMINISTRATIVE EXPENSES:PayPal Fees,PayPal Bank 3,$1.64 ,"$1,023,781.02 "
PayPal Bank 3,9/22/23,Deposit,28Y96140YU216931V,04 PAYPAL GENERAL UNRESTR,"Subject: GeneralPage
Transaction ID: 28Y96140YU216931V
https://www.paypal.com/activity/payment/28Y96140YU216931V",PayPal Bank 3,--,$96.62 ,"$1,023,877.64 "
Donations directed by individuals,9/22/23,Deposit,28Y96140YU216931V,04 PAYPAL GENERAL UNRESTR,Support Ukraine - Support Ukraine,Contributed income:Donations directed by individuals,PayPal Bank 3,$100.00 ,"$1,023,977.64 "
PayPal Fees,9/22/23,Deposit,28Y96140YU216931V,04 PAYPAL GENERAL UNRESTR,PayPal fees,OFFICE/GENERAL ADMINISTRATIVE EXPENSES:PayPal Fees,PayPal Bank 3,$3.38 ,"$1,023,981.02 "
PayPal Bank 3,9/22/23,Deposit,21277431SL5587828,04 PAYPAL GENERAL UNRESTR,"Subject: GeneralPage
Transaction ID: 21277431SL5587828
https://www.paypal.com/activity/payment/21277431SL5587828",PayPal Bank 3,--,$95.12 ,"$1,024,076.14 "
Donations directed by individuals,9/22/23,Deposit,21277431SL5587828,04 PAYPAL GENERAL UNRESTR,Support Ukraine - Support Ukraine,Contributed income:Donations directed by individuals,PayPal Bank 3,$100.00 ,"$1,024,176.14 "
PayPal Fees,9/22/23,Deposit,21277431SL5587828,04 PAYPAL GENERAL UNRESTR,PayPal fees,OFFICE/GENERAL ADMINISTRATIVE EXPENSES:PayPal Fees,PayPal Bank 3,$4.88 ,"$1,024,181.02 "
PayPal Bank 3,9/22/23,Deposit,9FN19697RH501904R,04 PAYPAL GENERAL UNRESTR,"Subject: GeneralPage
Transaction ID: 9FN19697RH501904R
https://www.paypal.com/activity/payment/9FN19697RH501904R",PayPal Bank 3,--,$196.91 ,"$1,024,377.93 "
Donations directed by individuals,9/22/23,Deposit,9FN19697RH501904R,04 PAYPAL GENERAL UNRESTR,Support Ukraine - Support Ukraine,Contributed income:Donations directed by individuals,PayPal Bank 3,$206.46 ,"$1,024,584.39 "
PayPal Fees,9/22/23,Deposit,9FN19697RH501904R,04 PAYPAL GENERAL UNRESTR,PayPal fees,OFFICE/GENERAL ADMINISTRATIVE EXPENSES:PayPal Fees,PayPal Bank 3,$9.55 ,"$1,024,593.94 "
PayPal Bank 3,9/22/23,Deposit,0L62167711864244F,04 PAYPAL GENERAL UNRESTR,"Subject: GeneralPage
Transaction ID: 0L62167711864244F
https://www.paypal.com/activity/payment/0L62167711864244F",PayPal Bank 3,--,$50.00 ,"$1,024,643.94 "
Donations directed by individuals,9/22/23,Deposit,0L62167711864244F,04 PAYPAL GENERAL UNRESTR,Support Ukraine - Support Ukraine,Contributed income:Donations directed by individuals,PayPal Bank 3,$51.99 ,"$1,024,695.93 "
PayPal Fees,9/22/23,Deposit,0L62167711864244F,04 PAYPAL GENERAL UNRESTR,PayPal fees,OFFICE/GENERAL ADMINISTRATIVE EXPENSES:PayPal Fees,PayPal Bank 3,$1.99 ,"$1,024,697.92 "
PayPal Bank 3,9/22/23,Deposit,5J214848LY769590F,04 PAYPAL GENERAL UNRESTR,"Subject: GeneralPage
Transaction ID: 5J214848LY769590F
https://www.paypal.com/activity/payment/5J214848LY769590F",PayPal Bank 3,--,$5.00 ,"$1,024,702.92 "
Donations directed by individuals,9/22/23,Deposit,5J214848LY769590F,04 PAYPAL GENERAL UNRESTR,Support Ukraine - Support Ukraine,Contributed income:Donations directed by individuals,PayPal Bank 3,$5.65 ,"$1,024,708.57 "
PayPal Fees,9/22/23,Deposit,5J214848LY769590F,04 PAYPAL GENERAL UNRESTR,PayPal fees,OFFICE/GENERAL ADMINISTRATIVE EXPENSES:PayPal Fees,PayPal Bank 3,$0.65 ,"$1,024,709.22 "
PayPal Bank 3,9/22/23,Deposit,7M233862X7039973T,04 PAYPAL GENERAL UNRESTR,"Subject: GeneralPage
Transaction ID: 7M233862X7039973T
https://www.paypal.com/activity/payment/7M233862X7039973T",PayPal Bank 3,--,$49.22 ,"$1,024,758.44 "
Donations directed by individuals,9/22/23,Deposit,7M233862X7039973T,04 PAYPAL GENERAL UNRESTR,Support Ukraine - Support Ukraine,Contributed income:Donations directed by individuals,PayPal Bank 3,$51.99 ,"$1,024,810.43 "
PayPal Fees,9/22/23,Deposit,7M233862X7039973T,04 PAYPAL GENERAL UNRESTR,PayPal fees,OFFICE/GENERAL ADMINISTRATIVE EXPENSES:PayPal Fees,PayPal Bank 3,$2.77 ,"$1,024,813.20 "
PayPal Bank 3,9/22/23,Deposit,6H562266HN050331J,04 PAYPAL GENERAL UNRESTR,"Subject: Support Ukraine
Transaction ID: 6H562266HN050331J
https://www.paypal.com/activity/payment/6H562266HN050331J",PayPal Bank 3,--,$50.00 ,"$1,024,863.20 "
Donations directed by individuals,9/22/23,Deposit,6H562266HN050331J,04 PAYPAL GENERAL UNRESTR,Money in to PayPal,Contributed income:Donations directed by individuals,PayPal Bank 3,$51.99 ,"$1,024,915.19 "
PayPal Fees,9/22/23,Deposit,6H562266HN050331J,04 PAYPAL GENERAL UNRESTR,PayPal fees,OFFICE/GENERAL ADMINISTRATIVE EXPENSES:PayPal Fees,PayPal Bank 3,$1.99 ,"$1,024,917.18 "
PayPal Bank 3,9/22/23,Deposit,66H31562UM112750F,04 PAYPAL GENERAL UNRESTR,"Subject: GeneralPage
Transaction ID: 66H31562UM112750F
https://www.paypal.com/activity/payment/66H31562UM112750F",PayPal Bank 3,--,$48.06 ,"$1,024,965.24 "
Donations directed by individuals,9/22/23,Deposit,66H31562UM112750F,04 PAYPAL GENERAL UNRESTR,Support Ukraine - Support Ukraine,Contributed income:Donations directed by individuals,PayPal Bank 3,$50.00 ,"$1,025,015.24 "
PayPal Fees,9/22/23,Deposit,66H31562UM112750F,04 PAYPAL GENERAL UNRESTR,PayPal fees,OFFICE/GENERAL ADMINISTRATIVE EXPENSES:PayPal Fees,PayPal Bank 3,$1.94 ,"$1,025,017.18 "
PayPal Bank 3,9/22/23,Deposit,4E525025X5615140L,04 PAYPAL GENERAL UNRESTR,"Subject: GeneralPage
Transaction ID: 4E525025X5615140L
https://www.paypal.com/activity/payment/4E525025X5615140L",PayPal Bank 3,--,$193.73 ,"$1,025,210.91 "
Donations directed by individuals,9/22/23,Deposit,4E525025X5615140L,04 PAYPAL GENERAL UNRESTR,Support Ukraine - Support Ukraine,Contributed income:Donations directed by individuals,PayPal Bank 3,$200.00 ,"$1,025,410.91 "
PayPal Fees,9/22/23,Deposit,4E525025X5615140L,04 PAYPAL GENERAL UNRESTR,PayPal fees,OFFICE/GENERAL ADMINISTRATIVE EXPENSES:PayPal Fees,PayPal Bank 3,$6.27 ,"$1,025,417.18 "
PayPal Bank 3,9/22/23,Deposit,1AB82628AB082022B,04 PAYPAL GENERAL UNRESTR,"Subject: GeneralPage
Transaction ID: 1AB82628AB082022B
https://www.paypal.com/activity/payment/1AB82628AB082022B",PayPal Bank 3,--,$30.00 ,"$1,025,447.18 "
Donations directed by individuals,9/22/23,Deposit,1AB82628AB082022B,04 PAYPAL GENERAL UNRESTR,Support Ukraine - Support Ukraine,Contributed income:Donations directed by individuals,PayPal Bank 3,$31.40 ,"$1,025,478.58 "
PayPal Fees,9/22/23,Deposit,1AB82628AB082022B,04 PAYPAL GENERAL UNRESTR,PayPal fees,OFFICE/GENERAL ADMINISTRATIVE EXPENSES:PayPal Fees,PayPal Bank 3,$1.40 ,"$1,025,479.98 "
PayPal Bank 3,9/22/23,Deposit,7XE23069JM211505J,04 PAYPAL GENERAL UNRESTR,"Subject: GeneralPage
Transaction ID: 7XE23069JM211505J
https://www.paypal.com/activity/payment/7XE23069JM211505J",PayPal Bank 3,--,$200.00 ,"$1,025,679.98 "
Donations directed by individuals,9/22/23,Deposit,7XE23069JM211505J,04 PAYPAL GENERAL UNRESTR,Support Ukraine - Support Ukraine,Contributed income:Donations directed by individuals,PayPal Bank 3,$206.46 ,"$1,025,886.44 "
PayPal Fees,9/22/23,Deposit,7XE23069JM211505J,04 PAYPAL GENERAL UNRESTR,PayPal fees,OFFICE/GENERAL ADMINISTRATIVE EXPENSES:PayPal Fees,PayPal Bank 3,$6.46 ,"$1,025,892.90 "
PayPal Bank 3,9/22/23,Deposit,14J35462YK434063W,04 PAYPAL GENERAL UNRESTR,"Subject: GeneralPage
Note: Vitaliy
Transaction ID: 14J35462YK434063W
https://www.paypal.com/activity/payment/14J35462YK434063W",PayPal Bank 3,--,$100.00 ,"$1,025,992.90 "
Donations directed by individuals,9/22/23,Deposit,14J35462YK434063W,04 PAYPAL GENERAL UNRESTR,Support Ukraine - Support Ukraine,Contributed income:Donations directed by individuals,PayPal Bank 3,$103.48 ,"$1,026,096.38 "
PayPal Fees,9/22/23,Deposit,14J35462YK434063W,04 PAYPAL GENERAL UNRESTR,PayPal fees,OFFICE/GENERAL ADMINISTRATIVE EXPENSES:PayPal Fees,PayPal Bank 3,$3.48 ,"$1,026,099.86 "
PayPal Bank 3,9/22/23,Deposit,50Y61405WN8906705,07 1000 DRONES RESTR,"Subject: 1000DRONES
Transaction ID: 50Y61405WN8906705
https://www.paypal.com/activity/payment/50Y61405WN8906705",PayPal Bank 3,--,$100.00 ,"$1,026,199.86 "
Donations directed by individuals,9/22/23,Deposit,50Y61405WN8906705,07 1000 DRONES RESTR,1000 DRONES FOR UKRAINE - 1000 DRONES FOR UKRAINE,Contributed income:Donations directed by individuals,PayPal Bank 3,$103.48 ,"$1,026,303.34 "
PayPal Fees,9/22/23,Deposit,50Y61405WN8906705,07 1000 DRONES RESTR,PayPal fees,OFFICE/GENERAL ADMINISTRATIVE EXPENSES:PayPal Fees,PayPal Bank 3,$3.48 ,"$1,026,306.82 "
PayPal Bank 3,9/22/23,Deposit,98H38823LS3705240,07 1000 DRONES RESTR,"Subject: 1000DRONES
Transaction ID: 98H38823LS3705240
https://www.paypal.com/activity/payment/98H38823LS3705240",PayPal Bank 3,--,$100.00 ,"$1,026,406.82 "
Donations directed by individuals,9/22/23,Deposit,98H38823LS3705240,07 1000 DRONES RESTR,1000 DRONES FOR UKRAINE - 1000 DRONES FOR UKRAINE,Contributed income:Donations directed by individuals,PayPal Bank 3,$103.48 ,"$1,026,510.30 "
PayPal Fees,9/22/23,Deposit,98H38823LS3705240,07 1000 DRONES RESTR,PayPal fees,OFFICE/GENERAL ADMINISTRATIVE EXPENSES:PayPal Fees,PayPal Bank 3,$3.48 ,"$1,026,513.78 "
PayPal Bank 3,9/22/23,Deposit,8E205330FP784305N,04 PAYPAL GENERAL UNRESTR,"Subject: GeneralPage
Transaction ID: 8E205330FP784305N
https://www.paypal.com/activity/payment/8E205330FP784305N",PayPal Bank 3,--,$95.12 ,"$1,026,608.90 "
Donations directed by individuals,9/22/23,Deposit,8E205330FP784305N,04 PAYPAL GENERAL UNRESTR,Support Ukraine - Support Ukraine,Contributed income:Donations directed by individuals,PayPal Bank 3,$100.00 ,"$1,026,708.90 "
PayPal Fees,9/22/23,Deposit,8E205330FP784305N,04 PAYPAL GENERAL UNRESTR,PayPal fees,OFFICE/GENERAL ADMINISTRATIVE EXPENSES:PayPal Fees,PayPal Bank 3,$4.88 ,"$1,026,713.78 "
PayPal Bank 3,9/22/23,Deposit,3LG961275Y791741P,04 PAYPAL GENERAL UNRESTR,"Subject: GeneralPage
Note: Смерть москалям!!!!
Transaction ID: 3LG961275Y791741P
https://www.paypal.com/activity/payment/3LG961275Y791741P",PayPal Bank 3,--,$295.36 ,"$1,027,009.14 "
Donations directed by individuals,9/22/23,Deposit,3LG961275Y791741P,04 PAYPAL GENERAL UNRESTR,Support Ukraine - Support Ukraine,Contributed income:Donations directed by individuals,PayPal Bank 3,$309.43 ,"$1,027,318.57 "
PayPal Fees,9/22/23,Deposit,3LG961275Y791741P,04 PAYPAL GENERAL UNRESTR,PayPal fees,OFFICE/GENERAL ADMINISTRATIVE EXPENSES:PayPal Fees,PayPal Bank 3,$14.07 ,"$1,027,332.64 "
PayPal Bank 3,9/22/23,Deposit,9SG78993R64490944,04 PAYPAL GENERAL UNRESTR,"Subject: GeneralPage
Transaction ID: 9SG78993R64490944
https://www.paypal.com/activity/payment/9SG78993R64490944",PayPal Bank 3,--,$49.22 ,"$1,027,381.86 "
Donations directed by individuals,9/22/23,Deposit,9SG78993R64490944,04 PAYPAL GENERAL UNRESTR,Support Ukraine - Support Ukraine,Contributed income:Donations directed by individuals,PayPal Bank 3,$51.99 ,"$1,027,433.85 "
PayPal Fees,9/22/23,Deposit,9SG78993R64490944,04 PAYPAL GENERAL UNRESTR,PayPal fees,OFFICE/GENERAL ADMINISTRATIVE EXPENSES:PayPal Fees,PayPal Bank 3,$2.77 ,"$1,027,436.62 "
PayPal Bank 3,9/22/23,Deposit,1GA5606334348872N,04 PAYPAL GENERAL UNRESTR,"Subject: Support Ukraine
Transaction ID: 1GA5606334348872N
https://www.paypal.com/activity/payment/1GA5606334348872N",PayPal Bank 3,--,$4.91 ,"$1,027,441.53 "
Donations directed by individuals,9/22/23,Deposit,1GA5606334348872N,04 PAYPAL GENERAL UNRESTR,Money in to PayPal,Contributed income:Donations directed by individuals,PayPal Bank 3,$5.65 ,"$1,027,447.18 "
PayPal Fees,9/22/23,Deposit,1GA5606334348872N,04 PAYPAL GENERAL UNRESTR,PayPal fees,OFFICE/GENERAL ADMINISTRATIVE EXPENSES:PayPal Fees,PayPal Bank 3,$0.74 ,"$1,027,447.92 "
PayPal Bank 3,9/22/23,Deposit,9L340536SN9971332,04 PAYPAL GENERAL UNRESTR,"Subject: Support Ukraine
Transaction ID: 9L340536SN9971332
https://www.paypal.com/activity/payment/9L340536SN9971332",PayPal Bank 3,--,$9.84 ,"$1,027,457.76 "
Donations directed by individuals,9/22/23,Deposit,9L340536SN9971332,04 PAYPAL GENERAL UNRESTR,Money in to PayPal,Contributed income:Donations directed by individuals,PayPal Bank 3,$10.80 ,"$1,027,468.56 "
PayPal Fees,9/22/23,Deposit,9L340536SN9971332,04 PAYPAL GENERAL UNRESTR,PayPal fees,OFFICE/GENERAL ADMINISTRATIVE EXPENSES:PayPal Fees,PayPal Bank 3,$0.96 ,"$1,027,469.52 "
PayPal Bank 3,9/22/23,Deposit,8C2769025A9199146,04 PAYPAL GENERAL UNRESTR,"Subject: Support Ukraine
Transaction ID: 8C2769025A9199146
https://www.paypal.com/activity/payment/8C2769025A9199146",PayPal Bank 3,--,$24.61 ,"$1,027,494.13 "
Donations directed by individuals,9/22/23,Deposit,8C2769025A9199146,04 PAYPAL GENERAL UNRESTR,Money in to PayPal,Contributed income:Donations directed by individuals,PayPal Bank 3,$26.25 ,"$1,027,520.38 "
PayPal Fees,9/22/23,Deposit,8C2769025A9199146,04 PAYPAL GENERAL UNRESTR,PayPal fees,OFFICE/GENERAL ADMINISTRATIVE EXPENSES:PayPal Fees,PayPal Bank 3,$1.64 ,"$1,027,522.02 "
PayPal Bank 3,9/22/23,Deposit,4PJ094060Y084452W,08 VICTORY DRONES RESTR,"Subject: GeneralPage
Note: for Victory Drones
Transaction ID: 4PJ094060Y084452W
https://www.paypal.com/activity/payment/4PJ094060Y084452W",PayPal Bank 3,--,$98.45 ,"$1,027,620.47 "
Donations directed by individuals,9/22/23,Deposit,4PJ094060Y084452W,08 VICTORY DRONES RESTR,Support Ukraine - Support Ukraine,Contributed income:Donations directed by individuals,PayPal Bank 3,$103.48 ,"$1,027,723.95 "
PayPal Fees,9/22/23,Deposit,4PJ094060Y084452W,08 VICTORY DRONES RESTR,PayPal fees,OFFICE/GENERAL ADMINISTRATIVE EXPENSES:PayPal Fees,PayPal Bank 3,$5.03 ,"$1,027,728.98 "
PayPal Bank 3,9/22/23,Deposit,5CE82164C4881571H,04 PAYPAL GENERAL UNRESTR,"Subject: GeneralPage
Transaction ID: 5CE82164C4881571H
https://www.paypal.com/activity/payment/5CE82164C4881571H",PayPal Bank 3,--,$30.00 ,"$1,027,758.98 "
Donations directed by individuals,9/22/23,Deposit,5CE82164C4881571H,04 PAYPAL GENERAL UNRESTR,Support Ukraine - Support Ukraine,Contributed income:Donations directed by individuals,PayPal Bank 3,$31.40 ,"$1,027,790.38 "
PayPal Fees,9/22/23,Deposit,5CE82164C4881571H,04 PAYPAL GENERAL UNRESTR,PayPal fees,OFFICE/GENERAL ADMINISTRATIVE EXPENSES:PayPal Fees,PayPal Bank 3,$1.40 ,"$1,027,791.78 "
PayPal Bank 3,9/22/23,Deposit,30R686793E5331422,04 PAYPAL GENERAL UNRESTR,"Subject: GeneralPage
Transaction ID: 30R686793E5331422
https://www.paypal.com/activity/payment/30R686793E5331422",PayPal Bank 3,--,$50.00 ,"$1,027,841.78 "
Donations directed by individuals,9/22/23,Deposit,30R686793E5331422,04 PAYPAL GENERAL UNRESTR,Support Ukraine - Support Ukraine,Contributed income:Donations directed by individuals,PayPal Bank 3,$51.99 ,"$1,027,893.77 "
PayPal Fees,9/22/23,Deposit,30R686793E5331422,04 PAYPAL GENERAL UNRESTR,PayPal fees,OFFICE/GENERAL ADMINISTRATIVE EXPENSES:PayPal Fees,PayPal Bank 3,$1.99 ,"$1,027,895.76 "
PayPal Bank 3,9/22/23,Deposit,23968221CG564425G,04 PAYPAL GENERAL UNRESTR,"Subject: GeneralPage
Transaction ID: 23968221CG564425G
https://www.paypal.com/activity/payment/23968221CG564425G",PayPal Bank 3,--,$98.45 ,"$1,027,994.21 "
Donations directed by individuals,9/22/23,Deposit,23968221CG564425G,04 PAYPAL GENERAL UNRESTR,Support Ukraine - Support Ukraine,Contributed income:Donations directed by individuals,PayPal Bank 3,$103.48 ,"$1,028,097.69 "
PayPal Fees,9/22/23,Deposit,23968221CG564425G,04 PAYPAL GENERAL UNRESTR,PayPal fees,OFFICE/GENERAL ADMINISTRATIVE EXPENSES:PayPal Fees,PayPal Bank 3,$5.03 ,"$1,028,102.72 "
PayPal Bank 3,9/22/23,Deposit,0FG37798XE521013L,04 PAYPAL GENERAL UNRESTR,"Subject: GeneralPage
Transaction ID: 0FG37798XE521013L
https://www.paypal.com/activity/payment/0FG37798XE521013L",PayPal Bank 3,--,$29.53 ,"$1,028,132.25 "
Donations directed by individuals,9/22/23,Deposit,0FG37798XE521013L,04 PAYPAL GENERAL UNRESTR,Support Ukraine - Support Ukraine,Contributed income:Donations directed by individuals,PayPal Bank 3,$31.40 ,"$1,028,163.65 "
PayPal Fees,9/22/23,Deposit,0FG37798XE521013L,04 PAYPAL GENERAL UNRESTR,PayPal fees,OFFICE/GENERAL ADMINISTRATIVE EXPENSES:PayPal Fees,PayPal Bank 3,$1.87 ,"$1,028,165.52 "
PayPal Bank 3,9/22/23,Deposit,17503417UU580431Y,04 PAYPAL GENERAL UNRESTR,"Subject: GeneralPage
Transaction ID: 17503417UU580431Y
https://www.paypal.com/activity/payment/17503417UU580431Y",PayPal Bank 3,--,$10.00 ,"$1,028,175.52 "
Donations directed by individuals,9/22/23,Deposit,17503417UU580431Y,04 PAYPAL GENERAL UNRESTR,Support Ukraine - Support Ukraine,Contributed income:Donations directed by individuals,PayPal Bank 3,$10.80 ,"$1,028,186.32 "
PayPal Fees,9/22/23,Deposit,17503417UU580431Y,04 PAYPAL GENERAL UNRESTR,PayPal fees,OFFICE/GENERAL ADMINISTRATIVE EXPENSES:PayPal Fees,PayPal Bank 3,$0.80 ,"$1,028,187.12 "
PayPal Bank 3,9/22/23,Deposit,1BA64015D04591041,08 VICTORY DRONES RESTR,"Subject: VictoryDrones
Transaction ID: 1BA64015D04591041
https://www.paypal.com/activity/payment/1BA64015D04591041",PayPal Bank 3,--,$9.84 ,"$1,028,196.96 "
Donations directed by individuals,9/22/23,Deposit,1BA64015D04591041,08 VICTORY DRONES RESTR,VICTORY DRONES - VICTORY DRONES,Contributed income:Donations directed by individuals,PayPal Bank 3,$10.80 ,"$1,028,207.76 "
PayPal Fees,9/22/23,Deposit,1BA64015D04591041,08 VICTORY DRONES RESTR,PayPal fees,OFFICE/GENERAL ADMINISTRATIVE EXPENSES:PayPal Fees,PayPal Bank 3,$0.96 ,"$1,028,208.72 "
PayPal Bank 3,9/22/23,Deposit,3H9365522C553842C,04 PAYPAL GENERAL UNRESTR,"Subject: GeneralPage
Transaction ID: 3H9365522C553842C
https://www.paypal.com/activity/payment/3H9365522C553842C",PayPal Bank 3,--,$98.45 ,"$1,028,307.17 "
Donations directed by individuals,9/22/23,Deposit,3H9365522C553842C,04 PAYPAL GENERAL UNRESTR,Support Ukraine - Support Ukraine,Contributed income:Donations directed by individuals,PayPal Bank 3,$103.48 ,"$1,028,410.65 "
PayPal Fees,9/22/23,Deposit,3H9365522C553842C,04 PAYPAL GENERAL UNRESTR,PayPal fees,OFFICE/GENERAL ADMINISTRATIVE EXPENSES:PayPal Fees,PayPal Bank 3,$5.03 ,"$1,028,415.68 "
PayPal Bank 3,9/22/23,Deposit,2SC24493GE657405E,04 PAYPAL GENERAL UNRESTR,"Subject: GeneralPage
Transaction ID: 2SC24493GE657405E
https://www.paypal.com/activity/payment/2SC24493GE657405E",PayPal Bank 3,--,$100.00 ,"$1,028,515.68 "
Donations directed by individuals,9/22/23,Deposit,2SC24493GE657405E,04 PAYPAL GENERAL UNRESTR,Support Ukraine - Support Ukraine,Contributed income:Donations directed by individuals,PayPal Bank 3,$103.48 ,"$1,028,619.16 "
PayPal Fees,9/22/23,Deposit,2SC24493GE657405E,04 PAYPAL GENERAL UNRESTR,PayPal fees,OFFICE/GENERAL ADMINISTRATIVE EXPENSES:PayPal Fees,PayPal Bank 3,$3.48 ,"$1,028,622.64 "
PayPal Bank 3,9/22/23,Deposit,7JM22124K5066620P,04 PAYPAL GENERAL UNRESTR,"Subject: GeneralPage
Transaction ID: 7JM22124K5066620P
https://www.paypal.com/activity/payment/7JM22124K5066620P",PayPal Bank 3,--,$286.34 ,"$1,028,908.98 "
Donations directed by individuals,9/22/23,Deposit,7JM22124K5066620P,04 PAYPAL GENERAL UNRESTR,Support Ukraine - Support Ukraine,Contributed income:Donations directed by individuals,PayPal Bank 3,$300.00 ,"$1,029,208.98 "
PayPal Fees,9/22/23,Deposit,7JM22124K5066620P,04 PAYPAL GENERAL UNRESTR,PayPal fees,OFFICE/GENERAL ADMINISTRATIVE EXPENSES:PayPal Fees,PayPal Bank 3,$13.66 ,"$1,029,222.64 "
PayPal Bank 3,9/22/23,Deposit,6T7428284U7260609,04 PAYPAL GENERAL UNRESTR,"Subject: GeneralPage
Transaction ID: 6T7428284U7260609
https://www.paypal.com/activity/payment/6T7428284U7260609",PayPal Bank 3,--,$142.92 ,"$1,029,365.56 "
Donations directed by individuals,9/22/23,Deposit,6T7428284U7260609,04 PAYPAL GENERAL UNRESTR,Support Ukraine - Support Ukraine,Contributed income:Donations directed by individuals,PayPal Bank 3,$150.00 ,"$1,029,515.56 "
PayPal Fees,9/22/23,Deposit,6T7428284U7260609,04 PAYPAL GENERAL UNRESTR,PayPal fees,OFFICE/GENERAL ADMINISTRATIVE EXPENSES:PayPal Fees,PayPal Bank 3,$7.08 ,"$1,029,522.64 "
PayPal Bank 3,9/22/23,Deposit,78F988039V923024L,04 PAYPAL GENERAL UNRESTR,"Subject: Support Ukraine
Transaction ID: 78F988039V923024L
https://www.paypal.com/activity/payment/78F988039V923024L",PayPal Bank 3,--,$98.45 ,"$1,029,621.09 "
Donations directed by individuals,9/22/23,Deposit,78F988039V923024L,04 PAYPAL GENERAL UNRESTR,Money in to PayPal,Contributed income:Donations directed by individuals,PayPal Bank 3,$103.48 ,"$1,029,724.57 "
PayPal Fees,9/22/23,Deposit,78F988039V923024L,04 PAYPAL GENERAL UNRESTR,PayPal fees,OFFICE/GENERAL ADMINISTRATIVE EXPENSES:PayPal Fees,PayPal Bank 3,$5.03 ,"$1,029,729.60 "
PayPal Bank 3,9/22/23,Deposit,5AK1297008993505N,04 PAYPAL GENERAL UNRESTR,"Subject: GeneralPage
Transaction ID: 5AK1297008993505N
https://www.paypal.com/activity/payment/5AK1297008993505N",PayPal Bank 3,--,$9.84 ,"$1,029,739.44 "
Donations directed by individuals,9/22/23,Deposit,5AK1297008993505N,04 PAYPAL GENERAL UNRESTR,Support Ukraine - Support Ukraine,Contributed income:Donations directed by individuals,PayPal Bank 3,$10.80 ,"$1,029,750.24 "
PayPal Fees,9/22/23,Deposit,5AK1297008993505N,04 PAYPAL GENERAL UNRESTR,PayPal fees,OFFICE/GENERAL ADMINISTRATIVE EXPENSES:PayPal Fees,PayPal Bank 3,$0.96 ,"$1,029,751.20 "
PayPal Bank 3,9/22/23,Deposit,1B109205UM345364X,08 VICTORY DRONES RESTR,"Subject: VictoryDrones
Transaction ID: 1B109205UM345364X
https://www.paypal.com/activity/payment/1B109205UM345364X",PayPal Bank 3,--,$56.88 ,"$1,029,808.08 "
Donations directed by individuals,9/22/23,Deposit,1B109205UM345364X,08 VICTORY DRONES RESTR,VICTORY DRONES - VICTORY DRONES,Contributed income:Donations directed by individuals,PayPal Bank 3,$60.00 ,"$1,029,868.08 "
PayPal Fees,9/22/23,Deposit,1B109205UM345364X,08 VICTORY DRONES RESTR,PayPal fees,OFFICE/GENERAL ADMINISTRATIVE EXPENSES:PayPal Fees,PayPal Bank 3,$3.12 ,"$1,029,871.20 "
PayPal Bank 3,9/22/23,Deposit,7AL13861MY527053A,04 PAYPAL GENERAL UNRESTR,"Subject: GeneralPage
Transaction ID: 7AL13861MY527053A
https://www.paypal.com/activity/payment/7AL13861MY527053A",PayPal Bank 3,--,$96.62 ,"$1,029,967.82 "
Donations directed by individuals,9/22/23,Deposit,7AL13861MY527053A,04 PAYPAL GENERAL UNRESTR,Support Ukraine - Support Ukraine,Contributed income:Donations directed by individuals,PayPal Bank 3,$100.00 ,"$1,030,067.82 "
PayPal Fees,9/22/23,Deposit,7AL13861MY527053A,04 PAYPAL GENERAL UNRESTR,PayPal fees,OFFICE/GENERAL ADMINISTRATIVE EXPENSES:PayPal Fees,PayPal Bank 3,$3.38 ,"$1,030,071.20 "
PayPal Bank 3,9/22/23,Deposit,2SG73606LG8917353,04 PAYPAL GENERAL UNRESTR,"Subject: GeneralPage
Transaction ID: 2SG73606LG8917353
https://www.paypal.com/activity/payment/2SG73606LG8917353",PayPal Bank 3,--,$290.84 ,"$1,030,362.04 "
Donations directed by individuals,9/22/23,Deposit,2SG73606LG8917353,04 PAYPAL GENERAL UNRESTR,Support Ukraine - Support Ukraine,Contributed income:Donations directed by individuals,PayPal Bank 3,$300.00 ,"$1,030,662.04 "
PayPal Fees,9/22/23,Deposit,2SG73606LG8917353,04 PAYPAL GENERAL UNRESTR,PayPal fees,OFFICE/GENERAL ADMINISTRATIVE EXPENSES:PayPal Fees,PayPal Bank 3,$9.16 ,"$1,030,671.20 "
PayPal Bank 3,9/22/23,Deposit,3N7059264J4720016,08 VICTORY DRONES RESTR,"Subject: VictoryDrones
Transaction ID: 3N7059264J4720016
https://www.paypal.com/activity/payment/3N7059264J4720016",PayPal Bank 3,--,$9.84 ,"$1,030,681.04 "
Donations directed by individuals,9/22/23,Deposit,3N7059264J4720016,08 VICTORY DRONES RESTR,VICTORY DRONES - VICTORY DRONES,Contributed income:Donations directed by individuals,PayPal Bank 3,$10.80 ,"$1,030,691.84 "
PayPal Fees,9/22/23,Deposit,3N7059264J4720016,08 VICTORY DRONES RESTR,PayPal fees,OFFICE/GENERAL ADMINISTRATIVE EXPENSES:PayPal Fees,PayPal Bank 3,$0.96 ,"$1,030,692.80 "
PayPal Bank 3,9/22/23,Deposit,8T328532E6848610T,08 VICTORY DRONES RESTR,"Subject: VictoryDrones
Transaction ID: 8T328532E6848610T
https://www.paypal.com/activity/payment/8T328532E6848610T",PayPal Bank 3,--,$59.07 ,"$1,030,751.87 "
Donations directed by individuals,9/22/23,Deposit,8T328532E6848610T,08 VICTORY DRONES RESTR,VICTORY DRONES - VICTORY DRONES,Contributed income:Donations directed by individuals,PayPal Bank 3,$62.29 ,"$1,030,814.16 "
PayPal Fees,9/22/23,Deposit,8T328532E6848610T,08 VICTORY DRONES RESTR,PayPal fees,OFFICE/GENERAL ADMINISTRATIVE EXPENSES:PayPal Fees,PayPal Bank 3,$3.22 ,"$1,030,817.38 "
PayPal Bank 3,9/22/23,Deposit,84740723FP593710A,09 MSU RESTR,"Subject: MobileShowers
Transaction ID: 84740723FP593710A
https://www.paypal.com/activity/payment/84740723FP593710A",PayPal Bank 3,--,$28.19 ,"$1,030,845.57 "
Donations directed by individuals,9/22/23,Deposit,84740723FP593710A,09 MSU RESTR,Mobile Shower/Laundry Units - Mobile Shower/Laundry Units,Contributed income:Donations directed by individuals,PayPal Bank 3,$30.00 ,"$1,030,875.57 "
PayPal Fees,9/22/23,Deposit,84740723FP593710A,09 MSU RESTR,PayPal fees,OFFICE/GENERAL ADMINISTRATIVE EXPENSES:PayPal Fees,PayPal Bank 3,$1.81 ,"$1,030,877.38 "
PayPal Bank 3,9/22/23,Deposit,3EC6082698323264L,09 MSU RESTR,"Subject: MobileShowers
Transaction ID: 3EC6082698323264L
https://www.paypal.com/activity/payment/3EC6082698323264L",PayPal Bank 3,--,$295.36 ,"$1,031,172.74 "
Donations directed by individuals,9/22/23,Deposit,3EC6082698323264L,09 MSU RESTR,Mobile Shower/Laundry Units - Mobile Shower/Laundry Units,Contributed income:Donations directed by individuals,PayPal Bank 3,$309.43 ,"$1,031,482.17 "
PayPal Fees,9/22/23,Deposit,3EC6082698323264L,09 MSU RESTR,PayPal fees,OFFICE/GENERAL ADMINISTRATIVE EXPENSES:PayPal Fees,PayPal Bank 3,$14.07 ,"$1,031,496.24 "
PayPal Bank 3,9/22/23,Deposit,5128540375715382H,04 PAYPAL GENERAL UNRESTR,"Subject: GeneralPage
Transaction ID: 5128540375715382H
https://www.paypal.com/activity/payment/5128540375715382H",PayPal Bank 3,--,$49.22 ,"$1,031,545.46 "
Donations directed by individuals,9/22/23,Deposit,5128540375715382H,04 PAYPAL GENERAL UNRESTR,Support Ukraine - Support Ukraine,Contributed income:Donations directed by individuals,PayPal Bank 3,$51.99 ,"$1,031,597.45 "
PayPal Fees,9/22/23,Deposit,5128540375715382H,04 PAYPAL GENERAL UNRESTR,PayPal fees,OFFICE/GENERAL ADMINISTRATIVE EXPENSES:PayPal Fees,PayPal Bank 3,$2.77 ,"$1,031,600.22 "
PayPal Bank 3,9/22/23,Deposit,3HK125449Y377050N,04 PAYPAL GENERAL UNRESTR,"Subject: GeneralPage
Note: Spaghetti Kozak told me about you!
Transaction ID: 3HK125449Y377050N
https://www.paypal.com/activity/payment/3HK125449Y377050N",PayPal Bank 3,--,$96.62 ,"$1,031,696.84 "
Donations directed by individuals,9/22/23,Deposit,3HK125449Y377050N,04 PAYPAL GENERAL UNRESTR,Support Ukraine - Support Ukraine,Contributed income:Donations directed by individuals,PayPal Bank 3,$100.00 ,"$1,031,796.84 "
PayPal Fees,9/22/23,Deposit,3HK125449Y377050N,04 PAYPAL GENERAL UNRESTR,PayPal fees,OFFICE/GENERAL ADMINISTRATIVE EXPENSES:PayPal Fees,PayPal Bank 3,$3.38 ,"$1,031,800.22 "
PayPal Bank 3,9/22/23,Deposit,8BN79570002139722,04 PAYPAL GENERAL UNRESTR,"Subject: GeneralPage
Transaction ID: 8BN79570002139722
https://www.paypal.com/activity/payment/8BN79570002139722",PayPal Bank 3,--,$196.91 ,"$1,031,997.13 "
Donations directed by individuals,9/22/23,Deposit,8BN79570002139722,04 PAYPAL GENERAL UNRESTR,Support Ukraine - Support Ukraine,Contributed income:Donations directed by individuals,PayPal Bank 3,$206.46 ,"$1,032,203.59 "
PayPal Fees,9/22/23,Deposit,8BN79570002139722,04 PAYPAL GENERAL UNRESTR,PayPal fees,OFFICE/GENERAL ADMINISTRATIVE EXPENSES:PayPal Fees,PayPal Bank 3,$9.55 ,"$1,032,213.14 "
PayPal Bank 3,9/22/23,Deposit,2XJ95803HB276273U,04 PAYPAL GENERAL UNRESTR,"Subject: GeneralPage
Transaction ID: 2XJ95803HB276273U
https://www.paypal.com/activity/payment/2XJ95803HB276273U",PayPal Bank 3,--,$5.90 ,"$1,032,219.04 "
Donations directed by individuals,9/22/23,Deposit,2XJ95803HB276273U,04 PAYPAL GENERAL UNRESTR,Support Ukraine - Support Ukraine,Contributed income:Donations directed by individuals,PayPal Bank 3,$6.68 ,"$1,032,225.72 "
PayPal Fees,9/22/23,Deposit,2XJ95803HB276273U,04 PAYPAL GENERAL UNRESTR,PayPal fees,OFFICE/GENERAL ADMINISTRATIVE EXPENSES:PayPal Fees,PayPal Bank 3,$0.78 ,"$1,032,226.50 "
PayPal Bank 3,9/22/23,Deposit,04E26444G5952162J,04 PAYPAL GENERAL UNRESTR,"Subject: GeneralPage
Transaction ID: 04E26444G5952162J
https://www.paypal.com/activity/payment/04E26444G5952162J",PayPal Bank 3,--,$196.91 ,"$1,032,423.41 "
Donations directed by individuals,9/22/23,Deposit,04E26444G5952162J,04 PAYPAL GENERAL UNRESTR,Support Ukraine - Support Ukraine,Contributed income:Donations directed by individuals,PayPal Bank 3,$206.46 ,"$1,032,629.87 "
PayPal Fees,9/22/23,Deposit,04E26444G5952162J,04 PAYPAL GENERAL UNRESTR,PayPal fees,OFFICE/GENERAL ADMINISTRATIVE EXPENSES:PayPal Fees,PayPal Bank 3,$9.55 ,"$1,032,639.42 "
PayPal Bank 3,9/22/23,Deposit,9HB22139CS009020D,04 PAYPAL GENERAL UNRESTR,"Subject: GeneralPage
Transaction ID: 9HB22139CS009020D
https://www.paypal.com/activity/payment/9HB22139CS009020D",PayPal Bank 3,--,$48.06 ,"$1,032,687.48 "
Donations directed by individuals,9/22/23,Deposit,9HB22139CS009020D,04 PAYPAL GENERAL UNRESTR,Support Ukraine - Support Ukraine,Contributed income:Donations directed by individuals,PayPal Bank 3,$50.00 ,"$1,032,737.48 "
PayPal Fees,9/22/23,Deposit,9HB22139CS009020D,04 PAYPAL GENERAL UNRESTR,PayPal fees,OFFICE/GENERAL ADMINISTRATIVE EXPENSES:PayPal Fees,PayPal Bank 3,$1.94 ,"$1,032,739.42 "
PayPal Bank 3,9/22/23,Deposit,6MN03903DJ120811V,04 PAYPAL GENERAL UNRESTR,"Subject: GeneralPage
Transaction ID: 6MN03903DJ120811V
https://www.paypal.com/activity/payment/6MN03903DJ120811V",PayPal Bank 3,--,$98.45 ,"$1,032,837.87 "
Donations directed by individuals,9/22/23,Deposit,6MN03903DJ120811V,04 PAYPAL GENERAL UNRESTR,Support Ukraine - Support Ukraine,Contributed income:Donations directed by individuals,PayPal Bank 3,$103.48 ,"$1,032,941.35 "
PayPal Fees,9/22/23,Deposit,6MN03903DJ120811V,04 PAYPAL GENERAL UNRESTR,PayPal fees,OFFICE/GENERAL ADMINISTRATIVE EXPENSES:PayPal Fees,PayPal Bank 3,$5.03 ,"$1,032,946.38 "
PayPal Bank 3,9/22/23,Deposit,7UH579967F907653C,07 1000 DRONES RESTR,"Subject: 1000 DRONES FOR UKRAINE
Transaction ID: 7UH579967F907653C
https://www.paypal.com/activity/payment/7UH579967F907653C",PayPal Bank 3,--,$24.61 ,"$1,032,970.99 "
Donations directed by individuals,9/22/23,Deposit,7UH579967F907653C,07 1000 DRONES RESTR,Money in to PayPal,Contributed income:Donations directed by individuals,PayPal Bank 3,$26.25 ,"$1,032,997.24 "
PayPal Fees,9/22/23,Deposit,7UH579967F907653C,07 1000 DRONES RESTR,PayPal fees,OFFICE/GENERAL ADMINISTRATIVE EXPENSES:PayPal Fees,PayPal Bank 3,$1.64 ,"$1,032,998.88 "
PayPal Bank 3,9/22/23,Deposit,55B41665S7187545T,04 PAYPAL GENERAL UNRESTR,"Subject: GeneralPage
Transaction ID: 55B41665S7187545T
https://www.paypal.com/activity/payment/55B41665S7187545T",PayPal Bank 3,--,$42.53 ,"$1,033,041.41 "
Donations directed by individuals,9/22/23,Deposit,55B41665S7187545T,04 PAYPAL GENERAL UNRESTR,Support Ukraine - Support Ukraine,Contributed income:Donations directed by individuals,PayPal Bank 3,$45.00 ,"$1,033,086.41 "
PayPal Fees,9/22/23,Deposit,55B41665S7187545T,04 PAYPAL GENERAL UNRESTR,PayPal fees,OFFICE/GENERAL ADMINISTRATIVE EXPENSES:PayPal Fees,PayPal Bank 3,$2.47 ,"$1,033,088.88 "
PayPal Bank 3,9/22/23,Deposit,5BC82512X3461373D,07 1000 DRONES RESTR,"Subject: GeneralPage
Note: на лютих пташок
Transaction ID: 5BC82512X3461373D
https://www.paypal.com/activity/payment/5BC82512X3461373D",PayPal Bank 3,--,$98.45 ,"$1,033,187.33 "
Donations directed by individuals,9/22/23,Deposit,5BC82512X3461373D,07 1000 DRONES RESTR,Support Ukraine - Support Ukraine,Contributed income:Donations directed by individuals,PayPal Bank 3,$103.48 ,"$1,033,290.81 "
PayPal Fees,9/22/23,Deposit,5BC82512X3461373D,07 1000 DRONES RESTR,PayPal fees,OFFICE/GENERAL ADMINISTRATIVE EXPENSES:PayPal Fees,PayPal Bank 3,$5.03 ,"$1,033,295.84 "
PayPal Bank 3,9/22/23,Deposit,76H31803LA575464A,04 PAYPAL GENERAL UNRESTR,"Subject: GeneralPage
Transaction ID: 76H31803LA575464A
https://www.paypal.com/activity/payment/76H31803LA575464A",PayPal Bank 3,--,$9.07 ,"$1,033,304.91 "
Donations directed by individuals,9/22/23,Deposit,76H31803LA575464A,04 PAYPAL GENERAL UNRESTR,Support Ukraine - Support Ukraine,Contributed income:Donations directed by individuals,PayPal Bank 3,$10.00 ,"$1,033,314.91 "
PayPal Fees,9/22/23,Deposit,76H31803LA575464A,04 PAYPAL GENERAL UNRESTR,PayPal fees,OFFICE/GENERAL ADMINISTRATIVE EXPENSES:PayPal Fees,PayPal Bank 3,$0.93 ,"$1,033,315.84 "
PayPal Bank 3,9/22/23,Deposit,7UJ39686VG9878730,04 PAYPAL GENERAL UNRESTR,"Subject: GeneralPage
Transaction ID: 7UJ39686VG9878730
https://www.paypal.com/activity/payment/7UJ39686VG9878730",PayPal Bank 3,--,$970.61 ,"$1,034,286.45 "
Donations directed by individuals,9/22/23,Deposit,7UJ39686VG9878730,04 PAYPAL GENERAL UNRESTR,Support Ukraine - Support Ukraine,Contributed income:Donations directed by individuals,PayPal Bank 3,"$1,000.00 ","$1,035,286.45 "
PayPal Fees,9/22/23,Deposit,7UJ39686VG9878730,04 PAYPAL GENERAL UNRESTR,PayPal fees,OFFICE/GENERAL ADMINISTRATIVE EXPENSES:PayPal Fees,PayPal Bank 3,$29.39 ,"$1,035,315.84 "
PayPal Bank 3,9/22/23,Deposit,1RL78043SB3304007,04 PAYPAL GENERAL UNRESTR,"Subject: GeneralPage
Transaction ID: 1RL78043SB3304007
https://www.paypal.com/activity/payment/1RL78043SB3304007",PayPal Bank 3,--,$984.54 ,"$1,036,300.38 "
Donations directed by individuals,9/22/23,Deposit,1RL78043SB3304007,04 PAYPAL GENERAL UNRESTR,Support Ukraine - Support Ukraine,Contributed income:Donations directed by individuals,PayPal Bank 3,"$1,030.26 ","$1,037,330.64 "
PayPal Fees,9/22/23,Deposit,1RL78043SB3304007,04 PAYPAL GENERAL UNRESTR,PayPal fees,OFFICE/GENERAL ADMINISTRATIVE EXPENSES:PayPal Fees,PayPal Bank 3,$45.72 ,"$1,037,376.36 "
CHASE ENDING IN 5315,9/22/23,Deposit,--,02 GENERAL BANK URESTR,BOOK TRANSFER B/O: JPMC INTERNAL ACCOUNTS PROCESSING NEWARK DE XXXXX-XXXX US ORG:/WXXXXXXXX JUDY & PETER BLUM KOVLER FOUNDATION TRN: XXXXXX0265ES,CHASE ENDING IN 5315,Donations directed by individuals,"$12,000.00 ","$1,049,376.36 "
Donations directed by individuals,9/22/23,Deposit,--,02 GENERAL BANK URESTR,BOOK TRANSFER B/O: JPMC INTERNAL ACCOUNTS PROCESSING NEWARK DE XXXXX-XXXX US ORG:/WXXXXXXXX JUDY & PETER BLUM KOVLER FOUNDATION TRN: XXXXXX0265ES,Contributed income:Donations directed by individuals,CHASE ENDING IN 5315,"$12,000.00 ","$1,061,376.36 "
CHASE ENDING IN 5315,9/22/23,Deposit,--,02 GENERAL BANK URESTR,Zelle payment from IRENE AMRINE XXXXXXX1838,CHASE ENDING IN 5315,Donations directed by individuals,"$1,439.55 ","$1,062,815.91 "
Donations directed by individuals,9/22/23,Deposit,--,02 GENERAL BANK URESTR,Zelle payment from IRENE AMRINE XXXXXXX1838,Contributed income:Donations directed by individuals,CHASE ENDING IN 5315,"$1,439.55 ","$1,064,255.46 "
CHASE ENDING IN 5315,9/21/23,Deposit,--,02 GENERAL BANK URESTR,Zelle payment from IRINA ZAKHALYAVKO XXXXXXX1558,CHASE ENDING IN 5315,Donations directed by individuals,$30.00 ,"$1,064,285.46 "
Donations directed by individuals,9/21/23,Deposit,--,02 GENERAL BANK URESTR,Zelle payment from IRINA ZAKHALYAVKO XXXXXXX1558,Contributed income:Donations directed by individuals,CHASE ENDING IN 5315,$30.00 ,"$1,064,315.46 "
CHASE ENDING IN 5315,9/20/23,Deposit,--,02 GENERAL BANK URESTR,Zelle payment from IRINA ZAKHALYAVKO XXXXXXX1558,CHASE ENDING IN 5315,Donations directed by individuals,"$3,000.00 ","$1,067,315.46 "
Donations directed by individuals,9/20/23,Deposit,--,02 GENERAL BANK URESTR,Zelle payment from IRINA ZAKHALYAVKO XXXXXXX1558,Contributed income:Donations directed by individuals,CHASE ENDING IN 5315,"$3,000.00 ","$1,070,315.46 "
CHASE ENDING IN 5315,9/17/23,Deposit,--,02 GENERAL BANK URESTR,Zelle payment from MYKOLA GRYSHKO XXXXXXX7191,CHASE ENDING IN 5315,Donations directed by individuals,$140.00 ,"$1,070,455.46 "
Donations directed by individuals,9/17/23,Deposit,--,02 GENERAL BANK URESTR,Zelle payment from MYKOLA GRYSHKO XXXXXXX7191,Contributed income:Donations directed by individuals,CHASE ENDING IN 5315,$140.00 ,"$1,070,595.46 "
CHASE ENDING IN 5315,9/16/23,Deposit,--,02 GENERAL BANK URESTR,Zelle payment from MICHAL MALAROWSKI XXXXXXX3478,CHASE ENDING IN 5315,Donations directed by individuals,$25.00 ,"$1,070,620.46 "
Donations directed by individuals,9/16/23,Deposit,--,02 GENERAL BANK URESTR,Zelle payment from MICHAL MALAROWSKI XXXXXXX3478,Contributed income:Donations directed by individuals,CHASE ENDING IN 5315,$25.00 ,"$1,070,645.46 "
CHASE ENDING IN 5315,9/14/23,Deposit,--,05 VENMO UNRESTR,ORIG CO NAME:VENMO ORIG ID:XXXXXXXXXX DESC DATE:XXXXXX CO ENTRY DESCR:CASHOUT SEC:PPD TRACE#:XXXXXXXXXXXXXXX EED:XXXXX4 IND ID: IND NAME:OKSANA PATRINA TRN: 257 XXX7885TC,CHASE ENDING IN 5315,Donations directed by individuals,$739.96 ,"$1,071,385.42 "
Donations directed by individuals,9/14/23,Deposit,--,05 VENMO UNRESTR,ORIG CO NAME:VENMO ORIG ID:XXXXXXXXXX DESC DATE:XXXXXX CO ENTRY DESCR:CASHOUT SEC:PPD TRACE#:XXXXXXXXXXXXXXX EED:XXXXX4 IND ID: IND NAME:OKSANA PATRINA TRN: 257 XXX7885TC,Contributed income:Donations directed by individuals,CHASE ENDING IN 5315,$739.96 ,"$1,072,125.38 "
TRANSFER-ADJUSTMENTS,9/14/23,Journal Entry,16,--,--,Contributed income:TRANSFER-ADJUSTMENTS,--,($739.96),"$1,071,385.42 "
TRANSFER-ADJUSTMENTS,9/14/23,Journal Entry,16,--,--,Contributed income:TRANSFER-ADJUSTMENTS,--,$739.96 ,"$1,072,125.38 "
PayPal Bank 3,9/13/23,Transfer,--,--,ORIG CO NAME:PAYPAL ORIG ID:PAYPALSDXX DESC DATE:XXXXXX CO ENTRY DESCR:TRANSFER SEC:PPD TRACE#:XXXXXXXXXXXXXXX EED:XX0913 IND ID: IND NAME:DIGNITAS UKRAINE TRN: XXXXXX4343TC,PayPal Bank 3,CHASE ENDING IN 5315,"($20,000.00)","$1,052,125.38 "
CHASE ENDING IN 5315,9/13/23,Transfer,--,--,ORIG CO NAME:PAYPAL ORIG ID:PAYPALSDXX DESC DATE:XXXXXX CO ENTRY DESCR:TRANSFER SEC:PPD TRACE#:XXXXXXXXXXXXXXX EED:XX0913 IND ID: IND NAME:DIGNITAS UKRAINE TRN: XXXXXX4343TC,CHASE ENDING IN 5315,PayPal Bank 3,"$20,000.00 ","$1,072,125.38 "
CHASE ENDING IN 5315,9/13/23,Expense,--,QuickBooks Payments,ORIG CO NAME:INTUIT * ORIG ID:XXXXXXXXXX DESC DATE:XXXXXX CO ENTRY DESCR:QBooks OnlSEC:CCD TRACE#:XXXXXXXXXXXXXXX EED:XXXXXX IND ID:XXX7857 IND NAME:DIGNITAS UK RAINE INC XXX-XXX-XXXX TRN: XXXXXX0952TC,CHASE ENDING IN 5315,Software & apps,($85.00),"$1,072,040.38 "
Software & apps,9/13/23,Expense,--,QuickBooks Payments,ORIG CO NAME:INTUIT * ORIG ID:XXXXXXXXXX DESC DATE:XXXXXX CO ENTRY DESCR:QBooks OnlSEC:CCD TRACE#:XXXXXXXXXXXXXXX EED:XXXXXX IND ID:XXX7857 IND NAME:DIGNITAS UK RAINE INC XXX-XXX-XXXX TRN: XXXXXX0952TC,OFFICE/GENERAL ADMINISTRATIVE EXPENSES:Software & apps,CHASE ENDING IN 5315,$85.00 ,"$1,072,125.38 "
CHASE ENDING IN 5315,9/13/23,Expense,--,NGOPTICS,"ONLINE INTERNATIONAL WIRE TRANSFER A/C: FOREIGN CUR BUS ACCT BK X COLUMBUS NEWARK DE XXXXXXXXX US ORG: XXXXXXXXXXXXXXXXX DIGNITAS UKRAINE INC BEN:/PLXXXXXXX5681 XXXXXXXXXXXXXXX NGOPTICS SP Z O O REF: PROFORMA INVOICE NO PX/XX/XXXX PAYER DIGNITAS UKRAINE INC INVOICE PAYM ENT/OCMT/EURXXXXXX,XX/EXCH/X.XXXX/C NTR/XXXXXXXX/ACC/PROFORMA TRN: XXXXXXXXXXRE 09/13",CHASE ENDING IN 5315,DRONE PURCHASES,"($169,502.30)","$902,623.08 "
DRONE PURCHASES,9/13/23,Expense,--,NGOPTICS,"ONLINE INTERNATIONAL WIRE TRANSFER A/C: FOREIGN CUR BUS ACCT BK X COLUMBUS NEWARK DE XXXXXXXXX US ORG: XXXXXXXXXXXXXXXXX DIGNITAS UKRAINE INC BEN:/PLXXXXXXX5681 XXXXXXXXXXXXXXX NGOPTICS SP Z O O REF: PROFORMA INVOICE NO PX/XX/XXXX PAYER DIGNITAS UKRAINE INC INVOICE PAYM ENT/OCMT/EURXXXXXX,XX/EXCH/X.XXXX/C NTR/XXXXXXXX/ACC/PROFORMA TRN: XXXXXXXXXXRE 09/13",PROGRAM EXPENSES:DRONE PURCHASES,CHASE ENDING IN 5315,"$169,502.30 ","$1,072,125.38 "
TRANSFERS DIRECTED BY BOARD,9/13/23,Journal Entry,1,--,--,Contributed income:TRANSFERS DIRECTED BY BOARD,--,"($169,502.30)","$902,623.08 "
TRANSFERS DIRECTED BY BOARD,9/13/23,Journal Entry,1,--,--,Contributed income:TRANSFERS DIRECTED BY BOARD,--,"$169,502.30 ","$1,072,125.38 "
CHASE ENDING IN 5315,9/10/23,Deposit,--,02 GENERAL BANK URESTR,Zelle payment from MARYNA TKACHENKO XXXXXXX3842,CHASE ENDING IN 5315,Donations directed by individuals,$500.00 ,"$1,072,625.38 "
Donations directed by individuals,9/10/23,Deposit,--,02 GENERAL BANK URESTR,Zelle payment from MARYNA TKACHENKO XXXXXXX3842,Contributed income:Donations directed by individuals,CHASE ENDING IN 5315,$500.00 ,"$1,073,125.38 "
CHASE ENDING IN 5315,9/10/23,Deposit,--,02 GENERAL BANK URESTR,Zelle payment from NIKITA KORMSHCHIKOV BACmaxqw3f7g,CHASE ENDING IN 5315,Donations directed by individuals,"$1,000.00 ","$1,074,125.38 "
Donations directed by individuals,9/10/23,Deposit,--,02 GENERAL BANK URESTR,Zelle payment from NIKITA KORMSHCHIKOV BACmaxqw3f7g,Contributed income:Donations directed by individuals,CHASE ENDING IN 5315,"$1,000.00 ","$1,075,125.38 "
CHASE ENDING IN 5315,9/10/23,Deposit,--,02 GENERAL BANK URESTR,Zelle payment from YULIIA KOLODKINA XXXXXXX9064,CHASE ENDING IN 5315,Donations directed by individuals,$500.00 ,"$1,075,625.38 "
Donations directed by individuals,9/10/23,Deposit,--,02 GENERAL BANK URESTR,Zelle payment from YULIIA KOLODKINA XXXXXXX9064,Contributed income:Donations directed by individuals,CHASE ENDING IN 5315,$500.00 ,"$1,076,125.38 "
TRANSFER-ADJUSTMENTS,9/10/23,Journal Entry,15,--,--,Contributed income:TRANSFER-ADJUSTMENTS,--,($500.00),"$1,075,625.38 "
TRANSFER-ADJUSTMENTS,9/10/23,Journal Entry,15,--,--,Contributed income:TRANSFER-ADJUSTMENTS,--,$500.00 ,"$1,076,125.38 "
TRANSFER-ADJUSTMENTS,9/10/23,Journal Entry,15,--,--,Contributed income:TRANSFER-ADJUSTMENTS,--,($500.00),"$1,075,625.38 "
TRANSFER-ADJUSTMENTS,9/10/23,Journal Entry,15,--,--,Contributed income:TRANSFER-ADJUSTMENTS,--,$500.00 ,"$1,076,125.38 "
TRANSFER-ADJUSTMENTS,9/10/23,Journal Entry,15,--,--,Contributed income:TRANSFER-ADJUSTMENTS,--,"($1,000.00)","$1,075,125.38 "
TRANSFER-ADJUSTMENTS,9/10/23,Journal Entry,15,--,--,Contributed income:TRANSFER-ADJUSTMENTS,--,"$1,000.00 ","$1,076,125.38 "
CHASE ENDING IN 5315,9/9/23,Deposit,--,02 GENERAL BANK URESTR,Zelle payment from IRINA ZAKHALYAVKO XXXXXXX1558,CHASE ENDING IN 5315,Donations directed by individuals,$10.00 ,"$1,076,135.38 "
Donations directed by individuals,9/9/23,Deposit,--,02 GENERAL BANK URESTR,Zelle payment from IRINA ZAKHALYAVKO XXXXXXX1558,Contributed income:Donations directed by individuals,CHASE ENDING IN 5315,$10.00 ,"$1,076,145.38 "
CHASE ENDING IN 5315,9/9/23,Deposit,--,02 GENERAL BANK URESTR,Zelle payment from AZAMAT SHARIPOV TDP0HXW12S0G,CHASE ENDING IN 5315,Donations directed by individuals,$10.00 ,"$1,076,155.38 "
Donations directed by individuals,9/9/23,Deposit,--,02 GENERAL BANK URESTR,Zelle payment from AZAMAT SHARIPOV TDP0HXW12S0G,Contributed income:Donations directed by individuals,CHASE ENDING IN 5315,$10.00 ,"$1,076,165.38 "
CHASE ENDING IN 5315,9/9/23,Deposit,--,02 GENERAL BANK URESTR,Zelle payment from ELISSA LIPOVETSKIY XXXXXXX6536,CHASE ENDING IN 5315,Donations directed by individuals,$10.00 ,"$1,076,175.38 "
Donations directed by individuals,9/9/23,Deposit,--,02 GENERAL BANK URESTR,Zelle payment from ELISSA LIPOVETSKIY XXXXXXX6536,Contributed income:Donations directed by individuals,CHASE ENDING IN 5315,$10.00 ,"$1,076,185.38 "
CHASE ENDING IN 5315,9/9/23,Deposit,--,02 GENERAL BANK URESTR,Zelle payment from IANA DENYSENKO XXXXXXX4804,CHASE ENDING IN 5315,Donations directed by individuals,$40.00 ,"$1,076,225.38 "
Donations directed by individuals,9/9/23,Deposit,--,02 GENERAL BANK URESTR,Zelle payment from IANA DENYSENKO XXXXXXX4804,Contributed income:Donations directed by individuals,CHASE ENDING IN 5315,$40.00 ,"$1,076,265.38 "
CHASE ENDING IN 5315,9/9/23,Deposit,--,02 GENERAL BANK URESTR,Zelle payment from NATALIIA VASYLETS BACmn0ulalmu,CHASE ENDING IN 5315,Donations directed by individuals,$40.00 ,"$1,076,305.38 "
Donations directed by individuals,9/9/23,Deposit,--,02 GENERAL BANK URESTR,Zelle payment from NATALIIA VASYLETS BACmn0ulalmu,Contributed income:Donations directed by individuals,CHASE ENDING IN 5315,$40.00 ,"$1,076,345.38 "
TRANSFER-ADJUSTMENTS,9/9/23,Journal Entry,14,--,--,Contributed income:TRANSFER-ADJUSTMENTS,--,"$2,912.81 ","$1,079,258.19 "
TRANSFER-ADJUSTMENTS,9/9/23,Journal Entry,14,--,--,Contributed income:TRANSFER-ADJUSTMENTS,--,"($2,912.81)","$1,076,345.38 "
PayPal Fees,9/9/23,Journal Entry,14,--,--,OFFICE/GENERAL ADMINISTRATIVE EXPENSES:PayPal Fees,--,($87.19),"$1,076,258.19 "
PayPal Fees,9/9/23,Journal Entry,14,--,--,OFFICE/GENERAL ADMINISTRATIVE EXPENSES:PayPal Fees,--,$87.19 ,"$1,076,345.38 "
CHASE ENDING IN 5315,9/6/23,Deposit,--,02 GENERAL BANK URESTR,Zelle payment from NATALIIA LOMAKINA BACdro9mysjt,CHASE ENDING IN 5315,Donations directed by individuals,$500.00 ,"$1,076,845.38 "
Donations directed by individuals,9/6/23,Deposit,--,02 GENERAL BANK URESTR,Zelle payment from NATALIIA LOMAKINA BACdro9mysjt,Contributed income:Donations directed by individuals,CHASE ENDING IN 5315,$500.00 ,"$1,077,345.38 "
CHASE ENDING IN 5315,9/2/23,Deposit,--,02 GENERAL BANK URESTR,Zelle payment from OLENA STADNYUK CTIsfnB3sawV,CHASE ENDING IN 5315,Donations directed by individuals,"$1,000.00 ","$1,078,345.38 "
Donations directed by individuals,9/2/23,Deposit,--,02 GENERAL BANK URESTR,Zelle payment from OLENA STADNYUK CTIsfnB3sawV,Contributed income:Donations directed by individuals,CHASE ENDING IN 5315,"$1,000.00 ","$1,079,345.38 "
CHASE ENDING IN 5315,9/1/23,Deposit,--,02 GENERAL BANK URESTR,Zelle payment from ELLEN BEDENKO WFCT0R7NXZ2Z,CHASE ENDING IN 5315,Donations directed by individuals,$10.00 ,"$1,079,355.38 "
Donations directed by individuals,9/1/23,Deposit,--,02 GENERAL BANK URESTR,Zelle payment from ELLEN BEDENKO WFCT0R7NXZ2Z,Contributed income:Donations directed by individuals,CHASE ENDING IN 5315,$10.00 ,"$1,079,365.38 "
CHASE ENDING IN 5315,9/1/23,Deposit,--,02 GENERAL BANK URESTR,Zelle payment from VYACHESLAV SHPIGEL BACd3fgrxrf9,CHASE ENDING IN 5315,Donations directed by individuals,$555.00 ,"$1,079,920.38 "
Donations directed by individuals,9/1/23,Deposit,--,02 GENERAL BANK URESTR,Zelle payment from VYACHESLAV SHPIGEL BACd3fgrxrf9,Contributed income:Donations directed by individuals,CHASE ENDING IN 5315,$555.00 ,"$1,080,475.38 "
In-kind donations,8/31/23,Journal Entry,9,--,A.BOYCHUK AMAZON WISH LIST,Contributed income:In-kind donations,--,$17.47 ,"$1,080,492.85 "
IN-KIND DONATION DISTRIBUTIONS,8/31/23,Journal Entry,9,--,A.BOYCHUK AMAZON WISH LIST,PROGRAM EXPENSES:IN-KIND DONATION DISTRIBUTIONS,--,$17.47 ,"$1,080,510.32 "
In-kind donations,8/31/23,Journal Entry,10,--,A.BOYCHUK AMAZON WISH LIST,Contributed income:In-kind donations,--,$711.20 ,"$1,081,221.52 "
IN-KIND DONATION DISTRIBUTIONS,8/31/23,Journal Entry,10,--,A.BOYCHUK AMAZON WISH LIST,PROGRAM EXPENSES:IN-KIND DONATION DISTRIBUTIONS,--,$711.20 ,"$1,081,932.72 "
CHASE ENDING IN 5315,8/30/23,Deposit,--,02 GENERAL BANK URESTR,"Zelle payment from KOTRA, INC BACmjnz48rsf",CHASE ENDING IN 5315,Donations directed by individuals,"$2,400.00 ","$1,084,332.72 "
Donations directed by individuals,8/30/23,Deposit,--,02 GENERAL BANK URESTR,"Zelle payment from KOTRA, INC BACmjnz48rsf",Contributed income:Donations directed by individuals,CHASE ENDING IN 5315,"$2,400.00 ","$1,086,732.72 "
CHASE ENDING IN 5315,8/28/23,Deposit,--,02 GENERAL BANK URESTR,Zelle payment from MARYANA YAREMKO BACb7b2alqu5,CHASE ENDING IN 5315,Donations directed by individuals,"$2,100.00 ","$1,088,832.72 "
Donations directed by individuals,8/28/23,Deposit,--,02 GENERAL BANK URESTR,Zelle payment from MARYANA YAREMKO BACb7b2alqu5,Contributed income:Donations directed by individuals,CHASE ENDING IN 5315,"$2,100.00 ","$1,090,932.72 "
CHASE ENDING IN 5315,8/27/23,Deposit,--,02 GENERAL BANK URESTR,Zelle payment from Motria Melnyk 2JM0HXJT5NOG,CHASE ENDING IN 5315,Donations directed by individuals,$200.00 ,"$1,091,132.72 "
Donations directed by individuals,8/27/23,Deposit,--,02 GENERAL BANK URESTR,Zelle payment from Motria Melnyk 2JM0HXJT5NOG,Contributed income:Donations directed by individuals,CHASE ENDING IN 5315,$200.00 ,"$1,091,332.72 "
CHASE ENDING IN 5315,8/27/23,Deposit,--,02 GENERAL BANK URESTR,Zelle payment from TETYANA SHAMARINA CTIndstdzxvj,CHASE ENDING IN 5315,Donations directed by individuals,$60.00 ,"$1,091,392.72 "
Donations directed by individuals,8/27/23,Deposit,--,02 GENERAL BANK URESTR,Zelle payment from TETYANA SHAMARINA CTIndstdzxvj,Contributed income:Donations directed by individuals,CHASE ENDING IN 5315,$60.00 ,"$1,091,452.72 "
CHASE ENDING IN 5315,8/27/23,Deposit,--,02 GENERAL BANK URESTR,Zelle payment from VIKTOR Y OCHKOVSKIY XXXXXXX5200,CHASE ENDING IN 5315,Donations directed by individuals,$750.00 ,"$1,092,202.72 "
Donations directed by individuals,8/27/23,Deposit,--,02 GENERAL BANK URESTR,Zelle payment from VIKTOR Y OCHKOVSKIY XXXXXXX5200,Contributed income:Donations directed by individuals,CHASE ENDING IN 5315,$750.00 ,"$1,092,952.72 "
CHASE ENDING IN 5315,8/26/23,Deposit,--,02 GENERAL BANK URESTR,Zelle payment from ALEXANDER BASHMAKOV BACbo0xxn97d,CHASE ENDING IN 5315,Donations directed by individuals,$60.00 ,"$1,093,012.72 "
Donations directed by individuals,8/26/23,Deposit,--,02 GENERAL BANK URESTR,Zelle payment from ALEXANDER BASHMAKOV BACbo0xxn97d,Contributed income:Donations directed by individuals,CHASE ENDING IN 5315,$60.00 ,"$1,093,072.72 "
CHASE ENDING IN 5315,8/25/23,Deposit,1,02 GENERAL BANK URESTR,REMOTE ONLINE DEPOSIT # 1,CHASE ENDING IN 5315,Donations directed by individuals,"$10,000.00 ","$1,103,072.72 "
Donations directed by individuals,8/25/23,Deposit,1,02 GENERAL BANK URESTR,REMOTE ONLINE DEPOSIT # 1,Contributed income:Donations directed by individuals,CHASE ENDING IN 5315,"$10,000.00 ","$1,113,072.72 "
CHASE ENDING IN 5315,8/23/23,Deposit,--,02 GENERAL BANK URESTR,Zelle payment from VIKTORIYA SUKMANOVA BAClia4gplcq,CHASE ENDING IN 5315,Donations directed by individuals,"$3,500.00 ","$1,116,572.72 "
Donations directed by individuals,8/23/23,Deposit,--,02 GENERAL BANK URESTR,Zelle payment from VIKTORIYA SUKMANOVA BAClia4gplcq,Contributed income:Donations directed by individuals,CHASE ENDING IN 5315,"$3,500.00 ","$1,120,072.72 "
CHASE ENDING IN 5315,8/22/23,Deposit,--,02 GENERAL BANK URESTR,DEPOSIT ID NUMBER XX7732,CHASE ENDING IN 5315,Donations directed by individuals,"$10,000.00 ","$1,130,072.72 "
Donations directed by individuals,8/22/23,Deposit,--,02 GENERAL BANK URESTR,DEPOSIT ID NUMBER XX7732,Contributed income:Donations directed by individuals,CHASE ENDING IN 5315,"$10,000.00 ","$1,140,072.72 "
PayPal Bank 3,8/21/23,Transfer,--,--,ORIG CO NAME:PAYPAL ORIG ID:PAYPALSDXX DESC DATE:XXXXXX CO ENTRY DESCR:TRANSFER SEC:PPD TRACE#:XXXXXXXXXXXXXXX EED:XX0821 IND ID: IND NAME:DIGNITAS UKRAINE TRN: XXXXXX5448TC,PayPal Bank 3,CHASE ENDING IN 5315,"($6,000.00)","$1,134,072.72 "
CHASE ENDING IN 5315,8/21/23,Transfer,--,--,ORIG CO NAME:PAYPAL ORIG ID:PAYPALSDXX DESC DATE:XXXXXX CO ENTRY DESCR:TRANSFER SEC:PPD TRACE#:XXXXXXXXXXXXXXX EED:XX0821 IND ID: IND NAME:DIGNITAS UKRAINE TRN: XXXXXX5448TC,CHASE ENDING IN 5315,PayPal Bank 3,"$6,000.00 ","$1,140,072.72 "
CHASE ENDING IN 5315,8/21/23,Deposit,--,02 GENERAL BANK URESTR,Zelle payment from Lesia Semenova ALB0HXCPSN8K,CHASE ENDING IN 5315,Donations directed by individuals,$300.00 ,"$1,140,372.72 "
Donations directed by individuals,8/21/23,Deposit,--,02 GENERAL BANK URESTR,Zelle payment from Lesia Semenova ALB0HXCPSN8K,Contributed income:Donations directed by individuals,CHASE ENDING IN 5315,$300.00 ,"$1,140,672.72 "
CHASE ENDING IN 5315,8/19/23,Deposit,--,02 GENERAL BANK URESTR,Zelle payment from ELLEN BEDENKO WFCT0RHHTYM8,CHASE ENDING IN 5315,Donations directed by individuals,$20.00 ,"$1,140,692.72 "
Donations directed by individuals,8/19/23,Deposit,--,02 GENERAL BANK URESTR,Zelle payment from ELLEN BEDENKO WFCT0RHHTYM8,Contributed income:Donations directed by individuals,CHASE ENDING IN 5315,$20.00 ,"$1,140,712.72 "
CHASE ENDING IN 5315,8/19/23,Deposit,--,02 GENERAL BANK URESTR,Zelle payment from OLEXANDR NESKIN BACppz6c7zq8,CHASE ENDING IN 5315,Donations directed by individuals,$100.00 ,"$1,140,812.72 "
Donations directed by individuals,8/19/23,Deposit,--,02 GENERAL BANK URESTR,Zelle payment from OLEXANDR NESKIN BACppz6c7zq8,Contributed income:Donations directed by individuals,CHASE ENDING IN 5315,$100.00 ,"$1,140,912.72 "
CHASE ENDING IN 5315,8/15/23,Deposit,--,02 GENERAL BANK URESTR,Zelle payment from Denys Dratsky COFEUI1PLRFM,CHASE ENDING IN 5315,Donations directed by individuals,$30.00 ,"$1,140,942.72 "
Donations directed by individuals,8/15/23,Deposit,--,02 GENERAL BANK URESTR,Zelle payment from Denys Dratsky COFEUI1PLRFM,Contributed income:Donations directed by individuals,CHASE ENDING IN 5315,$30.00 ,"$1,140,972.72 "
CHASE ENDING IN 5315,8/15/23,Expense,--,03 FUNDRASING EVENTS UNRESTR,Zelle payment to Dmitri Zakhalyavko XXXXXXX6142,CHASE ENDING IN 5315,--,($885.00),"$1,140,087.72 "
EVENTS PARTICIPATION EXPENSES,8/15/23,Expense,--,03 FUNDRASING EVENTS UNRESTR,Zelle payment to Dmitri Zakhalyavko  Sousivka  table Fee XXXXXXX6142,FUNDRAISING EVENTS:EVENTS PARTICIPATION EXPENSES,CHASE ENDING IN 5315,$285.00 ,"$1,140,372.72 "
Legal fees,8/15/23,Expense,--,03 FUNDRASING EVENTS UNRESTR,non-profit allication,OFFICE/GENERAL ADMINISTRATIVE EXPENSES:Legal fees,CHASE ENDING IN 5315,$600.00 ,"$1,140,972.72 "
CHASE ENDING IN 5315,8/14/23,Deposit,--,02 GENERAL BANK URESTR,"FEDWIRE CREDIT VIA: FIRST REPUBLIC BANK/XXXXXXXXX B/O: LUM FOUNDATION ATTENTION ROBERT GRANEW YORK-NY-X0013 REF: CHASE NYC/CTR/BNF=DIGNITAS UKRAINE INC ROSELLE PARK NJ XXXXX-XXXX US/A C-XXXXXXXXXXXX RFB=O/B FST REP BK S OBI=REF: DONATION BBI=/CHGS/USDX,X X/ IMAD: XXXXMMQFMPRNXXXXXX TRN: XXXXXX0226FF",CHASE ENDING IN 5315,Donations directed by individuals,"$250,000.00 ","$1,390,972.72 "
Donations directed by individuals,8/14/23,Deposit,--,02 GENERAL BANK URESTR,"FEDWIRE CREDIT VIA: FIRST REPUBLIC BANK/XXXXXXXXX B/O: LUM FOUNDATION ATTENTION ROBERT GRANEW YORK-NY-X0013 REF: CHASE NYC/CTR/BNF=DIGNITAS UKRAINE INC ROSELLE PARK NJ XXXXX-XXXX US/A C-XXXXXXXXXXXX RFB=O/B FST REP BK S OBI=REF: DONATION BBI=/CHGS/USDX,X X/ IMAD: XXXXMMQFMPRNXXXXXX TRN: XXXXXX0226FF",Contributed income:Donations directed by individuals,CHASE ENDING IN 5315,"$250,000.00 ","$1,640,972.72 "
CHASE ENDING IN 5315,8/14/23,Check,--,CHASE BANK,DOMESTIC INCOMING WIRE FEE,CHASE ENDING IN 5315,Bank fees & service charges,($15.00),"$1,640,957.72 "
Bank fees & service charges,8/14/23,Check,--,CHASE BANK,DOMESTIC INCOMING WIRE FEE,OFFICE/GENERAL ADMINISTRATIVE EXPENSES:Bank fees & service charges,CHASE ENDING IN 5315,$15.00 ,"$1,640,972.72 "
CHASE ENDING IN 5315,8/14/23,Expense,--,QuickBooks Payments,ORIG CO NAME:INTUIT * ORIG ID:XXXXXXXXXX DESC DATE:XXXXXX CO ENTRY DESCR:QBooks OnlSEC:CCD TRACE#:XXXXXXXXXXXXXXX EED:XXXXXX IND ID:XXX9390 IND NAME:DIGNITAS UK RAINE INC XXX-XXX-XXXX TRN: XXXXXX5943TC,CHASE ENDING IN 5315,Software & apps,($42.50),"$1,640,930.22 "
Software & apps,8/14/23,Expense,--,QuickBooks Payments,ORIG CO NAME:INTUIT * ORIG ID:XXXXXXXXXX DESC DATE:XXXXXX CO ENTRY DESCR:QBooks OnlSEC:CCD TRACE#:XXXXXXXXXXXXXXX EED:XXXXXX IND ID:XXX9390 IND NAME:DIGNITAS UK RAINE INC XXX-XXX-XXXX TRN: XXXXXX5943TC,OFFICE/GENERAL ADMINISTRATIVE EXPENSES:Software & apps,CHASE ENDING IN 5315,$42.50 ,"$1,640,972.72 "
CHASE ENDING IN 5315,8/11/23,Deposit,--,02 GENERAL BANK URESTR,Zelle payment from DMITRY KOHMANYUK WFCT0RGWDFKH,CHASE ENDING IN 5315,Donations directed by individuals,$50.50 ,"$1,641,023.22 "
Donations directed by individuals,8/11/23,Deposit,--,02 GENERAL BANK URESTR,Zelle payment from DMITRY KOHMANYUK WFCT0RGWDFKH,Contributed income:Donations directed by individuals,CHASE ENDING IN 5315,$50.50 ,"$1,641,073.72 "
PayPal Bank 3,8/10/23,Transfer,--,--,ORIG CO NAME:PAYPAL ORIG ID:PAYPALSDXX DESC DATE:XXXXXX CO ENTRY DESCR:TRANSFER SEC:PPD TRACE#:XXXXXXXXXXXXXXX EED:XX0810 IND ID: IND NAME:DIGNITAS UKRAINE TRN: XXXXXX6011TC,PayPal Bank 3,CHASE ENDING IN 5315,"($3,000.00)","$1,638,073.72 "
CHASE ENDING IN 5315,8/10/23,Transfer,--,--,ORIG CO NAME:PAYPAL ORIG ID:PAYPALSDXX DESC DATE:XXXXXX CO ENTRY DESCR:TRANSFER SEC:PPD TRACE#:XXXXXXXXXXXXXXX EED:XX0810 IND ID: IND NAME:DIGNITAS UKRAINE TRN: XXXXXX6011TC,CHASE ENDING IN 5315,PayPal Bank 3,"$3,000.00 ","$1,641,073.72 "
CHASE ENDING IN 5315,8/10/23,Deposit,--,02 GENERAL BANK URESTR,Zelle payment from TETYANA SHAMARINA CTIRki6wt5G6,CHASE ENDING IN 5315,Donations directed by individuals,$100.00 ,"$1,641,173.72 "
Donations directed by individuals,8/10/23,Deposit,--,02 GENERAL BANK URESTR,Zelle payment from TETYANA SHAMARINA CTIRki6wt5G6,Contributed income:Donations directed by individuals,CHASE ENDING IN 5315,$100.00 ,"$1,641,273.72 "
CHASE ENDING IN 5315,8/10/23,Deposit,--,02 GENERAL BANK URESTR,"FEDWIRE CREDIT VIA: WELLS FARGO BANK, N.A./XXXXXXXXX B/O: SCHWAB CHARITABLE FUND SAN FRANCISCO CA X4105/US/REF: CHASE NYC/CTR/BNF=DIGNITAS UKRAINE INC ROSELLE P ARK NJ XXXXX-XXXX US/A C-XXXXXXXXXXXX RFB=XXXXXXXXXXXXX OB I=SCHWAB CHARITABLE FUND BBI=/CHGS/USDX,XX/CHGS/USDX,XX/OCMT/USDXXXXXX ,XX/ACC/SCHWAB C IMAD: XXXXIXBXXXXRXXXXXX TRN: XXXXXX0222FF",CHASE ENDING IN 5315,Donations directed by individuals,"$840,000.00 ","$2,481,273.72 "
Donations directed by individuals,8/10/23,Deposit,--,02 GENERAL BANK URESTR,"FEDWIRE CREDIT VIA: WELLS FARGO BANK, N.A./XXXXXXXXX B/O: SCHWAB CHARITABLE FUND SAN FRANCISCO CA X4105/US/REF: CHASE NYC/CTR/BNF=DIGNITAS UKRAINE INC ROSELLE P ARK NJ XXXXX-XXXX US/A C-XXXXXXXXXXXX RFB=XXXXXXXXXXXXX OB I=SCHWAB CHARITABLE FUND BBI=/CHGS/USDX,XX/CHGS/USDX,XX/OCMT/USDXXXXXX ,XX/ACC/SCHWAB C IMAD: XXXXIXBXXXXRXXXXXX TRN: XXXXXX0222FF",Contributed income:Donations directed by individuals,CHASE ENDING IN 5315,"$840,000.00 ","$3,321,273.72 "
CHASE ENDING IN 5315,8/10/23,Check,1007730,CHASE BANK,DOMESTIC INCOMING WIRE FEE,CHASE ENDING IN 5315,Bank fees & service charges,($15.00),"$3,321,258.72 "
Bank fees & service charges,8/10/23,Check,1007730,CHASE BANK,DOMESTIC INCOMING WIRE FEE,OFFICE/GENERAL ADMINISTRATIVE EXPENSES:Bank fees & service charges,CHASE ENDING IN 5315,$15.00 ,"$3,321,273.72 "
CHASE ENDING IN 5315,8/9/23,Check,5161,COLLEGIATE PRODUCTIONS,CHECK # 5161,CHASE ENDING IN 5315,SUPPLIES AND MATERIALS,"($1,650.60)","$3,319,623.12 "
SUPPLIES AND MATERIALS,8/9/23,Check,5161,COLLEGIATE PRODUCTIONS,CHECK # 5161,FUNDRAISING EVENTS:SUPPLIES AND MATERIALS,CHASE ENDING IN 5315,"$1,650.60 ","$3,321,273.72 "
PayPal Bank 3,8/8/23,Transfer,--,--,ORIG CO NAME:PAYPAL ORIG ID:PAYPALSDXX DESC DATE:XXXXXX CO ENTRY DESCR:TRANSFER SEC:PPD TRACE#:XXXXXXXXXXXXXXX EED:XX0808 IND ID: IND NAME:DIGNITAS UKRAINE TRN: XXXXXX5564TC,PayPal Bank 3,CHASE ENDING IN 5315,"($6,400.00)","$3,314,873.72 "
CHASE ENDING IN 5315,8/8/23,Transfer,--,--,ORIG CO NAME:PAYPAL ORIG ID:PAYPALSDXX DESC DATE:XXXXXX CO ENTRY DESCR:TRANSFER SEC:PPD TRACE#:XXXXXXXXXXXXXXX EED:XX0808 IND ID: IND NAME:DIGNITAS UKRAINE TRN: XXXXXX5564TC,CHASE ENDING IN 5315,PayPal Bank 3,"$6,400.00 ","$3,321,273.72 "
PayPal Bank 3,7/31/23,Transfer,--,--,ORIG CO NAME:PAYPAL ORIG ID:PAYPALSDXX DESC DATE:XXXXXX CO ENTRY DESCR:TRANSFER SEC:PPD TRACE#:XXXXXXXXXXXXXXX EED:XX0731 IND ID: IND NAME:DIGNITAS UKRAINE TRN: XXXXXX6563TC,PayPal Bank 3,CHASE ENDING IN 5315,"($9,600.00)","$3,311,673.72 "
CHASE ENDING IN 5315,7/31/23,Transfer,--,--,ORIG CO NAME:PAYPAL ORIG ID:PAYPALSDXX DESC DATE:XXXXXX CO ENTRY DESCR:TRANSFER SEC:PPD TRACE#:XXXXXXXXXXXXXXX EED:XX0731 IND ID: IND NAME:DIGNITAS UKRAINE TRN: XXXXXX6563TC,CHASE ENDING IN 5315,PayPal Bank 3,"$9,600.00 ","$3,321,273.72 "
In-kind donations,7/31/23,Journal Entry,12,--,A.BOYCHUK AMAZON WISH LIST,Contributed income:In-kind donations,--,$434.98 ,"$3,321,708.70 "
IN-KIND DONATION DISTRIBUTIONS,7/31/23,Journal Entry,12,--,A.BOYCHUK AMAZON WISH LIST,PROGRAM EXPENSES:IN-KIND DONATION DISTRIBUTIONS,--,$434.98 ,"$3,322,143.68 "
CHASE ENDING IN 5315,7/30/23,Deposit,--,02 GENERAL BANK URESTR,Zelle payment from Denys Dratsky COF3MG2E3DZ3,CHASE ENDING IN 5315,Donations directed by individuals,$30.00 ,"$3,322,173.68 "
Donations directed by individuals,7/30/23,Deposit,--,02 GENERAL BANK URESTR,Zelle payment from Denys Dratsky COF3MG2E3DZ3,Contributed income:Donations directed by individuals,CHASE ENDING IN 5315,$30.00 ,"$3,322,203.68 "
CHASE ENDING IN 5315,7/27/23,Deposit,--,02 GENERAL BANK URESTR,Zelle payment from OLGA STOKOLOSA BACbpea12b9f,CHASE ENDING IN 5315,Donations directed by individuals,$505.00 ,"$3,322,708.68 "
Donations directed by individuals,7/27/23,Deposit,--,02 GENERAL BANK URESTR,Zelle payment from OLGA STOKOLOSA BACbpea12b9f,Contributed income:Donations directed by individuals,CHASE ENDING IN 5315,$505.00 ,"$3,323,213.68 "
PayPal Bank 3,7/27/23,Deposit,--,04 PAYPAL GENERAL UNRESTR,--,PayPal Bank 3,Donations directed by individuals,$128.13 ,"$3,323,341.81 "
Donations directed by individuals,7/27/23,Deposit,--,04 PAYPAL GENERAL UNRESTR,--,Contributed income:Donations directed by individuals,PayPal Bank 3,$128.13 ,"$3,323,469.94 "
PayPal Bank 3,7/24/23,Transfer,--,--,ORIG CO NAME:PAYPAL ORIG ID:PAYPALSDXX DESC DATE:XXXXXX CO ENTRY DESCR:TRANSFER SEC:PPD TRACE#:XXXXXXXXXXXXXXX EED:XX0724 IND ID: IND NAME:DIGNITAS UKRAINE TRN: XXXXXX9382TC,PayPal Bank 3,CHASE ENDING IN 5315,"($5,000.00)","$3,318,469.94 "
CHASE ENDING IN 5315,7/24/23,Transfer,--,--,ORIG CO NAME:PAYPAL ORIG ID:PAYPALSDXX DESC DATE:XXXXXX CO ENTRY DESCR:TRANSFER SEC:PPD TRACE#:XXXXXXXXXXXXXXX EED:XX0724 IND ID: IND NAME:DIGNITAS UKRAINE TRN: XXXXXX9382TC,CHASE ENDING IN 5315,PayPal Bank 3,"$5,000.00 ","$3,323,469.94 "
CHASE ENDING IN 5315,7/24/23,Deposit,--,02 GENERAL BANK URESTR,Zelle payment from ROMANIIA VOITYSHYN XXXXXXX6393,CHASE ENDING IN 5315,Donations directed by individuals,$20.00 ,"$3,323,489.94 "
Donations directed by individuals,7/24/23,Deposit,--,02 GENERAL BANK URESTR,Zelle payment from ROMANIIA VOITYSHYN XXXXXXX6393,Contributed income:Donations directed by individuals,CHASE ENDING IN 5315,$20.00 ,"$3,323,509.94 "
CHASE ENDING IN 5315,7/24/23,Deposit,--,02 GENERAL BANK URESTR,Zelle payment from YULIIA LAZORYSHYN XXXXXXX7752,CHASE ENDING IN 5315,Donations directed by individuals,$20.00 ,"$3,323,529.94 "
Donations directed by individuals,7/24/23,Deposit,--,02 GENERAL BANK URESTR,Zelle payment from YULIIA LAZORYSHYN XXXXXXX7752,Contributed income:Donations directed by individuals,CHASE ENDING IN 5315,$20.00 ,"$3,323,549.94 "
CHASE ENDING IN 5315,7/22/23,Deposit,--,05 VENMO UNRESTR,ORIG CO NAME:VENMO ORIG ID:XXXXXXXXXX DESC DATE:XXXXXX CO ENTRY DESCR:CASHOUT SEC:PPD TRACE#:XXXXXXXXXXXXXXX EED:XXXXX4 IND ID: IND NAME:OKSANA PATRINA TRN: 205 XXX0438TC,CHASE ENDING IN 5315,Donations directed by individuals,$146.95 ,"$3,323,696.89 "
Donations directed by individuals,7/22/23,Deposit,--,05 VENMO UNRESTR,ORIG CO NAME:VENMO ORIG ID:XXXXXXXXXX DESC DATE:XXXXXX CO ENTRY DESCR:CASHOUT SEC:PPD TRACE#:XXXXXXXXXXXXXXX EED:XXXXX4 IND ID: IND NAME:OKSANA PATRINA TRN: 205 XXX0438TC,Contributed income:Donations directed by individuals,CHASE ENDING IN 5315,$146.95 ,"$3,323,843.84 "
PayPal Bank 3,7/18/23,Transfer,--,--,ORIG CO NAME:PAYPAL ORIG ID:PAYPALSDXX DESC DATE:XXXXXX CO ENTRY DESCR:TRANSFER SEC:PPD TRACE#:XXXXXXXXXXXXXXX EED:XX0718 IND ID: IND NAME:DIGNITAS UKRAINE TRN: XXXXXX3375TC,PayPal Bank 3,CHASE ENDING IN 5315,"($2,000.00)","$3,321,843.84 "
CHASE ENDING IN 5315,7/18/23,Transfer,--,--,ORIG CO NAME:PAYPAL ORIG ID:PAYPALSDXX DESC DATE:XXXXXX CO ENTRY DESCR:TRANSFER SEC:PPD TRACE#:XXXXXXXXXXXXXXX EED:XX0718 IND ID: IND NAME:DIGNITAS UKRAINE TRN: XXXXXX3375TC,CHASE ENDING IN 5315,PayPal Bank 3,"$2,000.00 ","$3,323,843.84 "
CHASE ENDING IN 5315,7/18/23,Deposit,--,05 VENMO UNRESTR,ORIG CO NAME:VENMO ORIG ID:XXXXXXXXXX DESC DATE:XXXXXX CO ENTRY DESCR:CASHOUT SEC:PPD TRACE#:XXXXXXXXXXXXXXX EED:XXXXX8 IND ID: IND NAME:OKSANA PATRINA TRN: 199 XXX5739TC,CHASE ENDING IN 5315,Donations directed by individuals,$141.85 ,"$3,323,985.69 "
Donations directed by individuals,7/18/23,Deposit,--,05 VENMO UNRESTR,ORIG CO NAME:VENMO ORIG ID:XXXXXXXXXX DESC DATE:XXXXXX CO ENTRY DESCR:CASHOUT SEC:PPD TRACE#:XXXXXXXXXXXXXXX EED:XXXXX8 IND ID: IND NAME:OKSANA PATRINA TRN: 199 XXX5739TC,Contributed income:Donations directed by individuals,CHASE ENDING IN 5315,$141.85 ,"$3,324,127.54 "
PayPal Bank 3,7/17/23,Transfer,--,--,ORIG CO NAME:PAYPAL ORIG ID:PAYPALSDXX DESC DATE:XXXXXX CO ENTRY DESCR:TRANSFER SEC:PPD TRACE#:XXXXXXXXXXXXXXX EED:XX0717 IND ID: IND NAME:DIGNITAS UKRAINE TRN: XXXXXX5964TC,PayPal Bank 3,CHASE ENDING IN 5315,"($6,000.00)","$3,318,127.54 "
CHASE ENDING IN 5315,7/17/23,Transfer,--,--,ORIG CO NAME:PAYPAL ORIG ID:PAYPALSDXX DESC DATE:XXXXXX CO ENTRY DESCR:TRANSFER SEC:PPD TRACE#:XXXXXXXXXXXXXXX EED:XX0717 IND ID: IND NAME:DIGNITAS UKRAINE TRN: XXXXXX5964TC,CHASE ENDING IN 5315,PayPal Bank 3,"$6,000.00 ","$3,324,127.54 "
CHASE ENDING IN 5315,7/15/23,Deposit,--,02 GENERAL BANK URESTR,Zelle payment from ANDRII SHUMYLO BACc5qt3q28e,CHASE ENDING IN 5315,Donations directed by individuals,$20.00 ,"$3,324,147.54 "
Donations directed by individuals,7/15/23,Deposit,--,02 GENERAL BANK URESTR,Zelle payment from ANDRII SHUMYLO BACc5qt3q28e,Contributed income:Donations directed by individuals,CHASE ENDING IN 5315,$20.00 ,"$3,324,167.54 "
CHASE ENDING IN 5315,7/15/23,Deposit,--,02 GENERAL BANK URESTR,Zelle payment from MYKOLA KOLOMIICHUK JXYtX009Ou5v,CHASE ENDING IN 5315,Donations directed by individuals,$100.00 ,"$3,324,267.54 "
Donations directed by individuals,7/15/23,Deposit,--,02 GENERAL BANK URESTR,Zelle payment from MYKOLA KOLOMIICHUK JXYtX009Ou5v,Contributed income:Donations directed by individuals,CHASE ENDING IN 5315,$100.00 ,"$3,324,367.54 "
CHASE ENDING IN 5315,7/15/23,Deposit,--,02 GENERAL BANK URESTR,Zelle payment from OLHA ZARICHYNSKA XM10FBFC4Q7P,CHASE ENDING IN 5315,Donations directed by individuals,$10.00 ,"$3,324,377.54 "
Donations directed by individuals,7/15/23,Deposit,--,02 GENERAL BANK URESTR,Zelle payment from OLHA ZARICHYNSKA XM10FBFC4Q7P,Contributed income:Donations directed by individuals,CHASE ENDING IN 5315,$10.00 ,"$3,324,387.54 "
CHASE ENDING IN 5315,7/8/23,Deposit,--,02 GENERAL BANK URESTR,Zelle payment from VIKTOR Y OCHKOVSKIY XXXXXXX4383,CHASE ENDING IN 5315,Donations directed by individuals,$750.00 ,"$3,325,137.54 "
Donations directed by individuals,7/8/23,Deposit,--,02 GENERAL BANK URESTR,Zelle payment from VIKTOR Y OCHKOVSKIY XXXXXXX4383,Contributed income:Donations directed by individuals,CHASE ENDING IN 5315,$750.00 ,"$3,325,887.54 "
PayPal Bank 3,7/5/23,Transfer,--,--,ORIG CO NAME:PAYPAL ORIG ID:PAYPALSDXX DESC DATE:XXXXXX CO ENTRY DESCR:TRANSFER SEC:PPD TRACE#:XXXXXXXXXXXXXXX EED:XX0705 IND ID: IND NAME:DIGNITAS UKRAINE TRN: XXXXXX5882TC,PayPal Bank 3,CHASE ENDING IN 5315,"($7,000.00)","$3,318,887.54 "
CHASE ENDING IN 5315,7/5/23,Transfer,--,--,ORIG CO NAME:PAYPAL ORIG ID:PAYPALSDXX DESC DATE:XXXXXX CO ENTRY DESCR:TRANSFER SEC:PPD TRACE#:XXXXXXXXXXXXXXX EED:XX0705 IND ID: IND NAME:DIGNITAS UKRAINE TRN: XXXXXX5882TC,CHASE ENDING IN 5315,PayPal Bank 3,"$7,000.00 ","$3,325,887.54 "
CHASE ENDING IN 5315,7/1/23,Deposit,--,02 GENERAL BANK URESTR,Zelle payment from OLENA PAZDERSKA XXXXXXX9704,CHASE ENDING IN 5315,Donations directed by individuals,$20.00 ,"$3,325,907.54 "
Donations directed by individuals,7/1/23,Deposit,--,02 GENERAL BANK URESTR,Zelle payment from OLENA PAZDERSKA XXXXXXX9704,Contributed income:Donations directed by individuals,CHASE ENDING IN 5315,$20.00 ,"$3,325,927.54 "
CHASE ENDING IN 5315,7/1/23,Deposit,--,02 GENERAL BANK URESTR,Zelle payment from VITALIY VYKHOVANETS XXXXXXX8270,CHASE ENDING IN 5315,Donations directed by individuals,$20.00 ,"$3,325,947.54 "
Donations directed by individuals,7/1/23,Deposit,--,02 GENERAL BANK URESTR,Zelle payment from VITALIY VYKHOVANETS XXXXXXX8270,Contributed income:Donations directed by individuals,CHASE ENDING IN 5315,$20.00 ,"$3,325,967.54 "
PayPal Bank 3,7/1/23,Deposit,--,04 PAYPAL GENERAL UNRESTR,--,PayPal Bank 3,Donations directed by individuals,$77.20 ,"$3,326,044.74 "
Donations directed by individuals,7/1/23,Deposit,--,04 PAYPAL GENERAL UNRESTR,--,Contributed income:Donations directed by individuals,PayPal Bank 3,$77.20 ,"$3,326,121.94 "
CHASE ENDING IN 5315,6/30/23,Deposit,--,02 GENERAL BANK URESTR,Zelle payment from BOHDAN TKACHENKO BACqojfhof47,CHASE ENDING IN 5315,Donations directed by individuals,$60.00 ,"$3,326,181.94 "
Donations directed by individuals,6/30/23,Deposit,--,02 GENERAL BANK URESTR,Zelle payment from BOHDAN TKACHENKO BACqojfhof47,Contributed income:Donations directed by individuals,CHASE ENDING IN 5315,$60.00 ,"$3,326,241.94 "
In-kind donations,6/30/23,Journal Entry,8,--,A.BOYCHUK AMAZON WISH LIST,Contributed income:In-kind donations,--,$223.82 ,"$3,326,465.76 "
IN-KIND DONATION DISTRIBUTIONS,6/30/23,Journal Entry,8,--,A.BOYCHUK AMAZON WISH LIST,PROGRAM EXPENSES:IN-KIND DONATION DISTRIBUTIONS,--,$223.82 ,"$3,326,689.58 "
CHASE ENDING IN 5315,6/29/23,Expense,--,03 FUNDRASING EVENTS UNRESTR,Zelle payment to Maryna Akatova XXXXXXX8391,CHASE ENDING IN 5315,LODGING,($754.77),"$3,325,934.81 "
LODGING,6/29/23,Expense,--,03 FUNDRASING EVENTS UNRESTR,Zelle payment to Maryna Akatova XXXXXXX8391,FUNDRAISING EVENTS:LODGING,CHASE ENDING IN 5315,$754.77 ,"$3,326,689.58 "
PayPal Bank 3,6/28/23,Transfer,--,--,ORIG CO NAME:PAYPAL ORIG ID:PAYPALSDXX DESC DATE:XXXXXX CO ENTRY DESCR:TRANSFER SEC:PPD TRACE#:XXXXXXXXXXXXXXX EED:XX0628 IND ID: IND NAME:DIGNITAS UKRAINE TRN: XXXXXX6831TC,PayPal Bank 3,CHASE ENDING IN 5315,"($3,000.00)","$3,323,689.58 "
CHASE ENDING IN 5315,6/28/23,Transfer,--,--,ORIG CO NAME:PAYPAL ORIG ID:PAYPALSDXX DESC DATE:XXXXXX CO ENTRY DESCR:TRANSFER SEC:PPD TRACE#:XXXXXXXXXXXXXXX EED:XX0628 IND ID: IND NAME:DIGNITAS UKRAINE TRN: XXXXXX6831TC,CHASE ENDING IN 5315,PayPal Bank 3,"$3,000.00 ","$3,326,689.58 "
PayPal Bank 3,6/26/23,Transfer,--,--,ORIG CO NAME:PAYPAL ORIG ID:PAYPALSDXX DESC DATE:XXXXXX CO ENTRY DESCR:TRANSFER SEC:PPD TRACE#:XXXXXXXXXXXXXXX EED:XX0626 IND ID: IND NAME:DIGNITAS UKRAINE TRN: XXXXXX9521TC,PayPal Bank 3,CHASE ENDING IN 5315,"($3,000.00)","$3,323,689.58 "
CHASE ENDING IN 5315,6/26/23,Transfer,--,--,ORIG CO NAME:PAYPAL ORIG ID:PAYPALSDXX DESC DATE:XXXXXX CO ENTRY DESCR:TRANSFER SEC:PPD TRACE#:XXXXXXXXXXXXXXX EED:XX0626 IND ID: IND NAME:DIGNITAS UKRAINE TRN: XXXXXX9521TC,CHASE ENDING IN 5315,PayPal Bank 3,"$3,000.00 ","$3,326,689.58 "
PayPal Bank 3,6/26/23,Deposit,--,04 PAYPAL GENERAL UNRESTR,--,PayPal Bank 3,Donations directed by individuals,$58.75 ,"$3,326,748.33 "
Donations directed by individuals,6/26/23,Deposit,--,04 PAYPAL GENERAL UNRESTR,--,Contributed income:Donations directed by individuals,PayPal Bank 3,$58.75 ,"$3,326,807.08 "
CHASE ENDING IN 5315,6/24/23,Deposit,--,02 GENERAL BANK URESTR,Zelle payment from LADA BIDIAK XXXXXXX0259,CHASE ENDING IN 5315,Donations directed by individuals,$40.00 ,"$3,326,847.08 "
Donations directed by individuals,6/24/23,Deposit,--,02 GENERAL BANK URESTR,Zelle payment from LADA BIDIAK XXXXXXX0259,Contributed income:Donations directed by individuals,CHASE ENDING IN 5315,$40.00 ,"$3,326,887.08 "
CHASE ENDING IN 5315,6/24/23,Deposit,--,02 GENERAL BANK URESTR,Zelle payment from VIKTOR Y OCHKOVSKIY XXXXXXX7752,CHASE ENDING IN 5315,Donations directed by individuals,$500.00 ,"$3,327,387.08 "
Donations directed by individuals,6/24/23,Deposit,--,02 GENERAL BANK URESTR,Zelle payment from VIKTOR Y OCHKOVSKIY XXXXXXX7752,Contributed income:Donations directed by individuals,CHASE ENDING IN 5315,$500.00 ,"$3,327,887.08 "
CHASE ENDING IN 5315,6/23/23,Deposit,--,02 GENERAL BANK URESTR,Zelle payment from LADA BIDIAK XXXXXXX6104,CHASE ENDING IN 5315,Donations directed by individuals,$80.00 ,"$3,327,967.08 "
Donations directed by individuals,6/23/23,Deposit,--,02 GENERAL BANK URESTR,Zelle payment from LADA BIDIAK XXXXXXX6104,Contributed income:Donations directed by individuals,CHASE ENDING IN 5315,$80.00 ,"$3,328,047.08 "
CHASE ENDING IN 5315,6/23/23,Expense,--,03 FUNDRASING EVENTS UNRESTR,Zelle payment to Mykola Omelchenko JPM999ycchw4,CHASE ENDING IN 5315,TRANSPORTATION AND PARKING,($589.55),"$3,327,457.53 "
TRANSPORTATION AND PARKING,6/23/23,Expense,--,03 FUNDRASING EVENTS UNRESTR,Zelle payment to Mykola Omelchenko JPM999ycchw4,FUNDRAISING EVENTS:TRANSPORTATION AND PARKING,CHASE ENDING IN 5315,$589.55 ,"$3,328,047.08 "
CHASE ENDING IN 5315,6/21/23,Deposit,--,03 FUNDRASING EVENTS UNRESTR,DEPOSIT ID NUMBER XX1111,CHASE ENDING IN 5315,Donations directed by individuals,"$3,456.00 ","$3,331,503.08 "
Donations directed by individuals,6/21/23,Deposit,--,03 FUNDRASING EVENTS UNRESTR,DEPOSIT ID NUMBER XX1111,Contributed income:Donations directed by individuals,CHASE ENDING IN 5315,"$3,456.00 ","$3,334,959.08 "
CHASE ENDING IN 5315,6/21/23,Expense,--,CHASE BANK,ORIG CO NAME:CHECK OR SUPPLY ORIG ID:XXXXXXXXXX DESC DATE:XXXXXX CO ENTRY DESCR:ORDER SEC:PPD TRACE#:XXXXXXXXXXXXXXX EED:XX0621 IND ID: IND NAME:DIGNITAS UKRAIN E INC TRN: XXXXXX4793TC,CHASE ENDING IN 5315,Supplies & materials,($20.00),"$3,334,939.08 "
Supplies & materials,6/21/23,Expense,--,CHASE BANK,ORIG CO NAME:CHECK OR SUPPLY ORIG ID:XXXXXXXXXX DESC DATE:XXXXXX CO ENTRY DESCR:ORDER SEC:PPD TRACE#:XXXXXXXXXXXXXXX EED:XX0621 IND ID: IND NAME:DIGNITAS UKRAIN E INC TRN: XXXXXX4793TC,OFFICE/GENERAL ADMINISTRATIVE EXPENSES:Supplies & materials,CHASE ENDING IN 5315,$20.00 ,"$3,334,959.08 "
CHASE ENDING IN 5315,6/18/23,Deposit,--,02 GENERAL BANK URESTR,Zelle payment from ANATOLIY LYTVYNIV XXXXXXX3468,CHASE ENDING IN 5315,Donations directed by individuals,$200.00 ,"$3,335,159.08 "
Donations directed by individuals,6/18/23,Deposit,--,02 GENERAL BANK URESTR,Zelle payment from ANATOLIY LYTVYNIV XXXXXXX3468,Contributed income:Donations directed by individuals,CHASE ENDING IN 5315,$200.00 ,"$3,335,359.08 "
CHASE ENDING IN 5315,6/17/23,Deposit,--,02 GENERAL BANK URESTR,Zelle payment from ANNA MASLOVA XXXXXXX0972,CHASE ENDING IN 5315,Donations directed by individuals,$5.00 ,"$3,335,364.08 "
Donations directed by individuals,6/17/23,Deposit,--,02 GENERAL BANK URESTR,Zelle payment from ANNA MASLOVA XXXXXXX0972,Contributed income:Donations directed by individuals,CHASE ENDING IN 5315,$5.00 ,"$3,335,369.08 "
CHASE ENDING IN 5315,6/17/23,Deposit,--,02 GENERAL BANK URESTR,Zelle payment from Mary Shmotolocha COF2W89OWJYB,CHASE ENDING IN 5315,Donations directed by individuals,$100.00 ,"$3,335,469.08 "
Donations directed by individuals,6/17/23,Deposit,--,02 GENERAL BANK URESTR,Zelle payment from Mary Shmotolocha COF2W89OWJYB,Contributed income:Donations directed by individuals,CHASE ENDING IN 5315,$100.00 ,"$3,335,569.08 "
CHASE ENDING IN 5315,6/17/23,Deposit,--,02 GENERAL BANK URESTR,Zelle payment from MYKOLA KOLOMIICHUK JXYDXX09b54a,CHASE ENDING IN 5315,Donations directed by individuals,$80.00 ,"$3,335,649.08 "
Donations directed by individuals,6/17/23,Deposit,--,02 GENERAL BANK URESTR,Zelle payment from MYKOLA KOLOMIICHUK JXYDXX09b54a,Contributed income:Donations directed by individuals,CHASE ENDING IN 5315,$80.00 ,"$3,335,729.08 "
PayPal Bank 3,6/15/23,Transfer,--,--,ORIG CO NAME:PAYPAL ORIG ID:PAYPALSDXX DESC DATE:XXXXXX CO ENTRY DESCR:TRANSFER SEC:PPD TRACE#:XXXXXXXXXXXXXXX EED:XX0615 IND ID: IND NAME:DIGNITAS UKRAINE TRN: XXXXXX1077TC,PayPal Bank 3,CHASE ENDING IN 5315,"($5,000.00)","$3,330,729.08 "
CHASE ENDING IN 5315,6/15/23,Transfer,--,--,ORIG CO NAME:PAYPAL ORIG ID:PAYPALSDXX DESC DATE:XXXXXX CO ENTRY DESCR:TRANSFER SEC:PPD TRACE#:XXXXXXXXXXXXXXX EED:XX0615 IND ID: IND NAME:DIGNITAS UKRAINE TRN: XXXXXX1077TC,CHASE ENDING IN 5315,PayPal Bank 3,"$5,000.00 ","$3,335,729.08 "
CHASE ENDING IN 5315,6/14/23,Check,5160,COLLEGIATE PRODUCTIONS,CHECK # XXXX 06/14,CHASE ENDING IN 5315,SUPPLIES AND MATERIALS,"($2,288.80)","$3,333,440.28 "
SUPPLIES AND MATERIALS,6/14/23,Check,5160,COLLEGIATE PRODUCTIONS,CHECK # XXXX 06/14,FUNDRAISING EVENTS:SUPPLIES AND MATERIALS,CHASE ENDING IN 5315,"$2,288.80 ","$3,335,729.08 "
CHASE ENDING IN 5315,6/14/23,Deposit,--,05 VENMO UNRESTR,ORIG CO NAME:VENMO ORIG ID:XXXXXXXXXX DESC DATE:XXXXXX CO ENTRY DESCR:CASHOUT SEC:PPD TRACE#:XXXXXXXXXXXXXXX EED:XXXXX4 IND ID: IND NAME:OKSANA PATRINA TRN: 165 XXX0408TC,CHASE ENDING IN 5315,Donations directed by individuals,$98.00 ,"$3,335,827.08 "
Donations directed by individuals,6/14/23,Deposit,--,05 VENMO UNRESTR,ORIG CO NAME:VENMO ORIG ID:XXXXXXXXXX DESC DATE:XXXXXX CO ENTRY DESCR:CASHOUT SEC:PPD TRACE#:XXXXXXXXXXXXXXX EED:XXXXX4 IND ID: IND NAME:OKSANA PATRINA TRN: 165 XXX0408TC,Contributed income:Donations directed by individuals,CHASE ENDING IN 5315,$98.00 ,"$3,335,925.08 "
CHASE ENDING IN 5315,6/12/23,Expense,--,03 FUNDRASING EVENTS UNRESTR,Zelle payment to Yuliya O'Connell XXXXXXX5387,CHASE ENDING IN 5315,--,"($1,081.06)","$3,334,844.02 "
SUPPLIES AND MATERIALS,6/12/23,Expense,--,03 FUNDRASING EVENTS UNRESTR,Zelle payment to Yuliya O'Connell XXXXXXX5387,FUNDRAISING EVENTS:SUPPLIES AND MATERIALS,CHASE ENDING IN 5315,$489.66 ,"$3,335,333.68 "
TRANSPORTATION AND PARKING,6/12/23,Expense,--,03 FUNDRASING EVENTS UNRESTR,Mykola Omelchenko St George plane tickets,FUNDRAISING EVENTS:TRANSPORTATION AND PARKING,CHASE ENDING IN 5315,$341.40 ,"$3,335,675.08 "
EVENTS PARTICIPATION EXPENSES,6/12/23,Expense,--,03 FUNDRASING EVENTS UNRESTR,St George table,FUNDRAISING EVENTS:EVENTS PARTICIPATION EXPENSES,CHASE ENDING IN 5315,$250.00 ,"$3,335,925.08 "
CHASE ENDING IN 5315,6/10/23,Deposit,--,02 GENERAL BANK URESTR,Zelle payment from MARIANNE EPSTEIN BACf075la3ac,CHASE ENDING IN 5315,Donations directed by individuals,$170.00 ,"$3,336,095.08 "
Donations directed by individuals,6/10/23,Deposit,--,02 GENERAL BANK URESTR,Zelle payment from MARIANNE EPSTEIN BACf075la3ac,Contributed income:Donations directed by individuals,CHASE ENDING IN 5315,$170.00 ,"$3,336,265.08 "
PayPal Bank 3,6/9/23,Transfer,--,--,ORIG CO NAME:PAYPAL ORIG ID:PAYPALSDXX DESC DATE:XXXXXX CO ENTRY DESCR:TRANSFER SEC:PPD TRACE#:XXXXXXXXXXXXXXX EED:XX0609 IND ID: IND NAME:DIGNITAS UKRAINE TRN: XXXXXX3859TC,PayPal Bank 3,CHASE ENDING IN 5315,"($1,000.00)","$3,335,265.08 "
CHASE ENDING IN 5315,6/9/23,Transfer,--,--,ORIG CO NAME:PAYPAL ORIG ID:PAYPALSDXX DESC DATE:XXXXXX CO ENTRY DESCR:TRANSFER SEC:PPD TRACE#:XXXXXXXXXXXXXXX EED:XX0609 IND ID: IND NAME:DIGNITAS UKRAINE TRN: XXXXXX3859TC,CHASE ENDING IN 5315,PayPal Bank 3,"$1,000.00 ","$3,336,265.08 "
CHASE ENDING IN 5315,6/7/23,Deposit,--,02 GENERAL BANK URESTR,Zelle payment from IRINA ZAKHALYAVKO XXXXXXX1558,CHASE ENDING IN 5315,Donations directed by individuals,$100.00 ,"$3,336,365.08 "
Donations directed by individuals,6/7/23,Deposit,--,02 GENERAL BANK URESTR,Zelle payment from IRINA ZAKHALYAVKO XXXXXXX1558,Contributed income:Donations directed by individuals,CHASE ENDING IN 5315,$100.00 ,"$3,336,465.08 "
CHASE ENDING IN 5315,6/7/23,Expense,--,03 FUNDRASING EVENTS UNRESTR,Zelle payment to Alexander Belokowsky JPMX99xnlt81,CHASE ENDING IN 5315,SUPPLIES AND MATERIALS,($49.06),"$3,336,416.02 "
SUPPLIES AND MATERIALS,6/7/23,Expense,--,03 FUNDRASING EVENTS UNRESTR,Zelle payment to Alexander Belokowsky JPMX99xnlt81,FUNDRAISING EVENTS:SUPPLIES AND MATERIALS,CHASE ENDING IN 5315,$49.06 ,"$3,336,465.08 "
PayPal Bank 3,6/6/23,Transfer,--,--,ORIG CO NAME:PAYPAL ORIG ID:PAYPALSDXX DESC DATE:XXXXXX CO ENTRY DESCR:TRANSFER SEC:PPD TRACE#:XXXXXXXXXXXXXXX EED:XX0606 IND ID: IND NAME:DIGNITAS UKRAINE TRN: XXXXXX4004TC,PayPal Bank 3,CHASE ENDING IN 5315,"($2,000.00)","$3,334,465.08 "
CHASE ENDING IN 5315,6/6/23,Transfer,--,--,ORIG CO NAME:PAYPAL ORIG ID:PAYPALSDXX DESC DATE:XXXXXX CO ENTRY DESCR:TRANSFER SEC:PPD TRACE#:XXXXXXXXXXXXXXX EED:XX0606 IND ID: IND NAME:DIGNITAS UKRAINE TRN: XXXXXX4004TC,CHASE ENDING IN 5315,PayPal Bank 3,"$2,000.00 ","$3,336,465.08 "
CHASE ENDING IN 5315,6/6/23,Deposit,--,03 FUNDRASING EVENTS UNRESTR,DEPOSIT ID NUMBER XX1332,CHASE ENDING IN 5315,Donations directed by individuals,$637.00 ,"$3,337,102.08 "
Donations directed by individuals,6/6/23,Deposit,--,03 FUNDRASING EVENTS UNRESTR,DEPOSIT ID NUMBER XX1332,Contributed income:Donations directed by individuals,CHASE ENDING IN 5315,$637.00 ,"$3,337,739.08 "
CHASE ENDING IN 5315,6/6/23,Expense,--,03 FUNDRASING EVENTS UNRESTR,Zelle payment to Alexander Belokowsky JPM999xkswhs,CHASE ENDING IN 5315,SUPPLIES AND MATERIALS,"($1,000.00)","$3,336,739.08 "
SUPPLIES AND MATERIALS,6/6/23,Expense,--,03 FUNDRASING EVENTS UNRESTR,Zelle payment to Alexander Belokowsky JPM999xkswhs,FUNDRAISING EVENTS:SUPPLIES AND MATERIALS,CHASE ENDING IN 5315,"$1,000.00 ","$3,337,739.08 "
CHASE ENDING IN 5315,6/5/23,Expense,--,03 FUNDRASING EVENTS UNRESTR,Zelle payment to Maryna Akatova XXXXXXX6501,CHASE ENDING IN 5315,SUPPLIES AND MATERIALS,($411.57),"$3,337,327.51 "
SUPPLIES AND MATERIALS,6/5/23,Expense,--,03 FUNDRASING EVENTS UNRESTR,Zelle payment to Maryna Akatova XXXXXXX6501,FUNDRAISING EVENTS:SUPPLIES AND MATERIALS,CHASE ENDING IN 5315,$411.57 ,"$3,337,739.08 "
CHASE ENDING IN 5315,6/5/23,Expense,--,03 FUNDRASING EVENTS UNRESTR,Zelle payment to Alexander Belokowsky JPM999xkphrv,CHASE ENDING IN 5315,SUPPLIES AND MATERIALS,($999.00),"$3,336,740.08 "
SUPPLIES AND MATERIALS,6/5/23,Expense,--,03 FUNDRASING EVENTS UNRESTR,Zelle payment to Alexander Belokowsky JPM999xkphrv,FUNDRAISING EVENTS:SUPPLIES AND MATERIALS,CHASE ENDING IN 5315,$999.00 ,"$3,337,739.08 "
CHASE ENDING IN 5315,6/5/23,Deposit,--,06 SQUARE UNRESTR,ORIG CO NAME:Square Inc ORIG ID:XXXXXXXXXX DESC DATE:XXXXXX CO ENTRY DESCR:XXXXXXPX SEC:CCD TRACE#:XXXXXXXXXXXXXXX EED:XXXXXX IND ID:LXXXXX5450 IND NAME:Dignita s Ukraine Inc LXXXXX TRN: XXXXXX3064TC,CHASE ENDING IN 5315,Donations directed by individuals,$5.64 ,"$3,337,744.72 "
Donations directed by individuals,6/5/23,Deposit,--,06 SQUARE UNRESTR,ORIG CO NAME:Square Inc ORIG ID:XXXXXXXXXX DESC DATE:XXXXXX CO ENTRY DESCR:XXXXXXPX SEC:CCD TRACE#:XXXXXXXXXXXXXXX EED:XXXXXX IND ID:LXXXXX5450 IND NAME:Dignita s Ukraine Inc LXXXXX TRN: XXXXXX3064TC,Contributed income:Donations directed by individuals,CHASE ENDING IN 5315,$5.64 ,"$3,337,750.36 "
CHASE ENDING IN 5315,6/4/23,Expense,--,03 FUNDRASING EVENTS UNRESTR,Zelle payment to Mykola Omelchenko JPM999xj5zdj,CHASE ENDING IN 5315,TRANSPORTATION AND PARKING,($60.00),"$3,337,690.36 "
TRANSPORTATION AND PARKING,6/4/23,Expense,--,03 FUNDRASING EVENTS UNRESTR,Zelle payment to Mykola Omelchenko JPM999xj5zdj,FUNDRAISING EVENTS:TRANSPORTATION AND PARKING,CHASE ENDING IN 5315,$60.00 ,"$3,337,750.36 "
CHASE ENDING IN 5315,6/4/23,Expense,--,03 FUNDRASING EVENTS UNRESTR,Zelle payment to Volodymyr Zatulyviter JPM999xj7wtp,CHASE ENDING IN 5315,TRANSPORTATION AND PARKING,($91.54),"$3,337,658.82 "
TRANSPORTATION AND PARKING,6/4/23,Expense,--,03 FUNDRASING EVENTS UNRESTR,Zelle payment to Volodymyr Zatulyviter JPM999xj7wtp,FUNDRAISING EVENTS:TRANSPORTATION AND PARKING,CHASE ENDING IN 5315,$91.54 ,"$3,337,750.36 "
CHASE ENDING IN 5315,6/4/23,Expense,--,02 GENERAL BANK URESTR,Zelle payment to Alexander Belokowsky JPMXX9xj66x4,CHASE ENDING IN 5315,SUPPLIES AND MATERIALS,($1.00),"$3,337,749.36 "
SUPPLIES AND MATERIALS,6/4/23,Expense,--,02 GENERAL BANK URESTR,Zelle payment to Alexander Belokowsky JPMXX9xj66x4,FUNDRAISING EVENTS:SUPPLIES AND MATERIALS,CHASE ENDING IN 5315,$1.00 ,"$3,337,750.36 "
CHASE ENDING IN 5315,6/3/23,Deposit,--,02 GENERAL BANK URESTR,Zelle payment from MAKSIM CHUGUNOV BACmi1wwjwv9,CHASE ENDING IN 5315,Donations directed by individuals,$40.00 ,"$3,337,790.36 "
Donations directed by individuals,6/3/23,Deposit,--,02 GENERAL BANK URESTR,Zelle payment from MAKSIM CHUGUNOV BACmi1wwjwv9,Contributed income:Donations directed by individuals,CHASE ENDING IN 5315,$40.00 ,"$3,337,830.36 "
CHASE ENDING IN 5315,5/31/23,Expense,--,CHASE BANK,MONTHLY SERVICE FEE,CHASE ENDING IN 5315,Bank fees & service charges,($15.00),"$3,337,815.36 "
Bank fees & service charges,5/31/23,Expense,--,CHASE BANK,MONTHLY SERVICE FEE,OFFICE/GENERAL ADMINISTRATIVE EXPENSES:Bank fees & service charges,CHASE ENDING IN 5315,$15.00 ,"$3,337,830.36 "
CHASE ENDING IN 5315,5/31/23,Deposit,--,05 VENMO UNRESTR,ORIG CO NAME:VENMO ORIG ID:XXXXXXXXXX DESC DATE:XXXXXX CO ENTRY DESCR:CASHOUT SEC:PPD TRACE#:XXXXXXXXXXXXXXX EED:XXXXX1 IND ID: IND NAME:OKSANA PATRINA TRN: 151 XXX8775TC,CHASE ENDING IN 5315,Donations directed by individuals,$230.54 ,"$3,338,060.90 "
Donations directed by individuals,5/31/23,Deposit,--,05 VENMO UNRESTR,ORIG CO NAME:VENMO ORIG ID:XXXXXXXXXX DESC DATE:XXXXXX CO ENTRY DESCR:CASHOUT SEC:PPD TRACE#:XXXXXXXXXXXXXXX EED:XXXXX1 IND ID: IND NAME:OKSANA PATRINA TRN: 151 XXX8775TC,Contributed income:Donations directed by individuals,CHASE ENDING IN 5315,$230.54 ,"$3,338,291.44 "
In-kind donations,5/31/23,Journal Entry,7,--,A.BOYCHUK AMAZON WISH LIST,Contributed income:In-kind donations,--,$232.82 ,"$3,338,524.26 "
IN-KIND DONATION DISTRIBUTIONS,5/31/23,Journal Entry,7,--,A.BOYCHUK AMAZON WISH LIST,PROGRAM EXPENSES:IN-KIND DONATION DISTRIBUTIONS,--,$232.82 ,"$3,338,757.08 "
CHASE ENDING IN 5315,5/30/23,Deposit,--,05 VENMO UNRESTR,ORIG CO NAME:VENMO ORIG ID:XXXXXXXXXX DESC DATE:XXXXXX CO ENTRY DESCR:ACCTVERIFYSEC:PPD TRACE#:XXXXXXXXXXXXXXX EED:XXX530 IND ID: IND NAME:OKSANA PATRINA TRN: 1 XXXXX1939TC,CHASE ENDING IN 5315,Donations directed by individuals,$0.16 ,"$3,338,757.24 "
Donations directed by individuals,5/30/23,Deposit,--,05 VENMO UNRESTR,ORIG CO NAME:VENMO ORIG ID:XXXXXXXXXX DESC DATE:XXXXXX CO ENTRY DESCR:ACCTVERIFYSEC:PPD TRACE#:XXXXXXXXXXXXXXX EED:XXX530 IND ID: IND NAME:OKSANA PATRINA TRN: 1 XXXXX1939TC,Contributed income:Donations directed by individuals,CHASE ENDING IN 5315,$0.16 ,"$3,338,757.40 "
CHASE ENDING IN 5315,5/30/23,Deposit,--,05 VENMO UNRESTR,ORIG CO NAME:VENMO ORIG ID:XXXXXXXXXX DESC DATE:XXXXXX CO ENTRY DESCR:ACCTVERIFYSEC:PPD TRACE#:XXXXXXXXXXXXXXX EED:XXX530 IND ID: IND NAME:OKSANA PATRINA TRN: 1 XXXXX1940TC,CHASE ENDING IN 5315,Donations directed by individuals,$0.21 ,"$3,338,757.61 "
Donations directed by individuals,5/30/23,Deposit,--,05 VENMO UNRESTR,ORIG CO NAME:VENMO ORIG ID:XXXXXXXXXX DESC DATE:XXXXXX CO ENTRY DESCR:ACCTVERIFYSEC:PPD TRACE#:XXXXXXXXXXXXXXX EED:XXX530 IND ID: IND NAME:OKSANA PATRINA TRN: 1 XXXXX1940TC,Contributed income:Donations directed by individuals,CHASE ENDING IN 5315,$0.21 ,"$3,338,757.82 "
CHASE ENDING IN 5315,5/30/23,Expense,--,CHASE BANK,ORIG CO NAME:VENMO ORIG ID:XXXXXXXXXX DESC DATE:XXXXXX CO ENTRY DESCR:ACCTVERIFYSEC:WEB TRACE#:XXXXXXXXXXXXXXX EED:XXXXXX IND ID:XXXXXXXXX7632 IND NAME:OKSANA P ATRINA TRN: XXXXXX3008TC,CHASE ENDING IN 5315,Bank fees & service charges,($0.21),"$3,338,757.61 "
Bank fees & service charges,5/30/23,Expense,--,CHASE BANK,ORIG CO NAME:VENMO ORIG ID:XXXXXXXXXX DESC DATE:XXXXXX CO ENTRY DESCR:ACCTVERIFYSEC:WEB TRACE#:XXXXXXXXXXXXXXX EED:XXXXXX IND ID:XXXXXXXXX7632 IND NAME:OKSANA P ATRINA TRN: XXXXXX3008TC,OFFICE/GENERAL ADMINISTRATIVE EXPENSES:Bank fees & service charges,CHASE ENDING IN 5315,$0.21 ,"$3,338,757.82 "
CHASE ENDING IN 5315,5/30/23,Expense,--,CHASE BANK,ORIG CO NAME:VENMO ORIG ID:XXXXXXXXXX DESC DATE:XXXXXX CO ENTRY DESCR:ACCTVERIFYSEC:WEB TRACE#:XXXXXXXXXXXXXXX EED:XXXXXX IND ID:XXXXXXXXX7513 IND NAME:OKSANA P ATRINA TRN: XXXXXX3007TC,CHASE ENDING IN 5315,Bank fees & service charges,($0.16),"$3,338,757.66 "
Bank fees & service charges,5/30/23,Expense,--,CHASE BANK,ORIG CO NAME:VENMO ORIG ID:XXXXXXXXXX DESC DATE:XXXXXX CO ENTRY DESCR:ACCTVERIFYSEC:WEB TRACE#:XXXXXXXXXXXXXXX EED:XXXXXX IND ID:XXXXXXXXX7513 IND NAME:OKSANA P ATRINA TRN: XXXXXX3007TC,OFFICE/GENERAL ADMINISTRATIVE EXPENSES:Bank fees & service charges,CHASE ENDING IN 5315,$0.16 ,"$3,338,757.82 "
CHASE ENDING IN 5315,5/30/23,Expense,--,06 SQUARE UNRESTR,ORIG CO NAME:Square Inc ORIG ID:XXXXXXXXXX DESC DATE:XXXXXX CO ENTRY DESCR:ACCTVERIFYSEC:CCD TRACE#:XXXXXXXXXXXXXXX EED:XXXXXX IND ID:T3RCW8MRD5SMKB9 IND NAME:D ignitas Ukraine Inc TXXXXXXX TRN: XXXXXX1024TC,CHASE ENDING IN 5315,Bank fees & service charges,($0.01),"$3,338,757.81 "
Bank fees & service charges,5/30/23,Expense,--,06 SQUARE UNRESTR,ORIG CO NAME:Square Inc ORIG ID:XXXXXXXXXX DESC DATE:XXXXXX CO ENTRY DESCR:ACCTVERIFYSEC:CCD TRACE#:XXXXXXXXXXXXXXX EED:XXXXXX IND ID:T3RCW8MRD5SMKB9 IND NAME:D ignitas Ukraine Inc TXXXXXXX TRN: XXXXXX1024TC,OFFICE/GENERAL ADMINISTRATIVE EXPENSES:Bank fees & service charges,CHASE ENDING IN 5315,$0.01 ,"$3,338,757.82 "
CHASE ENDING IN 5315,5/30/23,Deposit,--,01 ADMINISTRATIVE ACCOUNT,ORIG CO NAME:Square Inc ORIG ID:XXXXXXXXXX DESC DATE:XXXXXX CO ENTRY DESCR:ACCTVERIFYSEC:CCD TRACE#:XXXXXXXXXXXXXXX EED:XXXXX0 IND ID:T32CTMHPD9ACHCH IND NAME:D ignitas Ukraine Inc TXXXXXXX TRN: XXXXXX1015TC,CHASE ENDING IN 5315,Bank fees & service charges,$0.01 ,"$3,338,757.83 "
Bank fees & service charges,5/30/23,Deposit,--,01 ADMINISTRATIVE ACCOUNT,ORIG CO NAME:Square Inc ORIG ID:XXXXXXXXXX DESC DATE:XXXXXX CO ENTRY DESCR:ACCTVERIFYSEC:CCD TRACE#:XXXXXXXXXXXXXXX EED:XXXXX0 IND ID:T32CTMHPD9ACHCH IND NAME:D ignitas Ukraine Inc TXXXXXXX TRN: XXXXXX1015TC,OFFICE/GENERAL ADMINISTRATIVE EXPENSES:Bank fees & service charges,CHASE ENDING IN 5315,($0.01),"$3,338,757.82 "
PayPal Bank 3,5/29/23,Deposit,8NF06978J69707036,04 PAYPAL GENERAL UNRESTR,"Transaction ID: 8NF06978J69707036
https://www.paypal.com/activity/payment/8NF06978J69707036",PayPal Bank 3,Donations directed by individuals,$0.97 ,"$3,338,758.79 "
Donations directed by individuals,5/29/23,Deposit,8NF06978J69707036,04 PAYPAL GENERAL UNRESTR,Money in to PayPal,Contributed income:Donations directed by individuals,PayPal Bank 3,$0.97 ,"$3,338,759.76 "
CHASE ENDING IN 5315,5/27/23,Deposit,--,02 GENERAL BANK URESTR,Zelle payment from ELLEN BEDENKO WFCT0R7NXZ2Z,CHASE ENDING IN 5315,Donations directed by individuals,$40.00 ,"$3,338,799.76 "
Donations directed by individuals,5/27/23,Deposit,--,02 GENERAL BANK URESTR,Zelle payment from ELLEN BEDENKO WFCT0R7NXZ2Z,Contributed income:Donations directed by individuals,CHASE ENDING IN 5315,$40.00 ,"$3,338,839.76 "
CHASE ENDING IN 5315,5/27/23,Deposit,--,02 GENERAL BANK URESTR,Zelle payment from OLEKSIY VARFOLOMIYEV BACbpfrtgzq8,CHASE ENDING IN 5315,Donations directed by individuals,$20.00 ,"$3,338,859.76 "
Donations directed by individuals,5/27/23,Deposit,--,02 GENERAL BANK URESTR,Zelle payment from OLEKSIY VARFOLOMIYEV BACbpfrtgzq8,Contributed income:Donations directed by individuals,CHASE ENDING IN 5315,$20.00 ,"$3,338,879.76 "
CHASE ENDING IN 5315,5/27/23,Deposit,--,02 GENERAL BANK URESTR,DEPOSIT ID NUMBER XX2213,CHASE ENDING IN 5315,Donations directed by individuals,$300.00 ,"$3,339,179.76 "
Donations directed by individuals,5/27/23,Deposit,--,02 GENERAL BANK URESTR,DEPOSIT ID NUMBER XX2213,Contributed income:Donations directed by individuals,CHASE ENDING IN 5315,$300.00 ,"$3,339,479.76 "
PayPal Bank 3,5/24/23,Transfer,--,--,ORIG CO NAME:PAYPAL ORIG ID:PAYPALSDXX DESC DATE:XXXXXX CO ENTRY DESCR:TRANSFER SEC:PPD TRACE#:XXXXXXXXXXXXXXX EED:XX0524 IND ID: IND NAME:DIGNITAS UKRAINE TRN: XXXXXX6560TC,PayPal Bank 3,CHASE ENDING IN 5315,"($1,700.00)","$3,337,779.76 "
CHASE ENDING IN 5315,5/24/23,Transfer,--,--,ORIG CO NAME:PAYPAL ORIG ID:PAYPALSDXX DESC DATE:XXXXXX CO ENTRY DESCR:TRANSFER SEC:PPD TRACE#:XXXXXXXXXXXXXXX EED:XX0524 IND ID: IND NAME:DIGNITAS UKRAINE TRN: XXXXXX6560TC,CHASE ENDING IN 5315,PayPal Bank 3,"$1,700.00 ","$3,339,479.76 "
PayPal Bank 3,5/22/23,Transfer,--,--,ORIG CO NAME:PAYPAL ORIG ID:PAYPALSDXX DESC DATE:XXXXXX CO ENTRY DESCR:TRANSFER SEC:PPD TRACE#:XXXXXXXXXXXXXXX EED:XX0522 IND ID: IND NAME:DIGNITAS UKRAINE TRN: XXXXXX0460TC,PayPal Bank 3,CHASE ENDING IN 5315,"($2,300.00)","$3,337,179.76 "
CHASE ENDING IN 5315,5/22/23,Transfer,--,--,ORIG CO NAME:PAYPAL ORIG ID:PAYPALSDXX DESC DATE:XXXXXX CO ENTRY DESCR:TRANSFER SEC:PPD TRACE#:XXXXXXXXXXXXXXX EED:XX0522 IND ID: IND NAME:DIGNITAS UKRAINE TRN: XXXXXX0460TC,CHASE ENDING IN 5315,PayPal Bank 3,"$2,300.00 ","$3,339,479.76 "
CHASE ENDING IN 5315,5/22/23,Deposit,--,03 FUNDRASING EVENTS UNRESTR,DEPOSIT ID NUMBER XX9896,CHASE ENDING IN 5315,Donations directed by individuals,"$3,673.00 ","$3,343,152.76 "
Donations directed by individuals,5/22/23,Deposit,--,03 FUNDRASING EVENTS UNRESTR,DEPOSIT ID NUMBER XX9896,Contributed income:Donations directed by individuals,CHASE ENDING IN 5315,"$3,673.00 ","$3,346,825.76 "
CHASE ENDING IN 5315,5/22/23,Deposit,--,03 FUNDRASING EVENTS UNRESTR,CASH DEPOSIT CREDIT ADJUSTMENT,CHASE ENDING IN 5315,Donations directed by individuals,$11.00 ,"$3,346,836.76 "
Donations directed by individuals,5/22/23,Deposit,--,03 FUNDRASING EVENTS UNRESTR,CASH DEPOSIT CREDIT ADJUSTMENT,Contributed income:Donations directed by individuals,CHASE ENDING IN 5315,$11.00 ,"$3,346,847.76 "
CHASE ENDING IN 5315,5/22/23,Deposit,--,02 GENERAL BANK URESTR,Zelle payment from XIAOHUI BI BACnru6x46qp,CHASE ENDING IN 5315,Donations directed by individuals,"$1,700.00 ","$3,348,547.76 "
Donations directed by individuals,5/22/23,Deposit,--,02 GENERAL BANK URESTR,Zelle payment from XIAOHUI BI BACnru6x46qp,Contributed income:Donations directed by individuals,CHASE ENDING IN 5315,"$1,700.00 ","$3,350,247.76 "
CHASE ENDING IN 5315,5/21/23,Deposit,--,02 GENERAL BANK URESTR,Zelle payment from GFLS SHYBENO LLC XXXXXXX6831,CHASE ENDING IN 5315,Donations directed by individuals,$15.00 ,"$3,350,262.76 "
Donations directed by individuals,5/21/23,Deposit,--,02 GENERAL BANK URESTR,Zelle payment from GFLS SHYBENO LLC XXXXXXX6831,Contributed income:Donations directed by individuals,CHASE ENDING IN 5315,$15.00 ,"$3,350,277.76 "
CHASE ENDING IN 5315,5/21/23,Deposit,--,02 GENERAL BANK URESTR,Zelle payment from OLENA PAZDERSKA XXXXXXX5215,CHASE ENDING IN 5315,Donations directed by individuals,$60.00 ,"$3,350,337.76 "
Donations directed by individuals,5/21/23,Deposit,--,02 GENERAL BANK URESTR,Zelle payment from OLENA PAZDERSKA XXXXXXX5215,Contributed income:Donations directed by individuals,CHASE ENDING IN 5315,$60.00 ,"$3,350,397.76 "
CHASE ENDING IN 5315,5/21/23,Deposit,--,02 GENERAL BANK URESTR,Zelle payment from PAVLO MILESHCHENKO XXXXXXX8405,CHASE ENDING IN 5315,Donations directed by individuals,$350.00 ,"$3,350,747.76 "
Donations directed by individuals,5/21/23,Deposit,--,02 GENERAL BANK URESTR,Zelle payment from PAVLO MILESHCHENKO XXXXXXX8405,Contributed income:Donations directed by individuals,CHASE ENDING IN 5315,$350.00 ,"$3,351,097.76 "
CHASE ENDING IN 5315,5/20/23,Deposit,--,02 GENERAL BANK URESTR,Zelle payment from INNA COLLINS WFCT0R8WDM76,CHASE ENDING IN 5315,Donations directed by individuals,$40.00 ,"$3,351,137.76 "
Donations directed by individuals,5/20/23,Deposit,--,02 GENERAL BANK URESTR,Zelle payment from INNA COLLINS WFCT0R8WDM76,Contributed income:Donations directed by individuals,CHASE ENDING IN 5315,$40.00 ,"$3,351,177.76 "
CHASE ENDING IN 5315,5/20/23,Deposit,--,02 GENERAL BANK URESTR,Zelle payment from OKSANA PATRINA XXXXXXX8796,CHASE ENDING IN 5315,Donations directed by individuals,$200.00 ,"$3,351,377.76 "
Donations directed by individuals,5/20/23,Deposit,--,02 GENERAL BANK URESTR,Zelle payment from OKSANA PATRINA XXXXXXX8796,Contributed income:Donations directed by individuals,CHASE ENDING IN 5315,$200.00 ,"$3,351,577.76 "
CHASE ENDING IN 5315,5/20/23,Deposit,--,02 GENERAL BANK URESTR,Zelle payment from PAUL CONROY USAOIHMAVJNR,CHASE ENDING IN 5315,Donations directed by individuals,$30.00 ,"$3,351,607.76 "
Donations directed by individuals,5/20/23,Deposit,--,02 GENERAL BANK URESTR,Zelle payment from PAUL CONROY USAOIHMAVJNR,Contributed income:Donations directed by individuals,CHASE ENDING IN 5315,$30.00 ,"$3,351,637.76 "
CHASE ENDING IN 5315,5/18/23,Deposit,--,02 GENERAL BANK URESTR,ORIG CO NAME:GOOGLE ORIG ID:XXXXXXXXXX DESC DATE: CO ENTRY DESCR:ACCTVERIFYSEC:CCD TRACE#:XXXXXXXXXXXXXXX EED:XXXXXX IND ID:US003ULP5Y IND NAME:Dignitas Ukraine Inc XXXXXXXXX CREDIT TRN: XXXXXX9222TC,CHASE ENDING IN 5315,Donations directed by individuals,$0.07 ,"$3,351,637.83 "
Donations directed by individuals,5/18/23,Deposit,--,02 GENERAL BANK URESTR,ORIG CO NAME:GOOGLE ORIG ID:XXXXXXXXXX DESC DATE: CO ENTRY DESCR:ACCTVERIFYSEC:CCD TRACE#:XXXXXXXXXXXXXXX EED:XXXXXX IND ID:US003ULP5Y IND NAME:Dignitas Ukraine Inc XXXXXXXXX CREDIT TRN: XXXXXX9222TC,Contributed income:Donations directed by individuals,CHASE ENDING IN 5315,$0.07 ,"$3,351,637.90 "
CHASE ENDING IN 5315,5/10/23,Deposit,--,02 GENERAL BANK URESTR,Zelle payment from IRINA ZAKHALYAVKO XXXXXXX1558,CHASE ENDING IN 5315,Donations directed by individuals,$4.00 ,"$3,351,641.90 "
Donations directed by individuals,5/10/23,Deposit,--,02 GENERAL BANK URESTR,Zelle payment from IRINA ZAKHALYAVKO XXXXXXX1558,Contributed income:Donations directed by individuals,CHASE ENDING IN 5315,$4.00 ,"$3,351,645.90 "
PayPal Bank 3,5/9/23,Expense,5FE81103FS5404438,PAY PALL UNRESTRICTED,"Transaction ID: 5FE81103FS5404438
https://www.paypal.com/activity/payment/5FE81103FS5404438",PayPal Bank 3,Donations directed by individuals,($0.97),"$3,351,644.93 "
Donations directed by individuals,5/9/23,Expense,5FE81103FS5404438,PAY PALL UNRESTRICTED,Paid to Payment hold,Contributed income:Donations directed by individuals,PayPal Bank 3,($0.97),"$3,351,643.96 "
CHASE ENDING IN 5315,5/5/23,Deposit,--,02 GENERAL BANK URESTR,Zelle payment from IRINA ZAKHALYAVKO XXXXXXX1558,CHASE ENDING IN 5315,Donations directed by individuals,$175.00 ,"$3,351,818.96 "
Donations directed by individuals,5/5/23,Deposit,--,02 GENERAL BANK URESTR,Zelle payment from IRINA ZAKHALYAVKO XXXXXXX1558,Contributed income:Donations directed by individuals,CHASE ENDING IN 5315,$175.00 ,"$3,351,993.96 "
CHASE ENDING IN 5315,5/3/23,Deposit,--,02 GENERAL BANK URESTR,Zelle payment from ELLEN BEDENKO WFCT0R7NXZ2Z,CHASE ENDING IN 5315,Donations directed by individuals,$2.00 ,"$3,351,995.96 "
Donations directed by individuals,5/3/23,Deposit,--,02 GENERAL BANK URESTR,Zelle payment from ELLEN BEDENKO WFCT0R7NXZ2Z,Contributed income:Donations directed by individuals,CHASE ENDING IN 5315,$2.00 ,"$3,351,997.96 "
CHASE ENDING IN 5315,5/3/23,Deposit,--,02 GENERAL BANK URESTR,Zelle payment from IRINA ZAKHALYAVKO XXXXXXX1558,CHASE ENDING IN 5315,Donations directed by individuals,$5.00 ,"$3,352,002.96 "
Donations directed by individuals,5/3/23,Deposit,--,02 GENERAL BANK URESTR,Zelle payment from IRINA ZAKHALYAVKO XXXXXXX1558,Contributed income:Donations directed by individuals,CHASE ENDING IN 5315,$5.00 ,"$3,352,007.96 "
CHASE ENDING IN 5315,5/3/23,Expense,--,02 GENERAL BANK URESTR,Zelle payment to Ellen Bedenko JPMX99w4p9tv,CHASE ENDING IN 5315,Donations directed by individuals,($1.00),"$3,352,006.96 "
Donations directed by individuals,5/3/23,Expense,--,02 GENERAL BANK URESTR,Zelle payment to Ellen Bedenko JPMX99w4p9tv,Contributed income:Donations directed by individuals,CHASE ENDING IN 5315,($1.00),"$3,352,005.96 "
In-kind donations,4/30/23,Journal Entry,6,--,A.BOYCHUK AMAZON WISH LIST,Contributed income:In-kind donations,--,$199.92 ,"$3,352,205.88 "
IN-KIND DONATION DISTRIBUTIONS,4/30/23,Journal Entry,6,--,A.BOYCHUK AMAZON WISH LIST,PROGRAM EXPENSES:IN-KIND DONATION DISTRIBUTIONS,--,$199.92 ,"$3,352,405.80 "
CHASE ENDING IN 5315,4/20/23,Deposit,--,--,Opening Balance from Bank,CHASE ENDING IN 5315,Opening balance equity,$0.00 ,"$3,352,405.80 "
Opening balance equity,4/20/23,Deposit,--,--,--,Opening balance equity,CHASE ENDING IN 5315,$0.00 ,"$3,352,405.80 "
CHASE ENDING IN 5315,4/20/23,Deposit,--,02 GENERAL BANK URESTR,DEPOSIT ID NUMBER XX8615 DIMA,CHASE ENDING IN 5315,Donations directed by individuals,$25.00 ,"$3,352,430.80 "
Donations directed by individuals,4/20/23,Deposit,--,02 GENERAL BANK URESTR,DEPOSIT ID NUMBER XX8615 DIMA,Contributed income:Donations directed by individuals,CHASE ENDING IN 5315,$25.00 ,"$3,352,455.80 "
In-kind donations,3/31/23,Journal Entry,5,--,A.BOYCHUK AMAZON WISH LIST,Contributed income:In-kind donations,--,$91.63 ,"$3,352,547.43 "
IN-KIND DONATION DISTRIBUTIONS,3/31/23,Journal Entry,5,--,A.BOYCHUK AMAZON WISH LIST,PROGRAM EXPENSES:IN-KIND DONATION DISTRIBUTIONS,--,$91.63 ,"$3,352,639.06 "
In-kind donations,2/28/23,Journal Entry,4,--,A.BOYCHUK AMAZON WISH LIST,Contributed income:In-kind donations,--,$231.33 ,"$3,352,870.39 "
IN-KIND DONATION DISTRIBUTIONS,2/28/23,Journal Entry,4,--,A.BOYCHUK AMAZON WISH LIST,PROGRAM EXPENSES:IN-KIND DONATION DISTRIBUTIONS,--,$231.33 ,"$3,353,101.72 "
"Tuesday, December 19, 2023 07:16 PM UTC",,,,,,,,,